一万二	一萬二
一万五	一萬五
一万多	一萬多
一万年	一萬年
一万馀	一萬餘
一上台	一上臺
一下台	一下臺
一个个	一個個
一个人	一個人
一个准	一個準
一个劲	一個勁
一个样	一個樣
一伙人	一夥人
一伙头	一夥頭
一伙食	一伙食
一党制	一黨制
一写出	一寫出
一出去	一出去
一出场	一出場
一出子	一齣子
一出戏	一齣戲
一出来	一出來
一出生	一出生
一分钟	一分鐘
一别头	一彆頭
一加仑	一加侖
一千万	一千萬
一千个	一千個
一千人	一千人
一千亿	一千億
一千元	一千元
一千吨	一千噸
一千块	一千塊
一千多	一千多
一千年	一千年
一千点	一千點
一千馀	一千餘
一半只	一半隻
一口钟	一口鐘
一只只	一隻隻
一台台	一臺臺
一叶兰	一葉蘭
一吊钱	一吊錢
一向是	一向是
一周年	一週年
一周遭	一周遭
一喊出	一喊出
一回事	一回事
一回到	一回到
一回去	一回去
一回回	一回回
一回来	一回來
一团团	一團團
一团火	一團火
一团糟	一團糟
一地里	一地裏
一块面	一塊麵
一大伙	一大夥
一天后	一天後
一天钟	一天鐘
一妻制	一妻制
一干人	一干人
一扎脚	一扎腳
一托头	一托頭
一托气	一托氣
一播出	一播出
一斗斗	一斗斗
一方面	一方面
一杯杯	一杯杯
一杯羹	一杯羹
一根烟	一根菸
一溜烟	一溜煙
一点钟	一點鐘
一百万	一百萬
一看出	一看出
一碗面	一碗麵
一秒钟	一秒鐘
一笔划	一筆劃
一系列	一系列
一统志	一統志
一翻出	一翻出
一胎制	一胎制
一致字	一致字
一致性	一致性
一见面	一見面
一览表	一覽表
一讲出	一講出
一说出	一說出
一路发	一路發
一递里	一遞裏
一道烟	一道煙
一锅面	一鍋麵
一院制	一院制
一面倒	一面倒
一面食	一麵食
丁伯升	丁伯升
丁字梁	丁字梁
丁柏升	丁柏升
丁鸿志	丁鴻志
七万多	七萬多
七万馀	七萬餘
七个人	七個人
七五折	七五折
七分钟	七分鐘
七十万	七十萬
七十几	七十幾
七千万	七千萬
七千人	七千人
七千亿	七千億
七千元	七千元
七千多	七千多
七千馀	七千餘
七台河	七臺河
七叶胆	七葉膽
七天后	七天後
七娘妈	七娘媽
七巧板	七巧板
七彩虹	七彩虹
七星坛	七星壇
七星岩	七星巖
七星板	七星板
七点钟	七點鐘
七百万	七百萬
七秒钟	七秒鐘
七色板	七色板
七里河	七里河
七里香	七里香
万一会	萬一會
万一只	萬一只
万一在	萬一在
万一是	萬一是
万一有	萬一有
万万岁	萬萬歲
万丹乡	萬丹鄉
万事得	萬事得
万事达	萬事達
万事通	萬事通
万人坑	萬人坑
万人敌	萬人敵
万人敵	萬人敵
万人迷	萬人迷
万代兰	萬代蘭
万余只	萬餘隻
万余里	萬餘里
万元户	萬元戶
万全县	萬全縣
万全街	萬全街
万华区	萬華區
万华站	萬華站
万博省	萬博省
万卷书	萬卷書
万历史	萬歷史
万县市	萬縣市
万县港	萬縣港
万只怕	萬只怕
万向节	萬向節
万国宫	萬國宮
万国旗	萬國旗
万国码	萬國碼
万圣节	萬聖節
万多只	萬多隻
万天后	萬天後
万宁市	萬寧市
万安县	萬安縣
万宝华	萬寶華
万宝囊	萬寶囊
万宝常	萬寶常
万宝路	萬寶路
万家乐	萬家樂
万家香	萬家香
万寿山	萬壽山
万寿果	萬壽果
万寿菊	萬壽菊
万山镇	萬山鎮
万岁爷	萬歲爺
万峦乡	萬巒鄉
万州区	萬州區
万年前	萬年前
万年历	萬年曆
万年县	萬年縣
万年青	萬年青
万恩市	萬恩市
万户侯	萬戶侯
万把块	萬把塊
万斯同	萬斯同
万景峰	萬景峰
万智牌	萬智牌
万杞良	萬杞良
万柏林	萬柏林
万步表	萬步表
万毒枯	萬毒枯
万民伞	萬民傘
万沙浪	萬沙浪
万泉河	萬泉河
万泰银	萬泰銀
万洋山	萬洋山
万源市	萬源市
万灵丹	萬靈丹
万灵节	萬靈節
万灵药	萬靈藥
万用表	萬用表
万盛区	萬盛區
万盛溪	萬盛溪
万秀区	萬秀區
万维网	萬維網
万能梗	萬能梗
万能胶	萬能膠
万能锅	萬能鍋
万艾可	萬艾可
万花筒	萬花筒
万荣乡	萬榮鄉
万荣县	萬榮縣
万言书	萬言書
万载县	萬載縣
万那杜	萬那杜
万里乡	萬里鄉
万里侯	萬里侯
万重山	萬重山
万金油	萬金油
万馀人	萬餘人
万馀元	萬餘元
万鸦老	萬鴉老
万齐融	萬齊融
丈母娘	丈母娘
三万个	三萬個
三万人	三萬人
三万元	三萬元
三万块	三萬塊
三万多	三萬多
三专制	三專制
三个人	三個人
三个月	三個月
三仙台	三仙台
三元里	三元里
三八制	三八制
三分钟	三分鐘
三十万	三十萬
三十几	三十幾
三千万	三千萬
三千个	三千個
三千人	三千人
三千亿	三千億
三千元	三千元
三千块	三千塊
三千多	三千多
三千馀	三千餘
三只手	三隻手
三台县	三台縣
三叶期	三葉期
三叶松	三葉松
三叶草	三葉草
三叶虫	三葉蟲
三合一	三合一
三合会	三合會
三合土	三合土
三合房	三合房
三合星	三合星
三合板	三合板
三合院	三合院
三周年	三週年
三国志	三國志
三天后	三天後
三夹板	三夾板
三尸神	三尸神
三年制	三年制
三思台	三思臺
三恶道	三惡道
三折肱	三折肱
三方面	三方面
三杯鸡	三杯雞
三极管	三極管
三段制	三段制
三点钟	三點鐘
三班制	三班制
三用表	三用表
三百万	三百萬
三百个	三百個
三秒钟	三秒鐘
三穗县	三穗縣
三结合	三結合
三统历	三統曆
三胜制	三勝制
三角板	三角板
三角表	三角表
三连胜	三連勝
三部曲	三部曲
三里屯	三裏屯
三里河	三裏河
三长制	三長制
三青团	三青團
三面体	三面體
三面网	三面網
三面角	三面角
上一个	上一個
上下游	上下游
上不了	上不了
上个月	上個月
上千万	上千萬
上千人	上千人
上升为	上升爲
上半叶	上半葉
上发条	上發條
上合屋	上閤屋
上同调	上同調
上夸克	上夸克
上市柜	上市櫃
上栗县	上栗縣
上梁山	上梁山
上梁文	上梁文
上百万	上百萬
上确界	上確界
上签写	上簽寫
上签名	上簽名
上签字	上簽字
上签收	上簽收
上花台	上花臺
上药膏	上藥膏
上课钟	上課鐘
上面糊	上麵糊
上面级	上面級
上马杯	上馬杯
下一个	下一個
下三面	下三面
下不了	下不了
下个月	下個月
下仑路	下崙路
下划线	下劃綫
下台阶	下臺階
下城里	下城裏
下夸克	下夸克
下得了	下得了
下板儿	下板兒
下注解	下註解
下确界	下确界
下签写	下簽寫
下签名	下簽名
下签字	下簽字
下签收	下簽收
下课后	下課後
下课钟	下課鐘
下马杯	下馬杯
不一致	不一致
不下于	不下於
不世出	不世出
不乐于	不樂於
不了情	不了情
不了汉	不了漢
不了解	不瞭解
不二价	不二價
不亚于	不亞於
不体面	不體面
不作准	不作準
不值当	不值當
不偏极	不偏極
不停当	不停當
不光彩	不光彩
不克制	不剋制
不全症	不全症
不准他	不准他
不准你	不准你
不准备	不準備
不准她	不准她
不准它	不准它
不准我	不准我
不准没	不准沒
不准确	不準確
不准许	不准許
不准谁	不准誰
不出去	不出去
不出材	不出材
不出来	不出來
不划算	不划算
不利于	不利於
不占卜	不占卜
不占算	不占算
不发心	不發心
不只是	不只是
不可当	不可當
不合作	不合作
不合式	不合式
不合格	不合格
不合法	不合法
不合理	不合理
不合算	不合算
不合羣	不合羣
不合群	不合羣
不合节	不合節
不合适	不合適
不同于	不同於
不同人	不同人
不同处	不同處
不同意	不同意
不同点	不同點
不同调	不同調
不周到	不周到
不周山	不周山
不周延	不周延
不周风	不周風
不善于	不善於
不在了	不在了
不外借	不外借
不多于	不多於
不好了	不好了
不孕症	不孕症
不小于	不小於
不少于	不少於
不尽年	不盡年
不尽心	不盡心
不尽木	不盡木
不尽根	不盡根
不尽然	不盡然
不屑于	不屑於
不属于	不屬於
不干事	不幹事
不干他	不干他
不干休	不干休
不干你	不干你
不干净	不乾淨
不干她	不干她
不干它	不干它
不干我	不干我
不干扰	不干擾
不干擾	不干擾
不干杯	不乾杯
不干涉	不干涉
不干淨	不乾淨
不干牠	不干牠
不干犯	不干犯
不干脆	不乾脆
不干裂	不乾裂
不干預	不干預
不干预	不干預
不当事	不當事
不当人	不當人
不当党	不當黨
不当准	不當準
不当官	不當官
不当家	不當家
不当数	不當數
不当紧	不當緊
不当道	不當道
不得了	不得了
不得志	不得志
不得闲	不得閒
不情愿	不情願
不愿意	不願意
不成才	不成才
不挂眼	不掛眼
不放松	不放鬆
不敢当	不敢當
不整合	不整合
不早了	不早了
不明确	不明確
不松下	不鬆下
不标准	不標準
不正当	不正當
不正确	不正確
不死药	不死藥
不气干	不氣干
不注意	不注意
不甘于	不甘於
不相同	不相同
不相干	不相干
不确定	不確定
不确实	不確實
不符合	不符合
不等于	不等於
不系舟	不繫舟
不织布	不織布
不老药	不老藥
不育症	不育症
不胜春	不勝春
不胜衣	不勝衣
不至于	不至於
不致于	不致於
不舍得	不捨得
不舒适	不舒適
不良才	不良才
不虚发	不虛發
不行了	不行了
不见了	不見了
不见面	不見面
不规范	不規範
不讨采	不討采
不识闲	不識閒
不说价	不說價
不说出	不說出
不谐当	不諧當
不赞成	不贊成
不适合	不適合
不适当	不適當
不适感	不適感
不适用	不適用
不逊于	不遜於
不采声	不采聲
不锈钢	不鏽鋼
不限于	不限於
不龟药	不龜藥
与克制	與剋制
丑丫头	醜丫頭
丑八怪	醜八怪
丑剌剌	醜剌剌
丑女人	醜女人
丑奴儿	醜奴兒
丑婆子	丑婆子
丑媳妇	醜媳婦
丑小鸭	醜小鴨
丑巴怪	醜巴怪
丑毙了	醜斃了
丑表功	丑表功
丑贼生	醜賊生
丑闻案	醜聞案
专修班	專修班
专修科	專修科
专利药	專利藥
专制权	專制權
专注力	專注力
专精于	專精於
专辑里	專輯裏
世出世	世出世
世台会	世臺會
世彩堂	世綵堂
世恩录	世恩錄
世田谷	世田谷
世界杯	世界盃
世界里	世界裏
世纪钟	世紀鐘
世阿弥	世阿彌
业余者	業餘者
丛台区	叢臺區
丛生叶	叢生葉
东丰县	東豐縣
东丰阁	東豐閣
东京柜	東京櫃
东仓里	東倉里
东北向	東北向
东北面	東北面
东南向	東南向
东南面	東南面
东台市	東臺市
东台湾	東臺灣
东周时	東周時
东周钟	東周鐘
东学党	東學黨
东山里	東山里
东林党	東林黨
东胜区	東勝區
东西向	東西向
东西周	東西周
丝托索	絲托索
丝挂子	絲掛子
丝瓜布	絲瓜布
丝盘虫	絲盤蟲
丝织厂	絲織廠
丝绒布	絲絨布
丝虫病	絲蟲病
丢体面	丟體面
丢出去	丟出去
丢包术	丟包術
丢巧针	丟巧針
丢面子	丟面子
两万个	兩萬個
两万人	兩萬人
两万元	兩萬元
两万块	兩萬塊
两万多	兩萬多
两万馀	兩萬餘
两三千	兩三千
两下里	兩下里
两个人	兩個人
两个月	兩個月
两党制	兩黨制
两分钟	兩分鐘
两千万	兩千萬
两千个	兩千個
两千五	兩千五
两千人	兩千人
两千亿	兩千億
两千元	兩千元
两千块	兩千塊
两千多	兩千多
两千年	兩千年
两千馀	兩千餘
两只手	兩隻手
两周年	兩週年
两回事	兩回事
两天后	兩天後
两娘女	兩娘女
两当一	兩當一
两当县	兩當縣
两撇胡	兩撇鬍
两方面	兩方面
两极化	兩極化
两极管	兩極管
两段制	兩段制
两点钟	兩點鐘
两班制	兩班制
两百万	兩百萬
两百个	兩百個
两种人	兩種人
两秒钟	兩秒鐘
两院制	兩院制
两面倒	兩面倒
两面光	兩面光
两面刀	兩面刀
两面性	兩面性
两面派	兩面派
两面锯	兩面鋸
严云农	嚴云農
个中人	箇中人
个人化	個人化
个人奖	個人獎
个人性	個人性
个人用	個人用
个人秀	個人秀
个人组	個人組
个人赛	個人賽
个人风	個人風
个位数	個位數
个体户	個體戶
个别性	個別性
个头儿	個頭兒
个屁阿	個屁阿
个性化	個性化
个把月	個把月
个旧县	箇舊縣
个旧市	個舊市
个股为	個股爲
个过客	個過客
个钟表	個鐘錶
中上游	中上游
中下游	中下游
中了暑	中了暑
中了标	中了標
中了毒	中了毒
中仑站	中崙站
中价位	中價位
中台湾	中臺灣
中国制	中國製
中型钟	中型鐘
中央党	中央黨
中央台	中央台
中央面	中央面
中控台	中控台
中文台	中文台
中文系	中文系
中文里	中文裏
中暗箭	中暗箭
中止症	中止症
中港台	中港臺
中环杯	中環盃
中盘胜	中盤勝
中秋帖	中秋帖
中秋节	中秋節
中草药	中草藥
中药学	中藥學
中药店	中藥店
中药房	中藥房
中药材	中藥材
中药舖	中藥舖
中药铺	中藥鋪
中风后	中風後
丰丘明	豐丘明
丰乐亭	豐樂亭
丰产田	豐產田
丰南区	豐南區
丰原市	豐原市
丰台区	豐台區
丰城市	豐城市
丰宁县	豐寧縣
丰富性	豐富性
丰年玉	豐年玉
丰年祭	豐年祭
丰年节	豐年節
丰年虾	豐年蝦
丰收年	豐收年
丰水期	豐水期
丰泽区	豐澤區
丰润区	豐潤區
丰渔桥	豐漁橋
丰溪里	豐溪里
丰满区	豐滿區
丰滨乡	豐濱鄉
丰若晖	豐若暉
丰都县	豐都縣
丰镇市	豐鎮市
丰顺县	豐順縣
串亲戚	串親戚
串出来	串出來
临别时	臨別時
丸药盒	丸藥盒
丹布朗	丹布朗
为中台	爲中颱
为模范	爲模範
为规范	爲規範
主席台	主席臺
主席团	主席團
主干线	主幹綫
主控台	主控台
主播台	主播台
主教团	主教團
主普坛	主普壇
主机板	主機板
主画面	主畫面
主钟差	主鐘差
主题曲	主題曲
举出来	舉出來
举尾虫	舉尾蟲
举手表	舉手表
乃至于	乃至於
义和团	義和團
乌克兰	烏克蘭
乌冬面	烏冬面
乌干达	烏干達
乌当区	烏當區
乌托邦	烏托邦
乌梁海	烏梁海
乌沈沈	烏沈沈
乌涂水	烏塗水
乌苏市	烏蘇市
乌苏拉	烏蘇拉
乌龙面	烏龍麵
乐合彩	樂合彩
乐器钟	樂器鐘
乐坏了	樂壞了
乐意于	樂意於
乐游原	樂遊原
乐透彩	樂透彩
乔修亚	喬修亞
乔布斯	喬布斯
乔德里	喬德里
乔杰立	喬傑立
乘法表	乘法表
九万个	九萬個
九万人	九萬人
九万元	九萬元
九万块	九萬塊
九个人	九個人
九个月	九個月
九九表	九九表
九分钟	九分鐘
九十万	九十萬
九千万	九千萬
九千个	九千個
九千人	九千人
九千亿	九千億
九千元	九千元
九千块	九千塊
九千多	九千多
九千点	九千點
九台市	九臺市
九回肠	九迴腸
九天后	九天後
九宵云	九宵雲
九折臂	九折臂
九曲桥	九曲橋
九曲洞	九曲洞
九点钟	九點鐘
九百万	九百萬
九百个	九百個
九秒钟	九秒鐘
九里余	九里餘
九里区	九里區
九零后	九零後
九面体	九面體
九香虫	九香蟲
九龙杯	九龍杯
也克制	也剋制
也对于	也對於
也舍下	也舍下
习惯于	習慣於
乡愿意	鄉願意
书不尽	書不盡
书卷奖	書卷獎
书卷气	書卷氣
书呆子	書呆子
书虫子	書蟲子
书面上	書面上
书面纸	書面紙
书面语	書面語
买回去	買回去
买回家	買回家
买回来	買回來
买大彩	買大彩
买物历	買物歷
买闲钱	買閒錢
买面子	買面子
乱哄哄	亂哄哄
乱松松	亂鬆鬆
乱针绣	亂針繡
乱集团	亂集團
乳制品	乳製品
乾象历	乾象曆
乾象曆	乾象曆
了不得	了不得
了不成	了不成
了不起	了不起
了事环	了事環
了克制	了剋制
了得了	了得了
了望台	瞭望臺
了望塔	瞭望塔
了望山	瞭望山
了望所	瞭望所
了解到	瞭解到
了高儿	瞭高兒
争先后	爭先後
争闲气	爭閒氣
争面子	爭面子
事也干	事也幹
事发时	事發時
事可干	事可幹
事好干	事好幹
事情干	事情幹
事都干	事都幹
二丁挂	二丁掛
二万个	二萬個
二万人	二萬人
二万元	二萬元
二万块	二萬塊
二万多	二萬多
二个人	二個人
二个月	二個月
二人台	二人臺
二仑乡	二崙鄉
二党制	二黨制
二六板	二六板
二分钟	二分鐘
二十万	二十萬
二十几	二十幾
二千万	二千萬
二千个	二千個
二千人	二千人
二千亿	二千億
二千元	二千元
二千块	二千塊
二千多	二千多
二千年	二千年
二千石	二千石
二叠系	二疊系
二口虫	二口蟲
二叶松	二葉松
二合一	二合一
二吊六	二吊六
二和药	二和藥
二回熟	二回熟
二天后	二天後
二娘子	二娘子
二屋里	二屋裏
二年制	二年制
二恶英	二噁英
二手烟	二手菸
二撇胡	二撇鬍
二杆子	二桿子
二极体	二極體
二极管	二極管
二次曲	二次曲
二段制	二段制
二点钟	二點鐘
二班制	二班制
二田制	二田制
二百万	二百萬
二百个	二百個
二秒钟	二秒鐘
二老板	二老闆
二表哥	二表哥
二表妹	二表妹
二表姊	二表姊
二表姐	二表姐
二表嫂	二表嫂
二表弟	二表弟
二进制	二進制
二部制	二部制
二部曲	二部曲
二里头	二里頭
二面角	二面角
于一役	於一役
于仁泰	于仁泰
于从濂	于從濂
于会泳	于會泳
于伟国	于偉國
于佳卉	于佳卉
于光远	于光遠
于克制	於剋制
于克勒	于克勒
于凌奎	于凌奎
于凤桐	于鳳桐
于凤至	于鳳至
于化虎	于化虎
于占元	于占元
于双戈	于雙戈
于台烟	于台煙
于右任	于右任
于品海	于品海
于国桢	于國楨
于大宝	于大寶
于天仁	于天仁
于夫罗	於夫羅
于子千	于子千
于孔兼	于孔兼
于学忠	于學忠
于家堡	于家堡
于小伟	于小偉
于小彤	于小彤
于尔岑	于爾岑
于尔根	于爾根
于山国	于山國
于幼军	于幼軍
于幼华	於幼華
于广洲	于廣洲
于康震	于康震
于式枚	于式枚
于從濂	于從濂
于德海	于德海
于志宁	于志寧
于慎行	于慎行
于成龍	于成龍
于成龙	于成龍
于振武	于振武
于敏中	于敏中
于明涛	于明濤
于是之	於是之
于是乎	於是乎
于是就	於是就
于晨楠	于晨楠
于树洁	于樹潔
于根伟	于根偉
于梨华	於梨華
于欣源	于欣源
于正升	于正昇
于正昌	于正昌
于永波	于永波
于汉超	于漢超
于江震	于江震
于泽尔	于澤爾
于洪区	于洪區
于海洋	于海洋
于湘兰	于湘蘭
于潜县	於潛縣
于特森	于特森
于玉立	于玉立
于田县	于田縣
于秀敏	于秀敏
于素秋	于素秋
于美人	於美人
于若木	于若木
于荫霖	于蔭霖
于西翰	于西翰
于贝尔	于貝爾
于远伟	于遠偉
于道泉	于道泉
于都县	於都縣
于里察	于里察
于震寰	于震寰
于震环	于震環
于风政	于風政
于默奥	于默奧
亏不尽	虧不盡
云中君	雲中君
云南省	雲南省
云台山	雲臺山
云吞面	雲吞麵
云和县	雲和縣
云嘉南	雲嘉南
云城区	云城區
云天昊	雲天昊
云头儿	雲頭兒
云安县	雲安縣
云小啾	雲小啾
云岩区	雲岩區
云林人	雲林人
云林县	雲林縣
云林寺	雲林寺
云林讯	雲林訊
云梦县	雲夢縣
云梯车	雲梯車
云母片	雲母片
云母石	雲母石
云水僧	雲水僧
云浮市	雲浮市
云溪区	云溪區
云片糕	雲片糕
云科大	雲科大
云莽莽	雲莽莽
云西市	雲西市
云贵川	雲貴川
云遮月	雲遮月
云阳县	雲陽縣
云阳市	雲陽市
云霄县	雲霄縣
云龙区	雲龍區
云龙县	雲龍縣
互动台	互動臺
互生叶	互生葉
五万个	五萬個
五万人	五萬人
五万元	五萬元
五万块	五萬塊
五万多	五萬多
五万馀	五萬餘
五个人	五個人
五个月	五個月
五公里	五公里
五出戏	五齣戲
五分钟	五分鐘
五十万	五十萬
五十几	五十幾
五千万	五千萬
五千个	五千個
五千人	五千人
五千亿	五千億
五千元	五千元
五千吨	五千噸
五千块	五千塊
五千多	五千多
五千年	五千年
五千点	五千點
五台县	五臺縣
五台山	五臺山
五台市	五臺市
五周年	五週年
五天后	五天後
五斗柜	五斗櫃
五斗橱	五斗櫥
五斗米	五斗米
五点钟	五點鐘
五百万	五百萬
五百个	五百個
五种性	五種性
五秒钟	五秒鐘
五笔划	五筆劃
五脏庙	五臟廟
五脏神	五臟神
五里雾	五里霧
五面体	五面體
井田制	井田制
亚克力	亞克力
亚克朗	亞克朗
亚利叶	亞利葉
亚力克	亞力克
亚历桑	亞歷桑
亚当斯	亞當斯
亚松森	亞松森
亚洲杯	亞洲盃
亚青杯	亞青盃
亚麻布	亞麻布
些娘大	些娘大
交出去	交出去
交出来	交出來
交割价	交割價
交响曲	交響曲
交回去	交回去
交回来	交回來
交易价	交易價
交易台	交易臺
交杯盏	交杯盞
交杯酒	交杯酒
交汇处	交匯處
交流团	交流團
交白卷	交白卷
交货价	交貨價
亦对于	亦對於
亦舍下	亦捨下
产业别	產業別
产业链	產業鏈
产婆术	產婆術
产生出	產生出
亨塞克	亨塞克
京二胡	京二胡
亭彩店	亭彩店
亮光蜡	亮光蠟
亮星云	亮星雲
亲友团	親友團
亲子台	親子台
亲民党	親民黨
亲自干	親自幹
人云集	人云集
人出现	人出現
人别哭	人別哭
人参果	人蔘果
人参精	人蔘精
人团法	人團法
人才库	人才庫
人民党	人民黨
人物志	人物誌
人种学	人種學
人胜节	人勝節
人造板	人造板
人面上	人面上
亿多只	億多隻
亿天后	億天後
什不闲	什不閒
什叶派	什葉派
什锦面	什錦麵
仁布县	仁布縣
仁武厂	仁武廠
仅次于	僅次於
仆射姑	僕射姑
仇口儿	仇口兒
仇国论	仇國論
仇恨罪	仇恨罪
仇梓鸣	仇梓鳴
仇疙瘩	仇疙瘩
今儿个	今兒個
介壳虫	介殼蟲
介系词	介系詞
介面卡	介面卡
介面板	介面板
从事于	從事於
从价税	從價稅
从属于	從屬於
仑丰村	崙豐村
仑背乡	崙背鄉
他克制	他剋制
他出去	他出去
他出来	他出來
付出去	付出去
付出型	付出型
仙后座	仙后座
仙游县	仙遊縣
代工厂	代工廠
代码表	代碼表
代签人	代簽人
代表人	代表人
代表会	代表會
代表作	代表作
代表团	代表團
代表处	代表處
代表性	代表性
代表权	代表權
代表署	代表署
代表色	代表色
代表金	代表金
代表队	代表隊
代议制	代議制
令狐冲	令狐沖
以利于	以利於
以自制	以自制
以至于	以至於
以致于	以致於
仪器表	儀器表
仪征市	儀征市
仪表板	儀表板
仪表版	儀表版
仪表盘	儀表盤
们克制	們剋制
价值感	價值感
价值观	價值觀
价值论	價值論
价值量	價值量
价格战	價格戰
价格标	價格標
价格表	價格表
价电子	價電子
价目单	價目單
价目表	價目表
任一个	任一個
任何表	任何錶
任何钟	任何鐘
任务团	任務團
任教于	任教於
任期制	任期制
仿制品	仿製品
仿制药	仿製藥
企业团	企業團
企业系	企業系
企划书	企劃書
企划人	企劃人
企划厅	企劃廳
企划处	企劃處
企划案	企劃案
企划组	企劃組
企划部	企劃部
企管系	企管系
伊万诺	伊萬諾
伊吉克	伊吉克
伊府面	伊府麵
伊拉克	伊拉克
伊里奇	伊里奇
伊里布	伊里布
伍瑞克	伍瑞克
伍采克	伍采克
休仑湖	休崙湖
休闲区	休閒區
休闲服	休閒服
休闲组	休閒組
休闲裤	休閒褲
休闲鞋	休閒鞋
休闲风	休閒風
休闲馆	休閒館
优势种	優勢種
优惠价	優惠價
优胜奖	優勝獎
优胜者	優勝者
优胜队	優勝隊
伙伴国	夥伴國
伙伴龙	夥伴龍
伙食团	伙食團
伙食费	伙食費
会出去	會出去
会出来	會出來
会占卜	會佔卜
会合处	會合處
会合点	會合點
会同县	會同縣
会员价	會員價
会员制	會員制
会员团	會員團
会场价	會場價
会干净	會乾淨
会干扰	會干擾
会干政	會干政
会干杯	會乾杯
会干枯	會乾枯
会干涉	會干涉
会干涸	會乾涸
会干脆	會乾脆
会干裂	會乾裂
会干预	會干預
会计系	會計系
会里县	會裏縣
会长团	會長團
会面处	會面處
伟克适	偉克適
伟晶岩	偉晶岩
传习录	傳習錄
传出去	傳出去
传出来	傳出來
传制权	傳制權
传动链	傳動鏈
传回来	傳回來
传心术	傳心術
传教团	傳教團
传灯录	傳燈錄
传译出	傳譯出
传达出	傳達出
伤寒症	傷寒症
伤风克	傷風克
伯克利	伯克利
伯克来	伯克來
伯南克	伯南克
伯纳克	伯南克
估价单	估價單
估价行	估價行
估算出	估算出
伸出去	伸出去
伸出来	伸出來
伸回去	伸回去
伸回来	伸回來
伸展出	伸展出
低价位	低價位
低价团	低價團
低价格	低價格
低标准	低標準
体会出	體會出
体察出	體察出
体干班	體幹班
体温表	體溫表
体现出	體現出
体系化	體系化
体育台	體育台
体育系	體育系
体认出	體認出
体适能	體適能
体重表	體重表
体验出	體驗出
何小升	何小昇
何志钦	何志欽
何秋美	何秋美
何胜雄	何勝雄
何至于	何至於
何豪杰	何豪傑
余三勝	余三勝
余三胜	余三勝
余上沅	余上沅
余光中	余光中
余光生	余光生
余兰香	余蘭香
余发扬	余發揚
余吾镇	余吾鎮
余姚市	餘姚市
余威德	余威德
余子明	余子明
余宪宗	余憲宗
余干县	餘干縣
余庆县	餘慶縣
余思敏	余思敏
余政宪	余政憲
余文彬	余文彬
余杭区	餘杭區
余歌沧	余歌滄
余江县	餘江縣
余灿荣	余燦榮
余炳贤	余炳賢
余珮琳	余珮琳
余碧芬	余碧芬
余秀菁	余秀菁
余秉谚	余秉諺
余筱萍	余筱萍
余苑绮	余苑綺
余英时	余英時
余贤明	余賢明
余雪兰	余雪蘭
余雪明	余雪明
佛修根	佛修根
佛克斯	佛克斯
佛克纳	佛克納
佛布兹	佛布茲
佛瑞克	佛瑞克
佛科摆	佛科擺
佛舍利	佛舍利
佛蒙特	佛蒙特
佛里特	佛里特
佛雷克	佛雷克
作出来	作出來
作品里	作品裏
作废后	作廢後
作曲人	作曲人
作曲家	作曲家
作曲者	作曲者
你克制	你剋制
佳冬乡	佳冬鄉
佳里鎮	佳里鎮
佳里镇	佳里鎮
使其斗	使其鬥
使出来	使出來
使困扰	使困擾
使困窘	使困窘
使节团	使節團
使转向	使轉向
侏儒症	侏儒症
侏罗系	侏羅系
供应链	供應鏈
供给制	供給制
供给面	供給面
依个人	依個人
依附于	依附於
侦听台	偵聽台
侧面图	側面圖
侧面性	側面性
侯万户	侯萬戶
侯彩凤	侯彩鳳
侯胜茂	侯勝茂
侵入岩	侵入岩
侵占到	侵佔到
侵占罪	侵佔罪
便吃干	便吃乾
便当店	便當店
便当盒	便當盒
促销价	促銷價
俄文系	俄文系
俄语系	俄語系
保不准	保不準
保修期	保修期
保养厂	保養廠
保守党	保守黨
保安团	保安團
保暖杯	保暖杯
保温杯	保溫杯
保皇党	保皇黨
保险杆	保險桿
保险柜	保險櫃
信丰县	信豐縣
信号台	信號臺
信合社	信合社
信天游	信天游
修伊特	修伊特
修养成	修養成
修威特	修威特
修宪案	修憲案
修护站	修護站
修护队	修護隊
修指甲	修指甲
修改为	修改爲
修改后	修改後
修改成	修改成
修文县	修文縣
修曼德	修曼德
修杰楷	修杰楷
修正为	修正爲
修正期	修正期
修正案	修正案
修正档	修正檔
修正法	修正法
修正液	修正液
修武县	修武縣
修水利	修水利
修水县	修水縣
修理匠	修理匠
修理厂	修理廠
修理好	修理好
修理店	修理店
修理站	修理站
修理费	修理費
修理部	修理部
修缮费	修繕費
修胡刀	修鬍刀
修行人	修行人
修补匠	修補匠
修订本	修訂本
修订案	修訂案
修订版	修訂版
修词学	修詞學
修起来	修起來
修车厂	修車廠
修辞学	修辭學
修辞格	修辭格
修边幅	修邊幅
修造厂	修造廠
修道人	修道人
修道会	修道會
修道士	修道士
修道张	修道張
修道院	修道院
修配厂	修配廠
修鞋匠	修鞋匠
修饰句	修飾句
修饰字	修飾字
修饰词	修飾詞
修饰话	修飾話
修饰语	修飾語
俯冲点	俯衝點
俯冲角	俯衝角
俱舍师	俱舍師
俱舍论	俱舍論
倒了架	倒了架
倒了柴	倒了柴
倒出去	倒出去
倒出来	倒出來
倒回去	倒回去
倒回来	倒回來
倒杯水	倒杯水
倒杯茶	倒杯茶
借一步	借一步
借不到	借不到
借东风	借東風
借个火	借個火
借书单	借書單
借书证	借書證
借借看	借借看
借债人	借債人
借入方	借入方
借入款	借入款
借出去	借出去
借出来	借出來
借助于	藉助於
借单儿	借單兒
借回去	借回去
借回来	借回來
借字儿	借字兒
借寇兵	藉寇兵
借寇恂	借寇恂
借款人	借款人
借记卡	借記卡
借阅率	借閱率
借齿牙	借齒牙
倪云林	倪雲林
倪嗣冲	倪嗣沖
债权团	債權團
值得干	值得幹
值日表	值日表
倾向于	傾向於
倾向性	傾向性
倾斜面	傾斜面
假借义	假借義
假借字	假借字
假借法	假借法
假面具	假面具
假面剧	假面劇
偏回去	偏回去
偏回来	偏回來
偏执症	偏執症
偏极光	偏極光
偏极化	偏極化
偏极镜	偏極鏡
偏重于	偏重於
做不了	做不了
做出场	做出場
做出来	做出來
做得了	做得了
做针线	做針綫
停尸房	停屍房
停尸间	停屍間
健忘症	健忘症
偶发性	偶發性
偷出去	偷出去
偷出来	偷出來
偷回去	偷回去
偷回来	偷回來
偷婆娘	偷婆娘
偿回去	償回去
偿回来	償回來
傅克斯	傅克斯
傅利叶	傅利葉
傅匀余	傅勻余
傅科摆	傅科擺
傅立叶	傅立葉
傅里叶	傅里葉
催眠曲	催眠曲
催眠术	催眠術
催眠药	催眠藥
傻大个	傻大個
僵固性	僵固性
僵直性	僵直性
儒略历	儒略曆
儿童台	兒童台
儿童团	兒童團
兄弟党	兄弟黨
充场面	充場面
充满了	充滿了
充能干	充能幹
充门面	充門面
兆丰金	兆豐金
兆丰银	兆豐銀
先修班	先修班
先出去	先出去
先出来	先出來
先回到	先回到
先回去	先回去
先回来	先回來
光了了	光了了
光冲量	光衝量
光出律	光出律
光出溜	光出溜
光卤石	光鹵石
光周期	光周期
光复乡	光復鄉
光复会	光復會
光复节	光復節
光复路	光復路
光度表	光度表
光敏症	光敏症
光明云	光明雲
光明党	光明黨
光明面	光明面
光杆儿	光桿兒
光板儿	光板兒
光烟雾	光煙霧
光碟柜	光碟櫃
光纤维	光纖維
光脊梁	光脊樑
光致致	光緻緻
光艺术	光藝術
光范围	光範圍
光面子	光面子
克东县	克東縣
克丽丝	克麗絲
克伦克	克倫克
克伦奇	克倫奇
克佩罗	克佩羅
克克尔	克克爾
克兰诗	克蘭詩
克分子	克分子
克利斯	克利斯
克劳佛	克勞佛
克劳可	克勞可
克劳契	克勞契
克劳德	克勞德
克劳斯	克勞斯
克劳福	克勞福
克勒特	克勒特
克卜勒	克卜勒
克原子	克原子
克家子	克家子
克尔白	克爾白
克山县	克山縣
克当量	克當量
克拉克	克拉克
克拉兹	克拉茲
克拉姆	克拉姆
克拉本	克拉本
克拉科	克拉科
克林德	克林德
克林顿	克林頓
克格勃	克格勃
克汀病	克汀病
克洛尔	克洛爾
克洛斯	克洛斯
克洛格	克洛格
克流感	克流感
克瑞强	克瑞強
克瑞格	克瑞格
克罗埃	克羅埃
克罗德	克羅德
克罗齐	克羅齊
克耳文	克耳文
克耶族	克耶族
克耶邦	克耶邦
克莉丝	克莉絲
克莱儿	克萊兒
克莱因	克萊因
克莱恩	克萊恩
克莱曼	克萊曼
克莱柏	克萊柏
克莱格	克萊格
克莱顿	克萊頓
克蕾儿	克蕾兒
克虏伯	克虜伯
克里夫	克里夫
克里岛	克里島
克里斯	克里斯
克里木	克里木
克里梅	克里梅
克里特	克里特
克里门	克里門
克隆人	克隆人
克隆尼	克隆尼
克难街	克難街
克雷因	克雷因
克雷文	克雷文
克雷斯	克雷斯
克雷格	克雷格
克雷默	克雷默
克霉唑	克黴唑
克鲁兹	克魯茲
克鲁利	克魯利
克鲁尼	克魯尼
克鲁斯	克魯斯
克鲁格	克魯格
免不了	免不了
党三役	黨三役
党中央	黨中央
党主席	黨主席
党代会	黨代會
党代表	黨代表
党八股	黨八股
党公职	黨公職
党员证	黨員證
党团员	黨團員
党太尉	党太尉
党委会	黨委會
党小组	黨小組
党怀英	党懷英
党总支	黨總支
党支书	党支書
党政军	黨政軍
党籍碑	黨籍碑
党项族	党項族
入出境	入出境
入夜后	入夜後
內出血	內出血
內制作	內製作
內务柜	內務櫃
內婚制	內婚制
內心里	內心裏
內服药	內服藥
內蒙古	內蒙古
內阁制	內閣制
全出去	全出去
全出来	全出來
全台湾	全臺灣
全挂子	全掛子
全斗焕	全斗煥
全日制	全日制
全票价	全票價
全系列	全系列
全系统	全系統
全缘叶	全緣葉
全范围	全範圍
全裂叶	全裂葉
全谷物	全穀物
全面性	全面性
八万多	八萬多
八军团	八軍團
八分钟	八分鐘
八十万	八十萬
八十几	八十幾
八千万	八千萬
八千亿	八千億
八千多	八千多
八千点	八千點
八周年	八週年
八天后	八天後
八字胡	八字鬍
八斗子	八斗子
八斗才	八斗才
八极拳	八極拳
八点钟	八點鐘
八百万	八百萬
八秒钟	八秒鐘
八进制	八進制
八里乡	八里鄉
八面体	八面體
八面光	八面光
八面锋	八面鋒
公仔面	公仔麵
公使团	公使團
公切面	公切面
公孙丑	公孫丑
公定价	公定價
公布栏	公佈欄
公明党	公明黨
公有制	公有制
公里数	公里數
公里时	公里時
六万个	六萬個
六万人	六萬人
六万元	六萬元
六万块	六萬塊
六万多	六萬多
六个人	六個人
六个月	六個月
六分钟	六分鐘
六十万	六十萬
六十几	六十幾
六千万	六千萬
六千个	六千個
六千人	六千人
六千亿	六千億
六千元	六千元
六千块	六千塊
六千多	六千多
六千点	六千點
六合区	六合區
六合彩	六合彩
六合路	六合路
六周年	六週年
六天后	六天後
六星彩	六星彩
六点钟	六點鐘
六百万	六百萬
六百个	六百個
六面体	六面體
六须鲶	六鬚鯰
兰叶描	蘭葉描
兰叶撇	蘭葉撇
兰花烟	蘭花煙
共产党	共產黨
共产制	共產制
共价键	共價鍵
共同体	共同體
共同性	共同性
共同点	共同點
共同社	共同社
共同语	共同語
共和党	共和黨
共和制	共和制
共和历	共和曆
共基极	共基極
共青团	共青團
关不了	關不了
关云长	關雲長
关回去	關回去
关怀面	關懷面
关注度	關注度
关系人	關係人
关系到	關係到
关系和	關繫和
关系奖	關係獎
关系式	關係式
关系户	關係戶
关系法	關係法
关系着	關係着
关系词	關係詞
关系调	關係調
关系部	關係部
关节面	關節面
兴冲冲	興沖沖
兴隆台	興隆臺
兵器术	兵器術
兵工厂	兵工廠
兵籍表	兵籍表
典范性	典範性
养婆娘	養婆娘
兽医系	獸醫系
内出血	內出血
内蒙古	內蒙古
冈田准	岡田准
冉有仆	冉有僕
再出去	再出去
再出来	再出來
再出现	再出現
再制品	再製品
再制盐	再製鹽
再制纸	再製紙
再发生	再發生
再发见	再發見
再回到	再回到
再回去	再回去
再回来	再回來
再见面	再見面
再转复	再轉復
冒出来	冒出來
写不出	寫不出
写出去	寫出去
写出来	寫出來
写回去	寫回去
写回来	寫回來
写字台	寫字檯
军团菌	軍團菌
军官团	軍官團
军舰岩	軍艦岩
农作曲	農作曲
农化系	農化系
农历年	農曆年
农复会	農復會
农奴制	農奴制
农技团	農技團
农机系	農機系
农民党	農民黨
农民历	農民曆
农经系	農經系
农艺系	農藝系
农药商	農藥商
冠军杯	冠軍盃
冠子虫	冠子蟲
冥子里	冥子裏
冬不拉	冬不拉
冬冬鼓	鼕鼕鼓
冬天里	冬天裏
冬奥会	冬奧會
冬字头	冬字頭
冬季档	冬季檔
冬季节	冬季節
冬季赛	冬季賽
冬小麦	冬小麥
冬山乡	冬山鄉
冬山河	冬山河
冬日里	冬日裏
冬柴铁	冬柴鐵
冬瓜汤	冬瓜湯
冬瓜茶	冬瓜茶
冬眠期	冬眠期
冬至点	冬至點
冬运会	冬運會
冬青树	冬青樹
冯胜贤	馮勝賢
冯骥才	馮驥才
冰碛岩	冰磧岩
冲上前	衝上前
冲上去	衝上去
冲上来	衝上來
冲下去	衝下去
冲下来	衝下來
冲不上	衝不上
冲不下	衝不下
冲不入	衝不入
冲不出	衝不出
冲不开	衝不開
冲不破	衝不破
冲不过	衝不過
冲不进	衝不進
冲了上	衝了上
冲了下	衝了下
冲了入	衝了入
冲了出	衝了出
冲了来	衝了來
冲了过	衝了過
冲了进	衝了進
冲冲水	沖沖水
冲出去	衝出去
冲出来	衝出來
冲击力	衝擊力
冲击性	衝擊性
冲击波	衝擊波
冲刺班	衝刺班
冲动型	衝動型
冲压机	衝壓機
冲向前	衝向前
冲回去	衝回去
冲在下	衝在下
冲在前	衝在前
冲天炉	衝天爐
冲天炮	衝天炮
冲头阵	衝頭陣
冲得入	衝得入
冲得出	衝得出
冲得过	衝得過
冲得进	衝得進
冲撞力	衝撞力
冲断层	衝斷層
冲服剂	沖服劑
冲泡式	沖泡式
冲浪客	衝浪客
冲浪板	衝浪板
冲浪者	衝浪者
冲浪赛	衝浪賽
冲淋浴	沖淋浴
冲牀工	沖牀工
冲盹儿	衝盹兒
冲积土	沖積土
冲积堤	沖積堤
冲积层	沖積層
冲积岛	沖積島
冲积成	沖積成
冲积扇	沖積扇
冲积物	沖積物
冲空机	沖空機
冲突区	衝突區
冲突性	衝突性
冲突点	衝突點
冲绳县	沖繩縣
冲绳岛	沖繩島
冲自己	衝自己
冲起来	衝起來
冲过去	衝過去
冲过来	衝過來
冲进去	衝進去
冲进来	衝進來
冲锋号	衝鋒號
冲锋枪	衝鋒槍
冲锋鎗	衝鋒鎗
决定出	決定出
决心干	決心幹
决斗者	決鬥者
决胜局	決勝局
决胜期	決勝期
决胜点	決勝點
决胜盘	決勝盤
决胜节	決勝節
决胜负	決勝負
冶炼厂	冶煉廠
冶炼炉	冶煉爐
冷冻柜	冷凍櫃
冷地里	冷地里
冷感症	冷感症
冷板凳	冷板凳
冷板曲	冷板曲
冷气团	冷氣團
冷腌法	冷醃法
冷藏柜	冷藏櫃
冷读术	冷讀術
冷面相	冷面相
准三后	准三后
准不准	準不準
准保护	准保護
准保释	准保釋
准决斗	准決鬥
准决赛	準決賽
准分子	準分子
准噶尔	準噶爾
准备下	準備下
准备好	準備好
准备率	準備率
准备给	準備給
准备金	準備金
准妈妈	準媽媽
准平原	準平原
准拿督	準拿督
准新娘	準新娘
准新郎	準新郎
准时到	準時到
准普尔	准普爾
准格尔	準格爾
准決賽	準決賽
准点率	準點率
准确度	準確度
准确性	準確性
准确率	準確率
准考证	准考證
准谱儿	準譜兒
准货币	準貨幣
凌云县	凌雲縣
凌志美	凌志美
凌烟阁	凌煙閣
凌蒙初	凌濛初
减压症	減壓症
减压表	減壓表
减肥药	減肥藥
凑合着	湊合著
凝合力	凝合力
凝灰岩	凝灰岩
几丁质	幾丁質
几万个	幾萬個
几万人	幾萬人
几万元	幾萬元
几万块	幾萬塊
几世纪	幾世紀
几个人	幾個人
几个月	幾個月
几乎不	幾乎不
几乎在	幾乎在
几乎是	幾乎是
几人份	幾人份
几件事	幾件事
几位数	幾位數
几何体	幾何體
几何学	幾何學
几何线	幾何綫
几何量	幾何量
几儿个	幾兒個
几內亚	幾內亞
几内亚	幾內亞
几分钟	幾分鐘
几匹马	幾匹馬
几十万	幾十萬
几十个	幾十個
几十人	幾十人
几十亿	幾十億
几十年	幾十年
几千万	幾千萬
几千个	幾千個
几千人	幾千人
几千元	幾千元
几千块	幾千塊
几千年	幾千年
几句话	幾句話
几回价	幾回價
几块钱	幾塊錢
几大块	幾大塊
几大片	幾大片
几大类	幾大類
几天后	幾天後
几天来	幾天來
几封信	幾封信
几小时	幾小時
几层楼	幾層樓
几年来	幾年來
几年生	幾年生
几年级	幾年級
几成新	幾成新
几文钱	幾文錢
几日份	幾日份
几星期	幾星期
几月份	幾月份
几本书	幾本書
几梯次	幾梯次
几比几	幾比幾
几毛钱	幾毛錢
几滴水	幾滴水
几炷香	幾炷香
几点了	幾點了
几点几	幾點幾
几点钟	幾點鐘
几番家	幾番家
几百万	幾百萬
几百个	幾百個
几百人	幾百人
几百亿	幾百億
几百元	幾百元
几百块	幾百塊
几百年	幾百年
几盒装	幾盒裝
几碗饭	幾碗飯
几秒钟	幾秒鐘
几能勾	幾能勾
几节课	幾節課
几角形	幾角形
几趟路	幾趟路
几辆车	幾輛車
几近于	幾近於
几道菜	幾道菜
几面上	几面上
几首歌	幾首歌
凤凰台	鳳凰臺
凤台县	鳳台縣
凤尾松	鳳尾松
凤梨干	鳳梨乾
凭借着	憑藉着
凯里市	凱裏市
凶巴巴	兇巴巴
凶得狠	兇得狠
凶杀案	兇殺案
凶起来	兇起來
凸出去	凸出去
凸出成	凸出成
凸出来	凸出來
凸折线	凸折綫
凸显出	凸顯出
凸面体	凸面體
凸面镜	凸面鏡
凹洞里	凹洞裏
凹面镜	凹面鏡
出不起	出不起
出世作	出世作
出世法	出世法
出个价	出個價
出主意	出主意
出乱子	出亂子
出了事	出了事
出了月	出了月
出事情	出事情
出产地	出產地
出人命	出人命
出份子	出份子
出借书	出借書
出入口	出入口
出入境	出入境
出入証	出入証
出入证	出入證
出入门	出入門
出公差	出公差
出其右	出其右
出冷门	出冷門
出出气	出出氣
出分子	出分子
出勤率	出勤率
出厂价	出廠價
出去会	出去會
出去时	出去時
出去玩	出去玩
出发到	出發到
出发地	出發地
出发日	出發日
出发点	出發點
出口值	出口值
出口到	出口到
出口区	出口區
出口商	出口商
出口国	出口國
出口处	出口處
出口税	出口稅
出口货	出口貨
出口量	出口量
出口额	出口額
出品人	出品人
出品国	出品國
出售给	出售給
出唱片	出唱片
出喽子	出嘍子
出国前	出國前
出国时	出國時
出国者	出國者
出圈儿	出圈兒
出土物	出土物
出场费	出場費
出境証	出境証
出境证	出境證
出外人	出外人
出外景	出外景
出大差	出大差
出大恭	出大恭
出太阳	出太陽
出头天	出頭天
出头棍	出頭棍
出头鸟	出頭鳥
出娄子	出婁子
出家人	出家人
出小恭	出小恭
出尖儿	出尖兒
出局数	出局數
出岔儿	出岔兒
出岔子	出岔子
出差费	出差費
出差错	出差錯
出师表	出師表
出席率	出席率
出席者	出席者
出席费	出席費
出征收	出徵收
出意外	出意外
出把戏	出把戲
出操课	出操課
出故典	出故典
出数儿	出數兒
出月子	出月子
出条子	出條子
出来时	出來時
出楼子	出樓子
出殡日	出殯日
出毛病	出毛病
出气口	出氣口
出气筒	出氣筒
出水口	出水口
出水管	出水管
出洋相	出洋相
出海口	出海口
出港证	出港證
出溜儿	出溜兒
出漏子	出漏子
出火炕	出火炕
出点子	出點子
出版业	出版業
出版人	出版人
出版品	出版品
出版商	出版商
出版所	出版所
出版日	出版日
出版法	出版法
出版物	出版物
出版界	出版界
出版社	出版社
出版者	出版者
出版节	出版節
出版项	出版項
出状况	出狀況
出现数	出現數
出生别	出生別
出生地	出生地
出生年	出生年
出生日	出生日
出生牙	出生牙
出生率	出生率
出生纸	出生紙
出生证	出生證
出电影	齣電影
出电视	齣電視
出疹子	出疹子
出社会	出社會
出租人	出租人
出租店	出租店
出租率	出租率
出租给	出租給
出租车	出租車
出窝老	出窩老
出笼鸟	出籠鳥
出红差	出紅差
出纳台	出納台
出纳员	出納員
出纳处	出納處
出纳科	出納科
出纳组	出納組
出老千	出老千
出自于	出自於
出节目	齣節目
出花儿	出花兒
出花样	出花樣
出芽法	出芽法
出苗率	出苗率
出虚恭	出虛恭
出血性	出血性
出血热	出血熱
出血病	出血病
出血量	出血量
出货单	出貨單
出货量	出貨量
出资人	出資人
出起来	出起來
出超国	出超國
出超额	出超額
出车祸	出車禍
出进口	出進口
出远门	出遠門
出道时	出道時
出锋头	出鋒頭
出镜头	出鏡頭
出门子	出門子
出门时	出門時
出问题	出問題
出难题	出難題
出风口	出風口
出风头	出風頭
出高价	出高價
函谷关	函谷關
凿出去	鑿出去
凿出来	鑿出來
凿岩机	鑿巖機
凿船虫	鑿船蟲
刀创药	刀創藥
刀削面	刀削麵
分不出	分不出
分出去	分出去
分出来	分出來
分别出	分別出
分半钟	分半鐘
分厘卡	分釐卡
分发到	分發到
分发区	分發區
分发给	分發給
分向岛	分向島
分多钟	分多鐘
分子钟	分子鐘
分封制	分封制
分尸案	分屍案
分布于	分佈於
分布区	分佈區
分布图	分布圖
分布圖	分布圖
分布式	分佈式
分得出	分得出
分散于	分散於
分杯羹	分杯羹
分析出	分析出
分泌出	分泌出
分离出	分離出
分离术	分離術
分筋术	分筋術
分系统	分系統
分级制	分級制
分裂症	分裂症
分身术	分身術
分辨出	分辨出
分进合	分進合
切出去	切出去
切出来	切出來
切向力	切向力
切向量	切向量
切平面	切平面
切开术	切開術
切菜板	切菜板
切除术	切除術
刊出来	刊出來
刊误表	刊誤表
刑法志	刑法志
划一桨	划一槳
划不来	划不來
划分为	劃分爲
划分成	劃分成
划分法	劃分法
划到岸	划到岸
划双人	划雙人
划定为	劃定爲
划座位	劃座位
划得来	划得來
划时代	劃時代
划着走	划着走
划纹症	劃紋症
划线板	劃綫板
划起来	划起來
划过去	划過去
划过来	划過來
划进去	划進去
划进来	划進來
划龙舟	划龍舟
列举出	列舉出
列出来	列出來
列御寇	列禦寇
列表机	列表機
刘云山	劉雲山
刘任杰	劉任傑
刘伟杰	劉偉杰
刘克庄	劉克莊
刘克襄	劉克襄
刘占吉	劉占吉
刘嘉发	劉嘉發
刘宗周	劉宗周
刘峰松	劉峰松
刘幸义	劉幸義
刘幸如	劉倖如
刘志勤	劉志勤
刘志升	劉志昇
刘志威	劉志威
刘松仁	劉松仁
刘松年	劉松年
刘松藩	劉松藩
刘知几	劉知幾
刘秋凤	劉秋鳳
刘胡兰	劉胡蘭
刘鉴庭	劉鑑庭
刘长发	劉長發
刘青云	劉青雲
刚出去	剛出去
刚出来	剛出來
刚出道	剛出道
刚回到	剛回到
刚回去	剛回去
刚回来	剛回來
刚才在	剛纔在
刚才是	剛纔是
创业板	創業板
创伤后	創傷後
创作出	創作出
创作曲	創作曲
创制权	創制權
创历年	創歷年
创意曲	創意曲
创意杯	創意盃
创立出	創立出
创纪录	創紀錄
创记录	創記錄
创造出	創造出
初登板	初登板
初秋图	初秋圖
初选制	初選制
判别式	判別式
判断出	判斷出
別干净	別乾淨
刨出来	刨出來
利得汇	利得彙
利欲心	利慾心
别上去	別上去
别上来	別上來
别下去	別下去
别下来	別下來
别人的	別人的
别傻了	別傻了
别出去	別出去
别出来	別出來
别动队	別動隊
别口气	彆口氣
别吓人	別嚇人
别墅区	別墅區
别客气	別客氣
别害羞	別害羞
别描头	別描頭
别提了	別提了
别生气	別生氣
别的人	別的人
别种的	別種的
别苗头	別苗頭
别说出	別說出
别说到	別說到
别说起	別說起
别起来	別起來
别过去	別過去
别过头	別過頭
别过来	別過來
别除权	別除權
别颏腮	別頦腮
别鹤操	別鶴操
刮下去	刮下去
刮下来	刮下來
刮书背	刮書背
刮冷风	刮冷風
刮刮乐	刮刮樂
刮刮卡	刮刮卡
刮刮叫	刮刮叫
刮剌剌	刮剌剌
刮地器	刮地器
刮地皮	刮地皮
刮大风	颳大風
刮宫术	刮宮術
刮皮刀	刮皮刀
刮胡刀	刮鬍刀
刮胡子	刮鬍子
刮脸刀	刮臉刀
刮脸皮	刮臉皮
刮舌子	刮舌子
刮起来	刮起來
刮过去	刮過去
刮过来	刮過來
刮风后	颳風後
到不了	到不了
到岸价	到岸價
到那里	到那裏
制作业	製作業
制作人	製作人
制作出	製作出
制作商	製作商
制作好	製作好
制作成	製作成
制作羣	製作羣
制作者	製作者
制作费	製作費
制冰机	製冰機
制冷剂	制冷劑
制冷机	制冷機
制动器	制動器
制动缸	制動缸
制图员	製圖員
制图学	製圖學
制图室	製圖室
制图尺	製圖尺
制图师	製圖師
制图板	製圖板
制图样	製圖樣
制图桌	製圖桌
制图者	製圖者
制图车	製圖車
制定出	制定出
制宪权	制憲權
制度化	制度化
制度性	制度性
制度法	制度法
制度面	制度面
制式化	制式化
制成品	制成品
制新宪	制新憲
制服呢	制服呢
制水阀	制水閥
制海权	制海權
制片人	製片人
制片厂	製片廠
制片商	製片商
制片家	製片家
制版术	製版術
制空权	制空權
制糖厂	製糖廠
制药业	制藥業
制药厂	製藥廠
制衣厂	製衣廠
制裁案	制裁案
制造业	製造業
制造出	製造出
制造厂	製造廠
制造品	製造品
制造商	製造商
制造器	製造器
制造场	製造場
制造成	製造成
制造术	製造術
制造者	製造者
制酸剂	制酸劑
制酸性	製酸性
制面具	製面具
制革厂	製革廠
制鞋业	製鞋業
制鞋匠	製鞋匠
制音器	制音器
制高点	制高點
刺不准	刺不準
刺出去	刺出去
刺出来	刺出來
刺探出	刺探出
刺枪术	刺槍術
刺胳针	刺胳針
刻划出	刻劃出
刻半钟	刻半鐘
刻多钟	刻多鐘
刻录机	刻錄機
刻蜡纸	刻蠟紙
剃发令	剃髮令
剃发铺	剃髮鋪
剃头发	剃頭髮
剃须刀	剃鬚刀
削苹果	削蘋果
前儿个	前兒個
前几天	前幾天
前后任	前後任
前后文	前後文
前奏曲	前奏曲
前新系	前新系
前甲板	前甲板
前苏联	前蘇聯
前进党	前進黨
前面店	前面店
剔团圆	剔團圓
剔团𪢮	剔團圞
剔庄货	剔莊貨
剔齿纤	剔齒纖
剖面图	剖面圖
剥离症	剝離症
剥采比	剝採比
剥面皮	剝面皮
剪其发	剪其髮
剪头发	剪頭髮
剪秋罗	剪秋羅
剪贴出	剪貼出
副厂长	副廠長
副团长	副團長
副性征	副性徵
割回去	割回去
割回来	割回來
割圆术	割圓術
劈心里	劈心裏
劈挂拳	劈掛拳
劈脑后	劈腦後
力克制	力剋制
力回馈	力回饋
力量党	力量黨
劝出去	勸出去
劝出来	勸出來
劝回去	勸回去
劝回来	勸回來
办公台	辦公檯
办后事	辦後事
功率表	功率表
功绩制	功績制
功能团	功能團
功能表	功能表
功课表	功課表
加回去	加回去
加回来	加回來
加害于	加害於
加工厂	加工廠
加杯水	加杯水
加油团	加油團
加签证	加簽證
加达里	加達裏
加里宁	加裏寧
动不了	動不了
动干戈	動干戈
动手术	動手術
动物系	動物系
动配合	動配合
助选团	助選團
励志书	勵志書
劲舞团	勁舞團
劳军团	勞軍團
劳动党	勞動黨
劳台重	勞臺重
劳工党	勞工黨
劳里斯	勞里斯
勃极烈	勃極烈
勒克司	勒克司
勘误表	勘誤表
募兵制	募兵制
勾勒出	勾勒出
勾画出	勾畫出
匀出来	勻出來
包乘制	包乘制
包干儿	包乾兒
包干制	包干制
包待制	包待制
包扎法	包紮法
包承制	包承制
包班制	包班制
包种茶	包種茶
包谷花	包谷花
包里斯	包里斯
化合价	化合價
化合态	化合態
化合性	化合性
化合物	化合物
化合量	化合量
化妆台	化妝台
化学系	化學系
化工厂	化工廠
化工系	化工系
化纤厂	化纖廠
化肥厂	化肥廠
化验台	化驗台
北仑区	北侖區
北叶门	北葉門
北回线	北迴綫
北斗星	北斗星
北斗镇	北斗鎮
北极光	北極光
北极区	北極區
北极圈	北極圈
北极星	北極星
北极海	北極海
北极熊	北極熊
北极犬	北極犬
北极狐	北極狐
北极锋	北極鋒
北极鲸	北極鯨
北柴胡	北柴胡
北洋系	北洋系
匹似闲	匹似閒
匹头里	匹頭裏
区分出	區分出
区别性	區別性
区别词	區別詞
医学系	醫學系
医疗团	醫療團
医药业	醫藥業
医药品	醫藥品
医药学	醫藥學
医药界	醫藥界
医药费	醫藥費
医院里	醫院裏
十一万	十一萬
十一个	十一個
十七万	十七萬
十七个	十七個
十万个	十萬個
十万人	十萬人
十万位	十萬位
十万元	十萬元
十万块	十萬塊
十万多	十萬多
十三万	十三萬
十三个	十三個
十个人	十個人
十个月	十個月
十九万	十九萬
十九个	十九個
十二万	十二萬
十二个	十二個
十五万	十五萬
十五个	十五個
十余只	十餘隻
十余里	十餘里
十克拉	十克拉
十八万	十八萬
十八个	十八個
十公克	十公克
十公升	十公升
十公里	十公里
十六万	十六萬
十六个	十六個
十几万	十幾萬
十几个	十幾個
十几人	十幾人
十几元	十幾元
十几分	十幾分
十几号	十幾號
十几块	十幾塊
十几天	十幾天
十几岁	十幾歲
十几年	十幾年
十几次	十幾次
十出戏	十齣戲
十分干	十分乾
十分钟	十分鐘
十加仑	十加侖
十周年	十週年
十四万	十四萬
十四个	十四個
十多万	十多萬
十多个	十多個
十多只	十多隻
十天后	十天後
十天干	十天干
十年后	十年後
十来个	十來個
十杯水	十杯水
十杯酒	十杯酒
十点钟	十點鐘
十秒钟	十秒鐘
十足虫	十足蟲
十进制	十進制
十里余	十里餘
十面体	十面體
十馀万	十餘萬
千万年	千萬年
千位元	千位元
千余只	千餘隻
千余里	千餘里
千佛塔	千佛塔
千佛山	千佛山
千佛洞	千佛洞
千分之	千分之
千分表	千分表
千古事	千古事
千古恨	千古恨
千只可	千只可
千只够	千只夠
千只怕	千只怕
千只能	千只能
千叶县	千葉縣
千多只	千多隻
千天后	千天後
千夫长	千夫長
千字文	千字文
千字节	千字節
千家姓	千家姓
千家诗	千家詩
千层糕	千層糕
千层面	千層麵
千山区	千山區
千岛湖	千島湖
千岛酱	千島醬
千年前	千年前
千年艾	千年艾
千斤顶	千斤頂
千日红	千日紅
千日菊	千日菊
千日酒	千日酒
千湖国	千湖國
千牛刀	千牛刀
千瓦时	千瓦時
千百万	千百萬
千百年	千百年
千皓宣	千皓宣
千禧年	千禧年
千秋庙	千秋廟
千秋节	千秋節
千粒重	千粒重
千英宇	千英宇
千赫兹	千赫茲
千足虫	千足蟲
千里目	千里目
千里眼	千里眼
千里足	千里足
千里达	千里達
千里镜	千里鏡
千里马	千里馬
千里驹	千里駒
千金方	千金方
千金裘	千金裘
千金记	千金記
千金躯	千金軀
千锺粟	千鍾粟
千阳县	千陽縣
千面人	千面人
千顷陂	千頃陂
升上去	升上去
升上来	升上來
升任为	升任爲
升出来	升出來
升回去	升回去
升回来	升回來
升学率	升學率
升学班	升學班
升官图	升官圖
升格为	升格爲
升格成	升格成
升级性	升級性
升级成	升級成
升级版	升級版
升结肠	升結腸
升记号	升記號
升起来	升起來
升降机	升降機
升降梯	升降梯
升降舵	升降舵
升高为	升高爲
半分钟	半分鐘
半制品	半制品
半只可	半只可
半只够	半只夠
半吊子	半吊子
半复赛	半復賽
半夜里	半夜裏
半日制	半日制
半点钟	半點鐘
半票价	半票價
半秒钟	半秒鐘
华严钟	華嚴鐘
协奏曲	協奏曲
协调出	協調出
卓别林	卓別林
单一价	單一價
单个儿	單個兒
单交种	單交種
单位制	單位制
单克隆	單克隆
单单于	單單於
单向道	單向道
单向阀	單向閥
单味药	單味藥
单婚制	單婚制
单子叶	單子葉
单字表	單字表
单干户	單幹戶
单挂号	單掛號
单方向	單方向
单方面	單方面
单曲榜	單曲榜
单板机	單板機
单面山	單面山
卖光了	賣光了
卖出去	賣出去
卖良姜	賣良姜
卖药人	賣藥人
卖面子	賣面子
南丰县	南豐縣
南京钟	南京鐘
南北向	南北向
南北极	南北極
南台湾	南臺灣
南叶门	南葉門
南回线	南迴綫
南宫适	南宮适
南山杯	南山盃
南朝梁	南朝梁
南极光	南極光
南极圈	南極圈
南极座	南極座
南极洲	南極洲
南汇区	南匯區
博士后	博士後
博客里	博客裏
博彩业	博彩業
博物志	博物志
博莱克	博萊克
博蒙特	博蒙特
卜冠文	卜冠文
卜卜米	卜卜米
卜卦家	卜卦家
卜威廉	卜威廉
卜学亮	卜學亮
卜睿哲	卜睿哲
卜窀穸	卜窀穸
卜筮官	卜筮官
卜舫济	卜舫濟
卞庄子	卞莊子
占上游	佔上游
占上风	佔上風
占下风	佔下風
占不占	佔不佔
占不足	佔不足
占世界	佔世界
占个位	佔個位
占了卜	占了卜
占优势	佔優勢
占便宜	占便宜
占停车	佔停車
占卜师	占卜師
占卜术	占卜術
占哺乳	佔哺乳
占国内	佔國內
占地步	占地步
占地盘	占地盤
占场儿	占場兒
占多数	占多數
占头筹	佔頭籌
占局部	佔局部
占市场	佔市場
占平均	佔平均
占整体	佔整體
占星学	占星學
占星家	占星家
占星师	占星師
占星术	占星術
占有权	占有權
占有欲	佔有慾
占有率	占有率
占至多	佔至多
占至少	佔至少
占花魁	占花魁
占资源	佔資源
占起来	佔起來
占超过	佔超過
占过去	佔過去
占过来	佔過來
占领军	佔領軍
占领区	佔領區
占领地	佔領地
占领者	佔領者
占鳌头	占鰲頭
卡其布	卡其布
卡卡布	卡卡布
卡布瑞	卡布瑞
卡带柜	卡帶櫃
卡扎菲	卡扎菲
卡洛里	卡洛里
卡片柜	卡片櫃
卡耶里	卡耶里
卡苏里	卡蘇里
卡路里	卡路里
卢仁杰	盧仁傑
卢克索	盧克索
卢千惠	盧千惠
卢棱伽	盧棱伽
卢贝松	盧貝松
卢郁佳	盧郁佳
卤代烃	鹵代烴
卤化物	鹵化物
卤化银	鹵化銀
卤梅水	滷梅水
卤牛肉	滷牛肉
卤素灯	鹵素燈
卤肉饭	滷肉飯
卤虾油	滷蝦油
卤鸡肉	滷雞肉
卦千纸	卦千紙
卫教系	衛教系
卫星钟	衛星鐘
卫生系	衛生系
卯上干	卯上幹
卯后酒	卯後酒
印不出	印不出
印出去	印出去
印出来	印出來
印制厂	印製廠
印刷厂	印刷廠
印刷术	印刷術
印台区	印臺區
印板儿	印板兒
印染厂	印染廠
印花布	印花布
印表机	印表機
即兴曲	即興曲
即食面	即食麵
却回去	卻回去
却回来	卻回來
卷一卷	捲一捲
卷不起	捲不起
卷动门	捲動門
卷发器	捲髮器
卷叶蛾	卷葉蛾
卷地皮	卷地皮
卷子本	卷子本
卷尾猴	捲尾猴
卷层云	卷層雲
卷層云	捲層雲
卷帘格	捲簾格
卷帘门	捲簾門
卷心菜	捲心菜
卷扬机	捲揚機
卷烟盒	捲煙盒
卷积云	卷積雲
卷笔刀	卷筆刀
卷筒纸	捲筒紙
卷线器	捲綫器
卷腿裤	捲腿褲
卷舌音	捲舌音
卷舖盖	捲舖蓋
卷落叶	捲落葉
卷衣袖	捲衣袖
卷起來	捲起來
卷起来	捲起來
卷轴式	卷軸式
卷轴装	卷軸裝
卷铺盖	捲鋪蓋
卸尸宴	卸屍宴
厂字旁	廠字旁
厂用电	廠用電
厂礼拜	廠禮拜
历下区	歷下區
历史上	歷史上
历史剧	歷史劇
历史学	歷史學
历史家	歷史家
历史性	歷史性
历史系	歷史系
历史观	歷史觀
历史课	歷史課
历史里	歷史裏
历城区	歷城區
历城县	歷城縣
历年来	歷年來
历象表	曆象表
历险记	歷險記
压克力	壓克力
压出去	壓出去
压出来	壓出來
压制住	壓制住
压制性	壓制性
压力症	壓力症
压力表	壓力表
压回去	壓回去
压回来	壓回來
压舌板	壓舌板
压面棍	壓麵棍
厌恶感	厭惡感
厌食症	厭食症
厚纸板	厚紙板
原厂药	原廠藥
原发性	原發性
原叶体	原葉體
原子云	原子雲
原子价	原子價
原子团	原子團
原子钟	原子鐘
原定价	原定價
原料药	原料藥
原纤维	原纖維
原苏联	原蘇聯
去不了	去不了
县党部	縣黨部
参与制	參與制
参与度	參與度
参与感	參與感
参与权	參與權
参与率	參與率
参与者	參與者
参两院	參兩院
参加为	參加爲
参加人	參加人
参加国	參加國
参加奖	參加獎
参加完	參加完
参加者	參加者
参同契	參同契
参宿七	參宿七
参展商	參展商
参展团	參展團
参战国	參戰國
参拾壹	參拾壹
参拾陆	參拾陸
参政权	參政權
参照卡	參照卡
参照物	參照物
参照系	參照系
参考书	參考書
参考价	參考價
参考值	參考值
参考性	參考性
参考法	參考法
参考系	參考系
参见注	參見注
参观券	參觀券
参观团	參觀團
参观完	參觀完
参观者	參觀者
参议会	參議會
参议员	參議員
参议院	參議院
参访团	參訪團
参话头	參話頭
参谋长	參謀長
参赛国	參賽國
参赛权	參賽權
参赛片	參賽片
参赛者	參賽者
参选人	參選人
又干又	又乾又
又来了	又來了
友情价	友情價
友民党	友民黨
双主修	雙主修
双凸面	雙凸面
双台子	雙臺子
双周刊	雙週刊
双回门	雙回門
双复磷	雙復磷
双子叶	雙子葉
双折射	雙折射
双挂号	雙掛號
双捻布	雙捻布
双方面	雙方面
双曲线	雙曲綫
双胜类	雙胜類
双轨制	雙軌制
双面人	雙面人
双面谍	雙面諜
反乱并	反亂併
反光板	反光板
反光面	反光面
反冲力	反衝力
反叛党	反叛黨
反回头	反回頭
反坦克	反坦克
反复制	反複製
反复性	反覆性
反对党	反對黨
反导向	反導向
反射出	反射出
反射面	反射面
反应出	反應出
反斗城	反斗城
反方向	反方向
反时针	反時針
反时钟	反時鐘
反映出	反映出
反曲弓	反曲弓
反转录	反轉錄
反面儿	反面兒
反馈表	反饋表
发上去	發上去
发上来	發上來
发下去	發下去
发下来	發下來
发不出	發不出
发不到	發不到
发不起	發不起
发个儿	發個兒
发乎情	發乎情
发令枪	發令槍
发件人	發件人
发俊科	發俊科
发信号	發信號
发像管	發像管
发光体	發光體
发光器	發光器
发光屏	發光屏
发光度	發光度
发出去	發出去
发出来	發出來
发刊词	發刊詞
发利市	發利市
发动力	發動力
发动期	發動期
发动机	發動機
发包给	發包給
发号令	發號令
发售量	發售量
发喉急	發喉急
发嘘声	發噓聲
发回去	發回去
发回来	發回來
发型师	髮型師
发声器	發聲器
发声法	發聲法
发天阴	發天陰
发头风	發頭風
发射井	發射井
发射台	發射臺
发射器	發射器
发射场	發射場
发射机	發射機
发射极	發射極
发射点	發射點
发射站	發射站
发展中	發展中
发展为	發展爲
发展出	發展出
发展到	發展到
发展区	發展區
发展史	發展史
发展局	發展局
发展性	發展性
发展成	發展成
发展观	發展觀
发展部	發展部
发布会	發佈會
发怨言	發怨言
发情期	發情期
发报人	發報人
发报员	發報員
发报器	發報器
发报机	發報機
发指令	發指令
发挥出	發揮出
发挥到	發揮到
发挥性	發揮性
发掘出	發掘出
发掘到	發掘到
发摆子	發擺子
发改委	發改委
发文者	發文者
发明人	發明人
发明到	發明到
发明奖	發明獎
发明家	發明家
发明展	發明展
发明者	發明者
发横财	發橫財
发汗剂	發汗劑
发汗药	發汗藥
发泡体	發泡體
发泡剂	發泡劑
发泡胶	發泡膠
发洋财	發洋財
发淡科	發淡科
发源地	發源地
发火器	發火器
发火点	發火點
发炎性	發炎性
发烟剂	發煙劑
发烧友	發燒友
发烧客	發燒客
发烧度	發燒度
发烧时	發燒時
发烧片	發燒片
发热时	發熱時
发热量	發熱量
发片日	發片日
发牙豆	發牙豆
发牢骚	發牢騷
发现体	發現體
发现出	發現出
发现到	發現到
发现号	發現號
发现数	發現數
发现物	發現物
发球区	發球區
发球员	發球員
发球局	發球局
发球权	發球權
发球点	發球點
发生器	發生器
发生地	發生地
发生学	發生學
发生率	發生率
发电厂	發電廠
发电场	發電場
发电所	發電所
发电机	發電機
发电板	發電板
发电站	發電站
发电量	發電量
发疹子	發疹子
发病率	發病率
发白时	發白時
发皓齿	發皓齒
发短信	發短信
发石车	發石車
发硬时	發硬時
发神经	發神經
发祥地	發祥地
发稿时	發稿时
发端词	發端詞
发老狠	發老狠
发育成	發育成
发育期	發育期
发胀感	發脹感
发脾寒	發脾寒
发脾气	發脾氣
发色勒	髮色勒
发芽势	發芽勢
发芽率	發芽率
发草帖	發草帖
发薪水	發薪水
发蜡条	髮蠟條
发行人	發行人
发行商	發行商
发行日	發行日
发行权	發行權
发行者	發行者
发行量	發行量
发行额	發行額
发表会	發表會
发表欲	發表慾
发觉出	發覺出
发觉到	發覺到
发言人	發言人
发言台	發言台
发言权	發言權
发言条	發言條
发言者	發言者
发议论	發議論
发话器	發話器
发诨子	發諢子
发语词	發語詞
发语辞	發語辭
发财票	發財票
发财金	發財金
发货单	發貨單
发起人	發起人
发起来	發起來
发达为	發達爲
发达到	發達到
发达国	發達國
发过去	發過去
发过来	發過來
发进去	發進去
发进来	發進來
发送器	發送器
发送机	發送機
发酒疯	發酒瘋
发酒风	發酒風
发酵乳	發酵乳
发酵粉	發酵粉
发问者	發問者
发阴天	發陰天
发音体	發音體
发音器	發音器
发音学	發音學
发须俱	髮鬚俱
发须已	髮鬚已
发须斑	髮鬚斑
发须皆	髮鬚皆
发须都	髮鬚都
发高烧	發高燒
发高热	發高熱
叔于田	叔于田
叔梁纥	叔梁紇
取信于	取信於
取决于	取決於
取出来	取出來
取回去	取回去
取回来	取回來
取材于	取材於
取法于	取法於
受不了	受不了
受制于	受制於
受夠了	受夠了
受得了	受得了
受托人	受託人
受托者	受託者
受折磨	受折磨
受聘于	受聘于
受阻于	受阻於
受限于	受限於
受难曲	受難曲
变不了	變不了
变出来	變出來
变回去	變回去
变回来	變回來
变奏曲	變奏曲
变形虫	變形蟲
变种人	變種人
变质岩	變質岩
变速杆	變速桿
变造出	變造出
变魔术	變魔術
叙事曲	敘事曲
叠出去	疊出去
叠出来	疊出來
叠层岩	疊層岩
叠彩区	疊彩區
口干一	口幹一
口干什	口幹什
口干冒	口干冒
口干员	口幹員
口干掉	口幹掉
口干政	口干政
口干活	口幹活
口干涉	口干涉
口干犯	口干犯
口干著	口幹著
口干这	口幹這
口干那	口幹那
口干预	口干預
口才好	口才好
口服药	口服藥
古书云	古書云
古今注	古今注
古切里	古切里
古書云	古書云
古柯叶	古柯葉
古柯咸	古柯鹹
古語云	古語云
古语云	古語云
古钟表	古鐘錶
另一回	另一回
另一种	另一種
另一面	另一面
另方面	另方面
叩头虫	叩頭蟲
只不过	只不過
只为了	只爲了
只买到	只買到
只亮出	只亮出
只亮到	只亮到
只会到	只會到
只会在	只會在
只传出	只傳出
只借到	只借到
只写出	只寫出
只写到	只寫到
只写在	只寫在
只剩下	只剩下
只加到	只加到
只占到	只佔到
只占卜	只占卜
只占吉	只占吉
只占算	只占算
只受到	只受到
只可以	只可以
只可在	只可在
只听到	只聽到
只唱出	只唱出
只唱到	只唱到
只喝到	只喝到
只回到	只回到
只回去	只回去
只回来	只回來
只因为	只因爲
只夠到	只夠到
只夠在	只夠在
只好去	只好去
只好在	只好在
只好来	只好來
只学会	只學會
只学到	只學到
只守到	只守到
只射到	只射到
只尽到	只盡到
只帮忙	只幫忙
只开出	只開出
只开到	只開到
只开去	只開去
只开回	只開回
只开来	只開來
只录到	只錄到
只得到	只得到
只怕会	只怕會
只怕是	只怕是
只想出	只想出
只想到	只想到
只想去	只想去
只想来	只想來
只愿意	只願意
只懂得	只懂得
只找出	只找出
只找到	只找到
只捉到	只捉到
只接到	只接到
只插到	只插到
只收到	只收到
只数到	只數到
只是会	只是會
只是在	只是在
只是有	只是有
只有在	只有在
只来到	只來到
只査出	只査出
只査到	只査到
只流出	只流出
只流到	只流到
只漏出	只漏出
只漏到	只漏到
只照到	只照到
只猜出	只猜出
只猜到	只猜到
只用到	只用到
只留下	只留下
只留到	只留到
只看出	只看出
只看到	只看到
只睡到	只睡到
只站到	只站到
只管出	只管出
只管到	只管到
只管去	只管去
只管在	只管在
只管来	只管來
只红到	只紅到
只经过	只經過
只考出	只考出
只考到	只考到
只肯出	只肯出
只肯到	只肯到
只肯去	只肯去
只肯在	只肯在
只肯来	只肯來
只能在	只能在
只能有	只能有
只要会	只要會
只要在	只要在
只要是	只要是
只要有	只要有
只要能	只要能
只让出	只讓出
只让到	只讓到
只记到	只記到
只记在	只記在
只记得	只記得
只讲出	只講出
只讲到	只講到
只设到	只設到
只设在	只設在
只说出	只說出
只说到	只說到
只说是	只說是
只赚到	只賺到
只走到	只走到
只赶出	只趕出
只赶到	只趕到
只赶去	只趕去
只赶回	只趕回
只赶来	只趕來
只跟到	只跟到
只跟去	只跟去
只跟在	只跟在
只跟来	只跟來
只踩到	只踩到
只身世	只身世
只身为	只身爲
只身份	只身份
只身体	只身體
只身前	只身前
只身受	只身受
只身后	只身後
只身子	只身子
只身形	只身形
只身影	只身影
只身心	只身心
只身旁	只身旁
只身材	只身材
只身段	只身段
只身边	只身邊
只身首	只身首
只身高	只身高
只转到	只轉到
只输到	只輸到
只过去	只過去
只过来	只過來
只进到	只進到
只追到	只追到
只追回	只追回
只通到	只通到
只采到	只採到
只采声	只采聲
只量出	只量出
只量到	只量到
只闯出	只闖出
只闯到	只闖到
只降到	只降到
只限于	只限於
只限到	只限到
只限在	只限在
只需要	只需要
只露出	只露出
只露到	只露到
只顾到	只顧到
只顾在	只顧在
只领到	只領到
叫出去	叫出去
叫出声	叫出聲
叫出来	叫出來
叫回去	叫回去
叫回来	叫回來
叮当响	叮當響
叮当声	叮噹聲
可仑坡	可侖坡
可免于	可免於
可喜娘	可喜娘
可回收	可回收
可好了	可好了
可干制	可乾製
可干拭	可乾拭
可干饮	可乾飲
可怜虫	可憐蟲
可愿意	可願意
可憎娘	可憎娘
可憎才	可憎才
可自制	可自制
台一线	台一綫
台七线	台七綫
台三线	台三綫
台东人	台東人
台东区	台東區
台东县	臺東縣
台东市	台東市
台东线	台東綫
台中人	台中人
台中区	台中區
台中县	臺中縣
台中场	台中場
台中市	臺中市
台中店	台中店
台中港	臺中港
台中站	台中站
台中讯	台中訊
台九线	台九綫
台企联	台企聯
台企银	台企銀
台儿庄	臺兒莊
台八线	台八綫
台制品	台製品
台前县	台前縣
台北人	臺北人
台北区	臺北區
台北县	臺北縣
台北场	台北場
台北城	台北城
台北客	台北客
台北小	台北小
台北市	臺北市
台北桥	台北橋
台北港	台北港
台北站	台北站
台北讯	台北訊
台北队	台北隊
台华轮	台華輪
台南人	台南人
台南区	台南區
台南县	臺南縣
台南市	臺南市
台南府	臺南府
台南站	台南站
台历史	台歷史
台压版	台壓版
台商圈	台商圈
台啤队	台啤隊
台子女	台子女
台子孙	台子孫
台安县	檯安縣
台客舞	台客舞
台山市	台山市
台州市	台州市
台布下	台佈下
台布告	台佈告
台布景	台布景
台布满	台佈滿
台布置	台佈置
台布署	台佈署
台布道	台佈道
台布防	台佈防
台师大	台師大
台开唱	台開唱
台开案	台開案
台式机	臺式機
台意怒	臺意怒
台指期	臺指期
台新金	臺新金
台新银	臺新銀
台期指	臺期指
台江区	臺江區
台江县	臺江縣
台湾人	臺灣人
台湾化	臺灣化
台湾区	臺灣區
台湾台	臺灣台
台湾史	臺灣史
台湾味	臺灣味
台湾团	臺灣團
台湾国	臺灣國
台湾女	臺灣女
台湾岛	臺灣島
台湾心	臺灣心
台湾日	臺灣日
台湾歌	臺灣歌
台湾版	臺灣版
台湾犬	臺灣犬
台湾玉	臺灣玉
台湾省	臺灣省
台湾社	臺灣社
台湾籍	臺灣籍
台湾米	臺灣米
台湾红	臺灣紅
台湾茶	臺灣茶
台湾菜	臺灣菜
台湾行	臺灣行
台湾话	臺灣話
台湾队	臺灣隊
台湾馆	臺灣館
台球桌	台球桌
台科大	台科大
台积电	台積電
台经院	台經院
台联会	台聯會
台联党	台聯黨
台胜科	台勝科
台胞证	臺胞證
台艺大	台藝大
台装货	台裝貨
台西乡	台西鄉
台语歌	台語歌
台车道	臺車道
台达电	台達電
台铁局	台鐵局
台面上	檯面上
台面前	台面前
台面呢	臺面呢
台风后	颱風後
台风夜	颱風夜
台风天	颱風天
台风季	颱風季
台风尾	颱風尾
台风眼	颱風眼
台风草	颱風草
台风险	颱風險
台风雨	颱風雨
台马轮	台馬輪
叱咤咤	叱咤咤
史冬鹏	史冬鵬
史垂克	史垂克
史塔克	史塔克
史崔克	史崔克
史托克	史托克
史托姆	史托姆
史托威	史托威
史托瑟	史托瑟
史査克	史査克
史瑞克	史瑞克
史瓦布	史瓦布
史翠克	史翠克
史莱克	史萊克
史达克	史達克
右后卫	右後衛
右后方	右後方
叶一茜	葉一茜
叶丁仁	葉丁仁
叶下珠	葉下珠
叶两传	葉兩傳
叶亮清	葉亮清
叶代芝	葉代芝
叶伟志	葉偉志
叶佐禹	葉佐禹
叶俊凯	葉俊凱
叶俊荣	葉俊榮
叶全真	葉全真
叶公超	葉公超
叶利钦	葉利欽
叶南铭	葉南銘
叶可欣	葉可欣
叶可蓁	葉可蓁
叶叶琹	葉叶琹
叶名琛	葉名琛
叶君璋	葉君璋
叶咏捷	葉詠捷
叶国兴	葉國興
叶圣陶	葉聖陶
叶城县	葉城縣
叶天士	葉天士
叶子列	葉子列
叶子戏	葉子戲
叶子杰	葉子杰
叶子格	葉子格
叶子烟	葉子菸
叶子纲	葉子綱
叶宗留	葉宗留
叶宗贤	葉宗賢
叶宜津	葉宜津
叶宪祖	葉憲祖
叶尔勤	葉爾勤
叶尔羌	葉爾羌
叶尔辛	葉爾辛
叶庆元	葉慶元
叶彦伯	葉彥伯
叶彰廷	葉彰廷
叶德辉	葉德輝
叶志仙	葉志仙
叶志远	葉志遠
叶恭弘	叶恭弘
叶惠青	葉惠青
叶成忠	葉成忠
叶政彦	葉政彥
叶文贵	葉文貴
叶斑病	葉斑病
叶昌桐	葉昌桐
叶明峰	葉明峰
叶明顺	葉明順
叶景栋	葉景棟
叶杰生	葉傑生
叶树姗	葉樹姍
叶根吉	葉根吉
叶正玲	葉正玲
叶步梁	葉步樑
叶永烈	葉永烈
叶永骞	葉永騫
叶江川	葉江川
叶泰兴	葉泰興
叶泽山	葉澤山
叶清照	葉清照
叶湘伦	葉湘倫
叶炳强	葉炳強
叶片状	葉片狀
叶状体	葉狀體
叶甜菜	葉甜菜
叶盛兰	葉盛蘭
叶硕堂	葉碩堂
叶礼庭	葉禮庭
叶紫华	葉紫華
叶红素	葉紅素
叶绍锜	葉紹錡
叶绿体	葉綠體
叶绿素	葉綠素
叶美君	葉美君
叶羿君	葉羿君
叶脉序	葉脈序
叶菊兰	葉菊蘭
叶菜类	葉菜類
叶蕴仪	葉蘊儀
叶蜡石	葉蠟石
叶赛莺	葉賽鶯
叶选平	葉選平
叶金川	葉金川
叶锈病	葉鏽病
叶长龙	葉長龍
叶闲花	葉閒花
叶黄素	葉黃素
叶鼻蝠	葉鼻蝠
号志机	號誌機
号志灯	號誌燈
号挂子	號掛子
号码布	號碼布
司令台	司令臺
司天台	司天臺
吃不了	吃不了
吃不出	吃不出
吃了饭	吃了飯
吃人虫	吃人蟲
吃伤了	吃傷了
吃地面	吃地面
吃完面	吃完麵
吃干了	吃乾了
吃干醋	吃乾醋
吃得了	吃得了
吃得出	吃得出
吃敲才	吃敲才
吃枪药	吃槍藥
吃药前	吃藥前
吃药后	吃藥後
吃药时	吃藥時
吃豆干	吃豆乾
吃辣面	吃辣麵
吃过面	吃過麵
吃钉板	吃釘板
吃错药	吃錯藥
吃闲话	吃閒話
吃闲饭	吃閒飯
各党派	各黨派
各回合	各回合
各团体	各團體
各干各	各幹各
各方面	各方面
各版面	各版面
各种事	各種事
各种人	各種人
各类钟	各類鐘
各系所	各系所
各院系	各院系
合不合	合不合
合不来	合不來
合众国	合眾國
合众社	合眾社
合伙人	合夥人
合体字	合體字
合作化	合作化
合作学	合作學
合作市	合作市
合作所	合作所
合作案	合作案
合作社	合作社
合作署	合作署
合作者	合作者
合作节	合作節
合八字	合八字
合历史	合歷史
合口味	合口味
合口呼	合口呼
合吃族	合吃族
合同法	合同法
合唱团	合唱團
合唱曲	合唱曲
合唱队	合唱隊
合夥人	合夥人
合奏团	合奏團
合奏曲	合奏曲
合子钱	合子錢
合子饼	合子餅
合家子	合家子
合家欢	閤家歡
合山市	合山市
合川区	合川區
合并为	合併爲
合并在	合併在
合并成	合併成
合并有	合併有
合并案	合併案
合并症	合併症
合府上	合府上
合得来	合得來
合恩角	合恩角
合情理	合情理
合意儿	合意兒
合成乳	合成乳
合成体	合成體
合成器	合成器
合成数	合成數
合成氨	合成氨
合成法	合成法
合成物	合成物
合成皮	合成皮
合成词	合成詞
合指症	合指症
合掌瓜	合掌瓜
合时宜	合時宜
合板眼	合板眼
合格率	合格率
合格者	合格者
合格证	合格證
合格赛	合格賽
合欢山	合歡山
合欢扇	合歡扇
合欢结	合歡結
合气道	合氣道
合水县	合水縣
合江县	合江縣
合江省	合江省
合法化	合法化
合法性	合法性
合流处	合流處
合浦县	合浦縣
合理化	合理化
合理性	合理性
合理标	合理標
合着者	合著者
合稀释	合稀釋
合约书	合約書
合约人	合約人
合约价	合約價
合约法	合約法
合羣性	合羣性
合股线	合股綫
合肥人	合肥人
合肥县	合肥縣
合肥市	合肥市
合胃口	合胃口
合色鞋	合色鞋
合著者	合著者
合计为	合計爲
合订本	合訂本
合议制	合議制
合议庭	合議庭
合谷穴	合谷穴
合资案	合資案
合起来	合起來
合辙儿	合轍兒
合逻辑	合邏輯
合金钢	合金鋼
合阳县	合陽縣
合龙门	合龍門
吉丁当	吉丁當
吉卜赛	吉卜賽
吉卜龄	吉卜齡
吉布兹	吉布茲
吉布地	吉布地
吉布提	吉布提
吉布森	吉布森
吉蔑族	吉蔑族
吊上去	吊上去
吊上来	吊上來
吊下去	吊下去
吊下来	吊下來
吊嗓子	吊嗓子
吊客眉	吊客眉
吊带衫	吊帶衫
吊带裤	吊帶褲
吊挂在	吊掛在
吊挂着	吊掛着
吊档裤	吊檔褲
吊死鬼	吊死鬼
吊瓶族	吊瓶族
吊胃口	吊胃口
吊脚儿	吊腳兒
吊膀子	弔膀子
吊衣架	吊衣架
吊袜带	吊襪帶
吊裤带	吊褲帶
吊起来	吊起來
吊车尾	吊車尾
吊钢丝	吊鋼絲
同一个	同一個
同一人	同一人
同一场	同一場
同一型	同一型
同一处	同一處
同一家	同一家
同一年	同一年
同一座	同一座
同一性	同一性
同一所	同一所
同一片	同一片
同一班	同一班
同一组	同一組
同义字	同義字
同义词	同義詞
同义语	同義語
同乐会	同樂會
同乡会	同鄉會
同事家	同事家
同人女	同人女
同人志	同人誌
同仁县	同仁縣
同仁堂	同仁堂
同位素	同位素
同位角	同位角
同位语	同位語
同余式	同餘式
同余类	同餘類
同分数	同分數
同动词	同動詞
同名数	同名數
同命鸟	同命鳥
同型性	同型性
同型机	同型機
同字框	同字框
同学们	同學們
同学会	同學會
同学家	同學家
同学录	同學錄
同学路	同學路
同安区	同安區
同安县	同安縣
同安街	同安街
同居人	同居人
同年代	同年代
同年级	同年級
同形词	同形詞
同德县	同德縣
同心县	同心縣
同心圆	同心圓
同心结	同心結
同心髻	同心髻
同性恋	同性戀
同性爱	同性愛
同情心	同情心
同情者	同情者
同意书	同意書
同意权	同意權
同意案	同意案
同意票	同意票
同文馆	同文館
同斜层	同斜層
同日生	同日生
同时代	同時代
同时候	同時候
同时期	同時期
同林鸟	同林鳥
同样会	同樣會
同样在	同樣在
同样地	同樣地
同样是	同樣是
同案犯	同案犯
同江市	同江市
同济会	同濟會
同温层	同溫層
同源词	同源詞
同理心	同理心
同甘苦	同甘苦
同生死	同生死
同盟会	同盟會
同盟党	同盟黨
同盟军	同盟軍
同盟国	同盟國
同盟者	同盟者
同类色	同類色
同类项	同類項
同级车	同級車
同罗杯	同羅杯
同翅目	同翅目
同考官	同考官
同胞爱	同胞愛
同舍生	同舍生
同行语	同行語
同衾帱	同衾幬
同言线	同言綫
同语线	同語綫
同谋者	同謀者
同质性	同質性
同路人	同路人
同轴圆	同軸圓
同道者	同道者
同门友	同門友
同音字	同音字
同音词	同音詞
同韵词	同韻詞
同龄人	同齡人
同龄林	同齡林
名人录	名人錄
名次表	名次表
名言录	名言錄
后七子	後七子
后上去	後上去
后上来	後上來
后下去	後下去
后下来	後下來
后两者	後兩者
后元音	後元音
后冷战	後冷戰
后劲溪	後勁溪
后勤区	後勤區
后勤学	後勤學
后勤部	後勤部
后北街	后北街
后医系	後醫系
后半世	後半世
后半叶	後半葉
后半场	後半場
后半夜	後半夜
后半天	後半天
后半季	後半季
后半晌	後半晌
后半期	後半期
后半段	後半段
后半部	後半部
后发座	后髮座
后坐力	後坐力
后壁乡	後壁鄉
后壁湖	後壁湖
后备军	後備軍
后备部	後備部
后天性	後天性
后奏曲	後奏曲
后婚儿	後婚兒
后学儿	後學兒
后安路	后安路
后尧婆	後堯婆
后尾儿	後尾兒
后平路	后平路
后座力	後座力
后座系	後座繫
后庭花	後庭花
后感觉	後感覺
后手儿	後手兒
后手钱	後手錢
后挡板	後擋板
后掠翼	後掠翼
后掠角	後掠角
后掩蔽	後掩蔽
后援会	後援會
后援军	後援軍
后方区	後方區
后望镜	後望鏡
后来人	後來人
后段班	後段班
后汉书	後漢書
后汉纪	後漢紀
后海湾	后海灣
后海灣	后海灣
后滚翻	後滾翻
后照镜	後照鏡
后现代	後現代
后甲板	後甲板
后空翻	後空翻
后竹围	後竹圍
后续力	後續力
后罩房	後罩房
后置词	後置詞
后脑勺	後腦勺
后脑杓	後腦杓
后脸儿	後臉兒
后腿肉	後腿肉
后舱门	後艙門
后花园	後花園
后菜园	後菜園
后视镜	後視鏡
后起字	後起字
后车站	後車站
后车轴	後車軸
后边儿	後邊兒
后退色	後退色
后遗症	後遺症
后里乡	后里鄉
后钩儿	後鉤兒
后院子	後院子
后面店	後面店
后髮座	后髮座
后鼻音	後鼻音
后龙溪	後龍溪
后龙镇	後龍鎮
吐出来	吐出來
吐谷浑	吐谷渾
吐露出	吐露出
向上地	向上地
向东看	向東看
向东走	向東走
向何处	向何處
向光性	向光性
向內走	向內走
向前看	向前看
向前走	向前走
向前进	向前進
向北地	向北地
向北看	向北看
向北走	向北走
向南看	向南看
向南走	向南走
向右拐	向右拐
向右看	向右看
向右转	向右轉
向后冲	向後衝
向后看	向後看
向后走	向後走
向后转	向後轉
向地性	向地性
向培良	向培良
向外冲	向外衝
向外看	向外看
向外走	向外走
向导员	嚮導員
向导犬	嚮導犬
向左拐	向左拐
向左看	向左看
向左转	向左轉
向往常	向往常
向往日	向往日
向往时	向往時
向往来	向往來
向心力	向心力
向心店	向心店
向斜层	向斜層
向日性	向日性
向日葵	向日葵
向来是	向來是
向溼性	向溼性
向电性	向電性
向秀丽	向秀麗
向西南	向西南
向钱看	向錢看
向阳信	向陽信
向阳区	向陽區
向风针	向風針
吓不了	嚇不了
吕宋烟	呂宋菸
吕布戟	呂布戟
吕梁山	呂梁山
吕梁市	呂梁市
吕芳烟	呂芳煙
吕蒙正	呂蒙正
吕贝克	呂貝克
吗啡针	嗎啡針
君主制	君主制
君合国	君合國
吧托女	吧托女
吨公里	噸公里
含油岩	含油岩
听不出	聽不出
听出来	聽出來
听墙面	聽牆面
听得出	聽得出
听腻了	聽膩了
听见了	聽見了
听骨链	聽骨鏈
启发式	啓發式
启发性	啓發性
启发法	啓發法
启示录	啓示錄
吴俊杰	吳俊傑
吴克羣	吳克羣
吴嘉种	吳嘉種
吴复连	吳復連
吴嶽修	吳嶽修
吴幸桦	吳幸樺
吴志伟	吳志偉
吴志扬	吳志揚
吴志祺	吳志祺
吴志远	吳志遠
吴皓升	吳皓昇
吴育升	吳育昇
吴荣杰	吳榮杰
吴蒙惠	吳蒙惠
吴越曲	吳越曲
吴采璋	吳采璋
吴里克	吳里克
吴隆杰	吳隆傑
吸出去	吸出去
吸出来	吸出來
吸回去	吸回去
吸回来	吸回來
吸地板	吸地板
吸烟区	吸煙區
吸烟客	吸煙客
吸烟室	吸煙室
吸烟族	吸菸族
吸烟率	吸菸率
吸烟者	吸煙者
吸管虫	吸管蟲
吸虫纲	吸蟲綱
吸血虫	吸血蟲
吹出去	吹出去
吹出来	吹出來
吹叶机	吹葉機
吹头发	吹頭髮
吹胡子	吹鬍子
吻别时	吻別時
呆呆兽	呆呆獸
呆小症	呆小症
呆憨呆	呆憨呆
呆致致	呆緻緻
呈现出	呈現出
告别式	告別式
告示板	告示板
呕出物	嘔出物
员山庄	員山庄
周一岳	周一嶽
周世惠	周世惠
周东昱	周東昱
周丽淇	周麗淇
周亚夫	周亞夫
周传瑛	周傳瑛
周传英	周傳英
周传雄	周傳雄
周作人	周作人
周佳佑	周佳佑
周佳琦	周佳琦
周俊三	周俊三
周俊勳	周俊勳
周公瑾	周公瑾
周六日	週六日
周典论	周典論
周华健	周華健
周历史	周歷史
周厉王	周厲王
周口市	周口市
周口店	周口店
周台竹	周台竹
周围人	周圍人
周培蕾	周培蕾
周士榆	周士榆
周士渊	周士淵
周大福	周大福
周奕成	周奕成
周妙音	周妙音
周孟晔	周孟曄
周宁县	周寧縣
周守训	周守訓
周宏哲	周宏哲
周宏室	周宏室
周定纬	周定緯
周宣王	周宣王
周小川	周小川
周平王	周平王
周年庆	週年慶
周幼婷	周幼婷
周幽王	周幽王
周庄王	周莊王
周庄镇	周莊鎮
周康王	周康王
周弘宪	周弘憲
周志全	周志全
周志浩	周志浩
周志诚	周志誠
周思源	周思源
周思齐	周思齊
周总理	周總理
周恒毅	周恆毅
周恩来	周恩來
周慧敏	周慧敏
周成王	周成王
周承玮	周承瑋
周敏鸿	周敏鴻
周敦颐	周敦頤
周文王	周文王
周日版	週日版
周星驰	周星馳
周春秀	周春秀
周晓涵	周曉涵
周期律	週期律
周期性	週期性
周期数	週期數
周期系	週期系
周期表	週期表
周期解	週期解
周村区	周村區
周杰伦	周杰倫
周柏臣	周柏臣
周树人	周樹人
周梦瑶	周夢瑤
周武王	周武王
周武雄	周武雄
周永康	周永康
周永明	周永明
周治平	周治平
周泓谕	周泓諭
周海媚	周海媚
周润发	周潤發
周渝民	周渝民
周游券	周遊券
周灿德	周燦德
周王朝	周王朝
周瘦鹃	周瘦鹃
周盈成	周盈成
周盈文	周盈文
周盛渊	周盛淵
周礼良	周禮良
周秀霞	周秀霞
周穆王	周穆王
周立昌	周立昌
周立波	周立波
周筱涵	周筱涵
周经凯	周經凱
周美里	周美里
周美青	周美青
周至县	周至縣
周蓓姬	周蓓姬
周赐海	周賜海
周赧王	周赧王
周走秀	週走秀
周转率	週轉率
周转金	周轉金
周遭人	週遭人
周邦彦	周邦彥
周郎癖	周郎癖
周采诗	周采詩
周锡玮	周錫瑋
周锦贵	周錦貴
周雅淑	周雅淑
周韫维	周韞維
呼出来	呼出來
命世才	命世才
咀嚼出	咀嚼出
和克制	和剋制
和合僧	和合僧
和合日	和合日
和合汤	和合湯
和平里	和平里
咒印术	咒印術
咕咕钟	咕咕鐘
咖啡杯	咖啡杯
咬屁虫	咬屁蟲
咭叮当	咭叮噹
咭当当	咭噹噹
咳嗽药	咳嗽藥
咸丝丝	鹹絲絲
咸丰县	咸豐縣
咸丰草	咸豐草
咸兴市	咸興市
咸宁市	咸寧市
咸安区	咸安區
咸水妹	鹹水妹
咸水湖	鹹水湖
咸水鱼	鹹水魚
咸津津	鹹津津
咸猪手	鹹豬手
咸猪肉	鹹豬肉
咸菜干	鹹菜乾
咸认为	咸認爲
咸酥鸡	鹹酥雞
咸镜道	咸鏡道
咸阳宫	咸陽宮
咸阳市	咸陽市
咸阳桥	咸陽橋
咸阳火	咸陽火
咸鸭蛋	鹹鴨蛋
咽不了	嚥不了
品尝会	品嚐會
品尝到	品嚐到
品莲台	品蓮臺
哈丰角	哈豐角
哈利发	哈利發
哈卡里	哈卡里
哈发林	哈發林
哈萨克	哈薩克
哈里发	哈里發
哈里尔	哈里爾
哈里斯	哈里斯
哈里逊	哈里遜
哈里里	哈里里
响叮当	響叮噹
响当当	響噹噹
哥伦布	哥倫布
哥萨克	哥薩克
哪一个	哪一個
哪一出	哪一齣
哪个人	哪個人
哪个月	哪個月
哪几个	哪幾個
哪几天	哪幾天
哪几次	哪幾次
哪方面	哪方面
哪种人	哪種人
哪里买	哪裏買
哪里人	哪裏人
哭个夠	哭個夠
哭出来	哭出來
哭秋风	哭秋風
哲学系	哲學系
唐三彩	唐三彩
唐志中	唐志中
唐才常	唐才常
唐氏症	唐氏症
唐美云	唐美雲
售价为	售價爲
售后部	售後部
售货台	售貨臺
唯一只	唯一只
唱出来	唱出來
唱回去	唱回去
唱回来	唱回來
啃书虫	啃書蟲
啄针儿	啄針兒
商历史	商歷史
商学系	商學系
啤酒厂	啤酒廠
喀布尔	喀布爾
喂偏食	喂偏食
喂动物	餵動物
喂奶时	餵奶時
喂母乳	餵母乳
喇叭虫	喇叭蟲
喊出去	喊出去
喊出来	喊出來
喊回去	喊回去
喊回来	喊回來
喘吁吁	喘吁吁
喜冲冲	喜衝衝
喜向往	喜向往
喜欢表	喜歡錶
喜欢钟	喜歡鐘
喜虫儿	喜蟲兒
喝交杯	喝交杯
喝倒彩	喝倒彩
喝倒采	喝倒采
喝彩声	喝彩聲
喷出去	噴出去
喷出口	噴出口
喷出来	噴出來
嗜眠症	嗜眠症
嗜睡症	嗜睡症
嘉言录	嘉言錄
嘘下台	噓下台
嘴答谷	嘴答谷
器物录	器物錄
噫吁戏	噫吁戲
噶大克	噶大克
噶布伦	噶布倫
噶当派	噶當派
嚷出去	嚷出去
嚷出来	嚷出來
嚼不了	嚼不了
四万万	四萬萬
四万个	四萬個
四万人	四萬人
四万元	四萬元
四万块	四萬塊
四万多	四萬多
四万馀	四萬餘
四下里	四下裏
四个人	四個人
四个月	四個月
四出戏	四齣戲
四分历	四分曆
四分钟	四分鐘
四十万	四十萬
四十几	四十幾
四千万	四千萬
四千个	四千個
四千人	四千人
四千亿	四千億
四千元	四千元
四千块	四千塊
四千多	四千多
四号台	四號台
四合一	四合一
四合房	四合房
四合院	四合院
四周围	四周圍
四周年	四週年
四天后	四天後
四年制	四年制
四才子	四才子
四方台	四方臺
四星彩	四星彩
四极管	四極管
四洲志	四洲志
四点钟	四點鐘
四百万	四百萬
四百个	四百個
四秒钟	四秒鐘
四部曲	四部曲
四面体	四面體
四面佛	四面佛
四面包	四面包
四面钟	四面鐘
回一回	回一回
回不了	回不了
回光镜	回光鏡
回力棒	回力棒
回力球	回力球
回单儿	回單兒
回历史	回歷史
回回历	回回曆
回回青	回回青
回墨印	回墨印
回声报	迴聲報
回复到	回復到
回头书	回頭書
回头人	回頭人
回头儿	回頭兒
回头客	回頭客
回头草	回頭草
回头见	回頭見
回头路	回頭路
回娘家	回娘家
回家乐	回家樂
回家路	回家路
回归到	回歸到
回归年	回歸年
回归潮	回歸潮
回归热	回歸熱
回归线	回歸綫
回形夹	迴形夾
回得去	回得去
回得来	回得來
回忆录	回憶錄
回忆说	回憶說
回忆起	回憶起
回想到	回想到
回想起	回想起
回报率	回報率
回收商	回收商
回收场	回收場
回收物	回收物
回收率	回收率
回收站	回收站
回收量	回收量
回教人	回教人
回教党	回教黨
回教国	回教國
回教徒	回教徒
回数票	回數票
回文对	迴文對
回文诗	迴文詩
回文锦	迴文錦
回旋器	迴旋器
回旋曲	迴旋曲
回旋梯	回旋梯
回族人	回族人
回来路	回來路
回民区	回民區
回溯到	回溯到
回潮率	回潮率
回盲瓣	迴盲瓣
回票面	回票面
回答到	回答到
回答说	回答說
回纥兵	回紇兵
回纥军	回紇軍
回纹针	迴紋針
回老家	回老家
回良玉	回良玉
回西流	回西流
回购额	回購額
回车键	回車鍵
回转仪	迴轉儀
回过来	回過來
回过神	回過神
回递性	迴遞性
回锅油	回锅油
回锅肉	回鍋肉
回页首	回頁首
回顾展	回顧展
回飞棒	回飛棒
回馈到	回饋到
回馈性	回饋性
回馈给	回饋給
回馈金	回饋金
回马枪	回馬槍
回鱼箸	回魚箸
回鹘文	回鶻文
团体奖	團體獎
团体性	團體性
团体操	團體操
团体票	團體票
团体组	團體組
团体行	團體行
团体赛	團體賽
团团转	團團轉
团圆夜	團圓夜
团圆日	團圓日
团圆节	團圓節
团圆饭	團圓飯
团扇妾	團扇妾
团管区	團管區
团队奖	團隊獎
团队报	團隊報
团队赛	團隊賽
团风县	團風縣
团香扇	團香扇
团龙儿	團龍兒
园游会	園遊會
园游券	園遊券
困腾腾	困騰騰
困难度	困難度
困难点	困難點
围困在	圍困在
固定制	固定制
固定术	固定術
国一制	國一制
国乐团	國樂團
国会制	國會制
国别史	國別史
国剧团	國劇團
国历代	國歷代
国历任	國歷任
国历史	國歷史
国历尽	國歷盡
国历届	國歷屆
国历年	國歷年
国历经	國歷經
国历险	國歷險
国发院	國發院
国台办	國臺辦
国台语	國台語
国合会	國合會
国大党	國大黨
国家党	國家黨
国家杯	國家杯
国术团	國術團
国术社	國術社
国术馆	國術館
国民党	國民黨
国王杯	國王杯
国社党	國社黨
国贸系	國貿系
国际台	國際臺
国际柜	國際櫃
圆周率	圓周率
圆周角	圓周角
圆板状	圓板狀
圆柱面	圓柱面
圆舞曲	圓舞曲
圆锥台	圓錐台
圆面积	圓面積
圆面饼	圓麵餅
圈子里	圈子裏
圈里人	圈裏人
土制品	土製品
土托鱼	土托魚
土木系	土木系
土谷祠	土穀祠
土霉素	土黴素
圣拉蒙	聖拉蒙
圣火台	聖火台
圣胡安	聖胡安
圣诞叶	聖誕葉
圣餐台	聖餐檯
圣餐布	聖餐布
在下面	在下面
在克制	在剋制
在制品	在制品
在家修	在家修
在此后	在此後
在眼里	在眼裏
在规范	在規範
在野党	在野黨
地一卷	地一捲
地价税	地價稅
地克制	地剋制
地制法	地制法
地区党	地區黨
地干吧	地幹吧
地平面	地平面
地方志	地方志
地板操	地板操
地狱谷	地獄谷
地理极	地理極
地瓜叶	地瓜葉
地瓜签	地瓜簽
地瓜面	地瓜面
地缝里	地縫裏
地表水	地表水
地里鬼	地裏鬼
地面上	地面上
地面下	地面下
地面层	地面層
地面水	地面水
地面站	地面站
场记板	場記板
均一价	均一價
均田制	均田制
坏家伙	壞家伙
坐台子	坐檯子
坐如钟	坐如鐘
坐板疮	坐板瘡
坐标系	座標系
坐萝卜	坐蘿蔔
坛佳酿	罈佳釀
坛好酒	罈好酒
坛白干	罈白干
坛美酒	罈美酒
坛老酒	罈老酒
坛陈年	罈陳年
坛高粱	罈高粱
坡布莱	坡布萊
坦克兵	坦克兵
坦克型	坦克型
坦克车	坦克車
坦荡荡	坦蕩蕩
垂直于	垂直於
垂直面	垂直面
垃圾虫	垃圾蟲
垣曲县	垣曲縣
垦丁杯	墾丁盃
垫出去	墊出去
垫出来	墊出來
垫回去	墊回去
垫回来	墊回來
埃克托	埃克托
埃及历	埃及曆
埃布罗	埃布羅
埃荣冲	埃榮衝
埃里温	埃裏溫
埔里镇	埔里鎮
埤塘里	埤塘里
培养出	培養出
培尔松	培爾松
培植出	培植出
培育出	培育出
基准兵	基準兵
基准日	基準日
基准法	基準法
基准点	基準點
基准线	基準綫
基准面	基準面
基地台	基地台
基布兹	基布茲
基本面	基本面
基民党	基民黨
堂后官	堂後官
堕胎药	墮胎藥
堪舆术	堪輿術
塑炼机	塑煉機
塑胶制	塑膠製
塑胶布	塑膠布
塑胶杯	塑膠杯
塑胶板	塑膠板
塑造出	塑造出
塔什干	塔什干
塔克辛	塔克辛
塔吉克	塔吉克
塔里木	塔里木
塔里班	塔里班
塞上曲	塞上曲
塞下曲	塞下曲
塞克森	塞克森
填表格	填表格
墓志铭	墓誌銘
墨斗鱼	墨斗魚
墨沈沈	墨沈沈
墨荡子	墨盪子
壮阳药	壯陽藥
壹个人	壹個人
壹周刊	壹週刊
处方药	處方藥
处理厂	處理廠
处理表	處理表
备忘录	備忘錄
备注栏	備註欄
复习考	複習考
复亩珍	複畝珍
复仇者	復仇者
复仇记	復仇記
复健科	復健科
复健赛	復健賽
复元音	複元音
复共轭	複共軛
复兴乡	復興鄉
复兴党	復興黨
复兴区	復興區
复兴号	復興號
复兴岗	復興崗
复兴岛	復興島
复兴社	復興社
复兴路	復興路
复兴门	復興門
复兴馆	復興館
复写纸	複寫紙
复决权	複決權
复函数	複函數
复分数	複分數
复分析	複分析
复分解	複分解
复利法	複利法
复利率	複利率
复制出	複製出
复制品	複製品
复华金	復華金
复印品	複印品
复印机	複印機
复印纸	複印紙
复原期	復原期
复发性	復發性
复发率	復發率
复古会	復古會
复古风	復古風
复合体	複合體
复合光	複合光
复合句	複合句
复合国	複合國
复合型	複合型
复合字	複合字
复合年	複合年
复合式	複合式
复合性	複合性
复合技	複合技
复合机	複合機
复合板	複合板
复合架	複合架
复合模	複合模
复合物	複合物
复合管	複合管
复合膜	複合膜
复合药	複合藥
复合词	複合詞
复名数	複名數
复名词	複名詞
复员令	復員令
复品牌	複品牌
复基因	複基因
复婚制	複婚制
复字键	複字鍵
复学生	復學生
复对数	複對數
复平面	複平面
复拍子	複拍子
复数域	複數域
复数形	複數形
复旦桥	復旦橋
复杂化	複雜化
复杂度	複雜度
复杂性	複雜性
复殖目	複殖目
复比例	複比例
复活岛	復活島
复活日	復活日
复活节	復活節
复活赛	復活賽
复盆子	覆盆子
复盖住	覆蓋住
复盖率	覆蓋率
复盖面	覆蓋面
复相关	複相關
复综语	複綜語
复色光	複色光
复苏期	復甦期
复苏术	復甦術
复读生	復讀生
复辅音	複輔音
复选题	複選題
复酱瓿	覆醬瓿
复音形	複音形
复音词	複音詞
复韵母	複韻母
夏于乔	夏于喬
夏于喬	夏于喬
夏历史	夏歷史
夏后氏	夏后氏
夏商周	夏商周
夏天里	夏天裏
夏日里	夏日裏
夏时制	夏時制
夏洛克	夏洛克
夏里夫	夏里夫
外交团	外交團
外交系	外交系
外出服	外出服
外出血	外出血
外出装	外出裝
外后日	外後日
外向型	外向型
外挂式	外掛式
外文系	外文係
外来种	外來種
外汇局	外匯局
外用药	外用藥
外聘制	外聘制
外蒙古	外蒙古
外表上	外表上
外语系	外語系
外调制	外調制
外面情	外面情
多云偶	多雲偶
多侧面	多側面
多党制	多黨制
多出来	多出來
多动症	多動症
多半只	多半只
多发性	多發性
多发病	多發病
多只会	多只會
多只可	多只可
多只在	多只在
多只是	多只是
多只有	多只有
多只能	多只能
多只需	多只需
多天后	多天後
多妻制	多妻制
多少只	多少隻
多层复	多層複
多平台	多平臺
多指症	多指症
多数党	多數黨
多方面	多方面
多极化	多極化
多汗症	多汗症
多面体	多面體
多面性	多面性
多面手	多面手
多面角	多面角
夜儿个	夜兒個
夜光云	夜光雲
夜光杯	夜光杯
夜光虫	夜光蟲
夜光表	夜光錶
夜合花	夜合花
夜合钱	夜合錢
夜尿症	夜尿症
夜度娘	夜度娘
夜惊症	夜驚症
夜游子	夜遊子
夜游神	夜遊神
夜游队	夜遊隊
夜盲症	夜盲症
够克制	夠剋制
够钟情	夠鍾情
够钟爱	夠鍾愛
夠面子	夠面子
大不了	大不了
大专杯	大專杯
大个儿	大個兒
大个子	大個子
大丰市	大豐市
大丰收	大豐收
大丰簋	大豐簋
大人药	大人藥
大价钱	大價錢
大伙人	大夥人
大伙儿	大夥兒
大余县	大餘縣
大修理	大修理
大借款	大借款
大兵团	大兵團
大减价	大減價
大出丧	大出喪
大出手	大出手
大出血	大出血
大利面	大利麵
大别山	大別山
大制作	大製作
大单于	大單于
大卤面	大滷麵
大厂县	大廠縣
大历史	大歷史
大只会	大只會
大只可	大只可
大只在	大只在
大只是	大只是
大只有	大只有
大只能	大只能
大只需	大只需
大台北	大台北
大叶桉	大葉桉
大合唱	大合唱
大同乡	大同鄉
大同书	大同書
大同区	大同區
大同县	大同縣
大同市	大同市
大同教	大同教
大同盟	大同盟
大同路	大同路
大后天	大後天
大后年	大後年
大后方	大後方
大周后	大周后
大周折	大週摺
大回朝	大回朝
大团圆	大團圓
大团结	大團結
大场面	大場面
大型钟	大型鐘
大夫松	大夫松
大头症	大頭症
大头针	大頭針
大姑娘	大姑娘
大娘子	大娘子
大岩桐	大岩桐
大峡谷	大峽谷
大布棚	大布棚
大廉价	大廉價
大折儿	大摺兒
大抚台	大撫臺
大方向	大方向
大明历	大明曆
大曲道	大曲道
大曲酒	大麴酒
大本钟	大本鐘
大来历	大來歷
大板根	大板根
大板车	大板車
大武仑	大武崙
大气团	大氣團
大气系	大氣系
大润发	大潤發
大爱台	大愛台
大班制	大班制
大理岩	大理岩
大秋元	大秋元
大笨钟	大笨鐘
大精彩	大精彩
大老板	大老闆
大胡子	大鬍子
大腔当	大腔當
大致上	大致上
大花面	大花面
大苏打	大蘇打
大范围	大範圍
大衍历	大衍曆
大表哥	大表哥
大表妹	大表妹
大表姊	大表姊
大表弟	大表弟
大裂谷	大裂谷
大迦叶	大迦葉
大里市	大里市
大里溪	大里溪
大陆团	大陸團
大集合	大集合
大风后	大風後
大风鉴	大風鑑
大食团	大食團
大麦克	大麥克
大麻烟	大麻煙
大麻里	大麻里
大黑松	大黑松
天历史	天歷史
天台县	天台縣
天台女	天台女
天台宗	天台宗
天台山	天台山
天后宫	天后宮
天后站	天后站
天后级	天后級
天坛座	天壇座
天心岩	天心岩
天才型	天才型
天才论	天才論
天文台	天文臺
天文钟	天文鐘
天生干	天生幹
天纳克	天納克
天花板	天花板
天门冬	天門冬
太仆寺	太僕寺
太初历	太初曆
太好了	太好了
太子党	太子黨
太扯了	太扯了
太极剑	太極劍
太极图	太極圖
太极拳	太極拳
太极门	太極門
太空游	太空遊
太谷县	太谷縣
太谷灯	太谷燈
太阳升	太陽升
太阳历	太陽曆
太阳系	太陽系
太阳谷	太陽谷
太阴历	太陰曆
太麻里	太麻里
失体面	失體面
失忆症	失憶症
失智症	失智症
失眠症	失眠症
失语症	失語症
失读症	失讀症
失调症	失調症
失面子	失面子
头一回	頭一回
头向前	頭向前
头朝里	頭朝裏
头花发	頭花髮
头足愿	頭足願
夷坚志	夷堅志
夸克星	夸克星
夸大狂	誇大狂
夸张法	誇張法
夸海口	誇海口
夸起来	誇起來
夹布子	夾布子
夹当儿	夾當兒
夹彩塑	夾彩塑
夹板气	夾板氣
夹板船	夾板船
夹注号	夾注號
夺回去	奪回去
夺回来	奪回來
奇努克	奇努克
奇台县	奇台縣
奇里安	奇里安
奉献出	奉獻出
奉苹蘩	奉蘋蘩
奉蒸尝	奉蒸嘗
奎松市	奎松市
奏出去	奏出去
奏出来	奏出來
奏鸣曲	奏鳴曲
契努克	契努克
契合度	契合度
奔回来	奔回來
套出来	套出來
套问出	套問出
套马杆	套馬桿
奥万大	奧萬大
奥克兰	奧克蘭
奥克明	奧克明
奥克蒙	奧克蒙
奥布里	奧布里
奥拜克	奧拜克
奥运团	奧運團
奥里斯	奧里斯
奥里萨	奧里薩
奥陶系	奧陶系
女乳症	女乳症
女仆部	女僕部
女佣人	女佣人
女修士	女修士
女修道	女修道
女同志	女同志
女同胞	女同胞
女宿舍	女宿舍
女王杯	女王杯
女秀才	女秀才
女舍监	女舍監
女药头	女藥頭
奴儿干	奴兒干
奴隶制	奴隸制
奶制品	奶製品
她克制	她剋制
她出去	她出去
她出来	她出來
好一出	好一齣
好不了	好不了
好了吗	好了嗎
好了吧	好了吧
好了歌	好了歌
好体面	好體面
好傢伙	好傢伙
好几万	好幾萬
好几个	好幾個
好几亿	好幾億
好几十	好幾十
好几千	好幾千
好几天	好幾天
好几年	好幾年
好几百	好幾百
好困吧	好睏吧
好困啊	好睏啊
好多个	好多個
好好干	好好幹
好家伙	好傢夥
好彩头	好彩頭
好斗大	好斗大
好斗室	好斗室
好斗笠	好斗笠
好斗篷	好斗篷
好斗胆	好斗膽
好斗蓬	好斗蓬
好极了	好極了
好立克	好立克
好胜心	好勝心
好采头	好采頭
好面子	好面子
如何干	如何幹
如果干	如果幹
妄想症	妄想症
妖精谷	妖精谷
妙极了	妙極了
妥当人	妥當人
姑娘家	姑娘家
委员制	委員制
委托书	委託書
委托人	委托人
姘出去	姘出去
姚俊杰	姚俊傑
姚升志	姚昇志
姚志源	姚志源
姚采颖	姚采穎
姜丰年	姜豐年
姜凤君	姜鳳君
姜切片	薑切片
姜堰市	薑堰市
姜大宇	姜大宇
姜太公	薑太公
姜子牙	薑子牙
姜宸英	姜宸英
姜建铭	姜建銘
姜愈老	薑愈老
姜文杰	姜文杰
姜是老	薑是老
姜母鸭	薑母鴨
姜沧源	姜滄源
姜石年	薑石年
姜竹祥	姜竹祥
姜维平	姜維平
姜老辣	薑老辣
姜至奂	姜至奐
姜辣素	薑辣素
姜远珍	姜遠珍
姜郁美	姜郁美
姜金龙	姜金龍
姜锡柱	姜錫柱
姜麻园	薑麻園
姜黄素	薑黃素
姜黄色	薑黃色
姬松茸	姬松茸
威克岛	威克島
威克斯	威克斯
威克森	威克森
威奇托	威奇托
威里斯	威里斯
娘儿们	娘兒們
娘儿俩	孃兒倆
娘娘庙	娘娘廟
娘娘腔	娘娘腔
娘子关	娘子關
娘子军	娘子軍
娘家姓	娘家姓
娘母子	娘母子
娘老子	娘老子
娱乐台	娛樂台
娶回家	娶回家
婆娘子	婆娘子
嫁出去	嫁出去
嫁出来	嫁出來
嫁祸于	嫁禍於
子目录	子目錄
子系统	子系統
子集合	子集合
孕穗期	孕穗期
孕育出	孕育出
字根表	字根表
字母表	字母表
字码表	字碼表
字面上	字面上
字音表	字音表
存托股	存托股
孙协志	孫協志
孙大千	孫大千
孙胜男	孫勝男
孟姜女	孟姜女
孟小冬	孟小冬
孟尝君	孟嘗君
孢子叶	孢子葉
孢子虫	孢子蟲
季后赛	季後賽
孤儿药	孤兒藥
孤拐面	孤拐面
学习团	學習團
学分制	學分制
学区制	學區制
学名药	學名藥
学员制	學員制
学回去	學回去
学回来	學回來
学徒制	學徒制
学术奖	學術獎
学术性	學術性
学术界	學術界
学术科	學術科
学术组	學術組
学籍表	學籍表
学经历	學經歷
学长制	學長制
孩儿面	孩兒面
孵出来	孵出來
宇宙云	宇宙雲
宇宙志	宇宙誌
安万特	安萬特
安克拉	安克拉
安可曲	安可曲
安山岩	安山岩
安席克	安席克
安眠药	安眠藥
安胎药	安胎藥
安萨里	安薩里
安钦云	安欽雲
安魂曲	安魂曲
宋三彩	宋三彩
完全叶	完全葉
完工后	完工後
完成后	完成後
宗周钟	宗周鐘
宗教团	宗教團
官历史	官歷史
官台木	官台木
官料药	官料藥
官板儿	官板兒
官能团	官能團
官能症	官能症
官面儿	官面兒
定义出	定義出
定出来	定出來
定制化	定制化
定南针	定南針
定时钟	定時鐘
定点厂	定點廠
定碳杯	定碳杯
定胜败	定勝敗
定范围	定範圍
定计划	定計劃
定都于	定都於
定风针	定風針
宜丰县	宜豐縣
宝丰县	寶豐縣
宝历史	寶歷史
宝山庄	寶山庄
宝贝团	寶貝團
实名制	實名制
实干家	實幹家
实质面	實質面
客制化	客製化
宣传周	宣傳週
宣室志	宣室志
宫里蓝	宮里藍
害人虫	害人蟲
家具体	家具體
家具备	家具備
家具有	家具有
家具行	家具行
家山药	家山藥
家政系	家政系
家机布	家機布
家里的	家裏的
家长制	家長制
宿松县	宿松縣
宿舍区	宿舍區
宿舍楼	宿舍樓
宿舍费	宿舍費
寄出去	寄出去
寄托在	寄托在
寄挂号	寄掛號
寄生虫	寄生蟲
密云县	密雲縣
密苏里	密蘇裏
富春秋	富春秋
富维克	富維克
富色彩	富色彩
富里乡	富里鄉
寒假里	寒假裏
寒号虫	寒號蟲
寒暑表	寒暑表
寒武系	寒武系
察合台	察合臺
察觉出	察覺出
对准表	對準錶
对准钟	對準鐘
对台戏	對臺戲
对对胡	對對胡
对数表	對數表
对照表	對照表
对着干	對著幹
对立面	對立面
对表中	對表中
对表扬	對表揚
对表明	對表明
对表演	對表演
对表现	對表現
对表达	對表達
寻找出	尋找出
导出值	導出值
导出去	導出去
导出来	導出來
导向型	導向型
导师制	導師制
导流板	導流板
导生制	導生制
导风板	導風板
寿丰乡	壽豐鄉
封了火	封了火
封檐板	封檐板
封面里	封面裏
射不出	射不出
射出去	射出去
射出来	射出來
射回去	射回去
射回来	射回來
射雕手	射鵰手
将出去	將出去
将出来	將出來
将占卜	將占卜
将回到	將回到
将回去	將回去
将回来	將回來
将无同	將無同
小丑鱼	小丑魚
小业种	小業種
小个子	小個子
小伙子	小夥子
小伙计	小夥計
小便斗	小便斗
小傢伙	小傢伙
小冲突	小衝突
小划子	小划子
小发财	小發財
小只会	小只會
小只可	小只可
小只在	小只在
小只是	小只是
小只有	小只有
小只能	小只能
小只需	小只需
小叮当	小叮噹
小同乡	小同鄉
小后生	小後生
小周后	小周后
小场面	小場面
小型钟	小型鐘
小夜曲	小夜曲
小天后	小天后
小姑娘	小姑娘
小娘子	小娘子
小岩洞	小岩洞
小恶魔	小惡魔
小才子	小才子
小挂儿	小掛兒
小插曲	小插曲
小松糕	小鬆糕
小柜子	小櫃子
小栗旬	小栗旬
小毛虫	小毛蟲
小瀑布	小瀑布
小班制	小班制
小秀才	小秀才
小秋收	小秋收
小米面	小米麵
小老板	小老闆
小胜利	小勝利
小胡子	小鬍子
小胡桃	小胡桃
小脏鬼	小髒鬼
小舍人	小舍人
小苏打	小蘇打
小苹果	小蘋果
小范围	小範圍
小虫子	小蟲子
小行板	小行板
小表哥	小表哥
小表妹	小表妹
小表姊	小表姊
小表嫂	小表嫂
小表弟	小表弟
小铲子	小鏟子
小集团	小集團
小面包	小麵包
小须鲸	小鬚鯨
少不了	少不了
少掌柜	少掌櫃
少数党	少數黨
尔冬升	爾冬升
尔本周	爾本週
尖团字	尖團字
尖团音	尖團音
尖扎县	尖扎縣
尖管面	尖管麵
尖裂叶	尖裂葉
尘卷风	塵捲風
尘肺症	塵肺症
尘芥虫	塵芥蟲
尚志市	尚志市
尚慕杰	尚慕傑
尝汤戏	嘗湯戲
尝甜头	嘗甜頭
尝试性	嘗試性
尝起来	嚐起來
尤克斯	尤克斯
尤秋兴	尤秋興
就克制	就剋制
就出去	就出去
就出来	就出來
就吃干	就吃乾
就回去	就回去
就回来	就回來
就干一	就幹一
就干吧	就幹吧
就干淨	就乾淨
就当作	就當作
就拿出	就拿出
就是了	就是了
就晚了	就晚了
就读于	就讀於
就里人	就裏人
尸体袋	屍體袋
尸陀林	尸陀林
尸魂界	尸魂界
尹秋君	尹秋君
尼克松	尼克松
尼克森	尼克森
尼克洛	尼克洛
尼克队	尼克隊
尼勒克	尼勒克
尼姑庵	尼姑庵
尼龙布	尼龍佈
尽义务	盡義務
尽人事	盡人事
尽人情	盡人情
尽全力	盡全力
尽全心	盡全心
尽可能	儘可能
尽场儿	盡場兒
尽头话	盡頭話
尽底下	儘底下
尽快地	盡快地
尽快的	盡快的
尽本分	盡本分
尽落尾	儘落尾
尽责任	盡責任
尽铅华	盡鉛華
尿出子	尿出子
尿崩症	尿崩症
尿布台	尿布台
尿布疹	尿布疹
尿毒症	尿毒症
局限于	局限於
局麻药	侷麻藥
层压板	層壓板
层积云	層積雲
居住于	居住於
屈万里	屈萬里
屈就于	屈就於
屈折语	屈折語
屈服于	屈服於
屋子里	屋子裏
屋里人	屋裏人
屋里的	屋裏的
屋面板	屋面板
屋面瓦	屋面瓦
屏风后	屏風後
展现出	展現出
展示出	展示出
展示柜	展示櫃
展露出	展露出
属于偶	屬於偶
属意于	屬意於
屠苏酒	屠蘇酒
履历片	履歷片
履历表	履歷表
屯田制	屯田制
山仔后	山仔后
山洞里	山洞裏
山羊胡	山羊鬍
山羊须	山羊鬚
山药蛋	山藥蛋
山谷地	山谷地
山里站	山里站
山里红	山裏紅
岩土体	岩土體
岩手县	岩手縣
岩流圈	巖流圈
岩浆岩	岩漿岩
岩浆流	岩漿流
岩濑健	岩瀨健
岩石圈	岩石圈
岩石学	岩石學
岩石层	岩石層
岩蔷薇	岩薔薇
岫岩县	岫岩縣
峇里岛	峇里島
峰火台	峰火臺
崑仑奴	崑崙奴
崑仑山	崑崙山
崔京周	崔京周
崔克索	崔克索
川党参	川黨參
川埼症	川埼症
川汇区	川匯區
巡回展	巡迴展
巡回祭	巡迴祭
巡回赛	巡迴賽
巡回车	巡迴車
工人党	工人黨
工作制	工作制
工作台	工作臺
工作团	工作團
工作表	工作表
工作面	工作面
工厂权	工廠權
工厂法	工廠法
工程系	工程系
左云县	左雲縣
左光斗	左光斗
左后方	左後方
左里克	左里克
巧克力	巧克力
巧克莉	巧克莉
巧历史	巧歷史
巧当儿	巧當兒
巨人症	巨人症
巨脾症	巨脾症
差多了	差多了
已占卜	已占卜
已占算	已占算
已对于	已對於
巴克利	巴克利
巴克礼	巴克禮
巴克莱	巴克萊
巴克雷	巴克雷
巴别塔	巴別塔
巴厘岛	巴厘島
巴尔干	巴爾幹
巴尔赞	巴爾贊
巴布亚	巴布亞
巴布尔	巴布爾
巴托丽	巴托麗
巴托莉	巴托莉
巴拉克	巴拉克
巴拉松	巴拉松
巴斯克	巴斯克
巴松管	巴松管
巴洛克	巴洛克
巴瑞克	巴瑞克
巴罗克	巴羅克
巴胡提	巴胡提
巴舍莱	巴舍萊
巴贝克	巴貝克
巴里坤	巴裏坤
巴里岛	巴里島
巴里斯	巴里斯
市党部	市黨部
市占率	市佔率
市场价	市場價
市长杯	市長盃
市面上	市面上
布一个	佈一個
布什尔	布什爾
布仑特	布侖特
布伦尼	布倫尼
布伦森	布倫森
布伦特	布倫特
布佳迪	布佳迪
布依族	布依族
布偶戏	布偶戲
布克奖	布克獎
布兰克	布蘭克
布兰妮	布蘭妮
布兰德	布蘭德
布兰森	佈蘭森
布兰特	布蘭特
布兰琪	布蘭琪
布农族	布農族
布利吉	布利吉
布劳恩	布勞恩
布卡拉	布卡拉
布吉河	布吉河
布告栏	布告欄
布告牌	布告牌
布哈拉	布哈拉
布哈林	布哈林
布喀河	布喀河
布坎南	布坎南
布娃娃	布娃娃
布宜若	布宜若
布宜诺	布宜諾
布尔兹	布爾茲
布尔津	布爾津
布尔省	布爾省
布尔诺	布爾諾
布希号	布希號
布希曼	布希曼
布德尔	布德爾
布拉克	布拉克
布拉吉	布拉吉
布拉德	布拉德
布拉格	布拉格
布拉欣	布拉欣
布拉谢	布拉謝
布拖县	布拖縣
布招儿	布招兒
布掸子	布撣子
布政使	布政使
布政司	布政司
布朗士	布朗士
布朗夏	布朗夏
布朗妮	布朗妮
布朗宁	布朗寧
布朗德	布朗德
布朗族	布朗族
布朗森	布朗森
布朗特	布朗特
布格河	布格河
布法罗	布法羅
布洒器	布灑器
布洛克	布洛克
布洛湾	布洛灣
布洛芬	布洛芬
布特哈	布特哈
布瑞尤	布瑞尤
布瑞特	布瑞特
布瑞顿	布瑞頓
布用填	布用填
布疑阵	佈疑陣
布累尔	布累爾
布纶堡	布綸堡
布纹纸	布紋紙
布维岛	布維島
布罗迪	布羅迪
布置成	佈置成
布胡会	布胡會
布莱克	布萊克
布莱尔	布萊爾
布莱尼	布萊尼
布莱德	布萊德
布莱恩	布萊恩
布莱特	布萊特
布莱顿	布萊頓
布衣交	布衣交
布衫儿	布衫兒
布袋安	布袋安
布袋戏	布袋戲
布袋港	布袋港
布袋莲	布袋蓮
布袋装	布袋裝
布袋镇	布袋鎮
布西县	布西縣
布谷鸟	布穀鳥
布达式	布達式
布迪亚	布迪亞
布道所	佈道所
布那喀	布那喀
布里斯	布里斯
布隆迪	布隆迪
布雅湾	布雅灣
布雷克	布雷克
布雷尔	布雷爾
布雷恩	布雷恩
布雷拉	布雷拉
布雷的	佈雷的
布雷舰	佈雷艦
布雷艇	佈雷艇
布雷蒙	布雷蒙
布雷迪	布雷迪
布雷队	佈雷隊
布雷顿	布雷頓
布雷默	布雷默
布马雪	布馬雪
布鲁克	布魯克
布鲁勒	布魯勒
布鲁尼	布魯尼
布鲁托	布魯托
布鲁斯	布魯斯
布鲁日	布魯日
布鲁珊	布魯珊
布鲁诺	布魯諾
帅呆了	帥呆了
帆布包	帆布包
帆布椅	帆布椅
帆布牀	帆布牀
帆布袋	帆布袋
帆布鞋	帆布鞋
师生杯	師生盃
师范生	師範生
师范类	師範類
希克斯	希克斯
希拉克	希拉剋
希拉里	希拉裏
希斯仑	希斯崙
帕修斯	帕修斯
帕台农	帕台農
帕穆克	帕穆克
帕谢克	帕謝克
帘子布	帘子布
帘子线	帘子綫
帘幕式	簾幕式
帘幽梦	簾幽夢
带丑闻	帶醜聞
带个好	帶個好
带出去	帶出去
带出来	帶出來
带回到	帶回到
带回去	帶回去
带回来	帶回來
带征银	帶徵銀
席哈克	席哈克
席志成	席誌成
席湘漓	席湘漓
帮不了	幫不了
常回去	常回去
常回来	常回來
常胜军	常勝軍
常胜家	常勝家
常衡制	常衡制
常见于	常見於
干一坛	乾一罈
干一杯	乾一杯
干一碗	乾一碗
干下去	幹下去
干不下	幹不下
干不了	幹不了
干不干	幹不幹
干不成	幹不成
干两年	幹兩年
干两杯	乾兩杯
干个够	乾個夠
干买卖	幹買賣
干了杯	乾了杯
干事会	幹事會
干事长	幹事長
干什么	幹什麼
干任何	幹任何
干伸舌	乾伸舌
干何事	幹何事
干你娘	幹你娘
干傻事	幹傻事
干儿子	乾兒子
干冒烟	乾冒煙
干农活	幹農活
干几件	幹幾件
干几宗	幹幾宗
干几手	乾幾手
干几杯	乾幾杯
干几桩	幹幾樁
干几番	幹幾番
干几碗	乾幾碗
干几辈	幹幾輩
干凯文	干凱文
干別的	幹別的
干刻版	乾刻版
干剥剥	乾剝剝
干劲儿	幹勁兒
干又热	乾又熱
干哥哥	乾哥哥
干回付	乾回付
干坏事	幹壞事
干坐着	乾坐著
干坛子	乾罈子
干堂婶	乾堂嬸
干大事	幹大事
干女儿	乾女兒
干女友	幹女友
干女婿	乾女婿
干奴才	乾奴才
干妹妹	乾妹妹
干姊姊	乾姊姊
干就干	幹就幹
干屎橛	乾屎橛
干巴巴	乾巴巴
干干的	乾乾的
干弟弟	乾弟弟
干强盗	幹強盜
干得了	幹得了
干得很	乾得很
干性油	幹性油
干打垒	乾打壘
干打雷	乾打雷
干扰到	干擾到
干扰力	干擾力
干扰素	干擾素
干拎娘	幹拎娘
干掉杯	乾掉杯
干撂台	乾撂台
干撇下	乾撇下
干支剌	乾支剌
干支支	乾支支
干支沟	干支溝
干数杯	乾數杯
干村沙	乾村沙
干梅子	乾梅子
干正事	幹正事
干此坛	乾此罈
干此杯	乾此杯
干毛巾	乾毛巾
干洗店	乾洗店
干活儿	幹活兒
干涉仪	干涉儀
干清宫	乾清宮
干湿发	乾濕髮
干灯盏	乾燈盞
干燥剂	乾燥劑
干燥器	乾燥器
干燥机	乾燥機
干燥箱	乾燥箱
干爸爸	乾爸爸
干犯法	幹犯法
干甚么	幹甚麼
干生受	乾生受
干生子	乾生子
干生气	乾生氣
干电池	乾電池
干瘪瘪	乾癟癟
干癣性	乾癬性
干白儿	乾白兒
干的好	幹的好
干眼病	乾眼病
干眼症	干眼症
干着急	乾着急
干瞪眼	乾瞪眼
干站着	乾站著
干篾片	乾篾片
干粗活	幹粗活
干粮袋	乾糧袋
干細胞	幹細胞
干细胞	幹細胞
干绷儿	乾繃兒
干肉片	乾肉片
干茨腊	乾茨臘
干茶钱	乾茶錢
干草叉	乾草叉
干草堆	乾草堆
干草机	乾草機
干草粉	乾草粉
干营生	幹營生
干著急	乾著急
干血浆	乾血漿
干衣机	乾衣機
干货物	幹貨物
干起来	幹起來
干过杯	乾過杯
干过瘾	乾過癮
干这杯	乾這杯
干那杯	乾那杯
干酵母	乾酵母
干闼婆	乾闥婆
干阿奶	乾阿奶
干霍乱	乾霍亂
干革命	幹革命
干馏法	乾餾法
干麻学	幹麻學
干麻阿	幹麻阿
平个人	平個人
平台数	平台數
平均价	平均價
平复帖	平復帖
平安里	平安裏
平康里	平康里
平板仪	平板儀
平板车	平板車
平泉庄	平泉莊
平衡台	平衡台
平谷区	平谷區
平谷县	平谷縣
平足症	平足症
平针缝	平針縫
平面图	平面圖
平面子	平面子
平面段	平面段
平面波	平面波
平面角	平面角
平面镜	平面鏡
年代里	年代裏
年历史	年歷史
年团子	年團子
年复合	年覆合
并上去	並上去
并上来	並上來
并不会	並不會
并不准	並不准
并不在	並不在
并不并	併不併
并不是	並不是
并不能	並不能
并且会	並且會
并且在	並且在
并且是	並且是
并且有	並且有
并且能	並且能
并举手	並舉手
并出去	並出去
并出来	並出來
并列为	並列爲
并列埠	並列埠
并卷机	併捲機
并发动	並發動
并发展	並發展
并发现	並發現
并发症	併發症
并发表	並發表
并可以	並可以
并吞下	併吞下
并回去	並回去
并回来	並回來
并头莲	並頭蓮
并存在	並存在
并州剪	並州剪
并没有	並沒有
并肩子	併肩子
并肩干	並肩幹
并能夠	並能夠
并蒂莲	並蒂蓮
并行口	並行口
并规范	並規範
并购买	並購買
并购案	併購案
并躺在	並躺在
并过去	並過去
并过来	並過來
并进去	並進去
并进来	並進來
并非在	並非在
并非是	並非是
幸亏在	幸虧在
幸亏是	幸虧是
幸亏有	幸虧有
幸发亭	幸發亭
幸好是	幸好是
幸好有	幸好有
幸存者	幸存者
幸福学	幸福學
幸福感	幸福感
幸而是	幸而是
幸运人	幸運人
幸运儿	幸運兒
幸运券	幸運券
幸运星	幸運星
幸运物	幸運物
幸运球	幸運球
幸运胡	幸運鬍
幸运色	幸運色
幸运草	幸運草
幺并矢	幺並矢
幻想曲	幻想曲
幽明录	幽明錄
广丰县	廣豐縣
广告曲	廣告曲
广告板	廣告板
广告系	廣告系
广播台	廣播臺
庄志伟	莊志偉
庄秋南	莊秋南
庄稼人	庄稼人
庄稼院	庄稼院
庄胜雄	莊勝雄
庆云县	慶雲縣
庆历史	慶歷史
床头柜	牀頭櫃
库仑计	庫侖計
库克山	庫克山
库工党	庫工黨
库瑞克	庫瑞克
库贝克	庫貝克
应克制	應剋制
应声虫	應聲蟲
应当会	應當會
应当在	應當在
应当是	應當是
应当有	應當有
应当能	應當能
应征信	應徵信
应征稿	應徵稿
应征者	應徵者
应用于	應用於
应采儿	應採兒
底夸克	底夸克
府兵制	府兵制
府干卿	府干卿
府干扰	府干擾
府干擾	府干擾
府干政	府干政
府干涉	府干涉
府干犯	府干犯
府干預	府干預
府干预	府干預
府谷县	府谷縣
庞克头	龐克頭
庞志龙	龐志龍
康托尔	康託爾
康济录	康濟錄
康百克	康百克
康采恩	康採恩
廉价品	廉價品
廉售价	廉售價
廖于诚	廖于誠
廖俊杰	廖俊傑
廖千莹	廖千瑩
廖志坚	廖志堅
廖本烟	廖本煙
廖本胜	廖本勝
廖英杰	廖英傑
廖金钟	廖金鐘
延伸出	延伸出
延地里	延地裏
建党节	建黨節
建构出	建構出
建筑业	建築業
建筑商	建築商
建筑学	建築學
建筑师	建築師
建筑物	建築物
建筑界	建築界
建筑科	建築科
建筑系	建築系
建筑羣	建築羣
建筑群	建築羣
建筑节	建築節
建造出	建造出
建都于	建都於
廿五万	廿五萬
开不了	開不了
开元录	開元錄
开出去	開出去
开出来	開出來
开创出	開創出
开化党	開化黨
开卷考	開卷考
开发中	開發中
开发为	開發爲
开发井	開發井
开发出	開發出
开发区	開發區
开发商	開發商
开发局	開發局
开发成	開發成
开发案	開發案
开发法	開發法
开发署	開發署
开发者	開發者
开发金	開發金
开后门	開後門
开回去	開回去
开回来	開回來
开新板	開新板
开盘价	開盤價
开药方	開藥方
开辟者	開辟者
开辟记	開闢記
开采权	開採權
开采法	開採法
异动表	異動表
异形叶	異形葉
弃尸案	棄屍案
弄出去	弄出去
弄出来	弄出來
弄坏了	弄壞了
弄干坤	弄乾坤
弄拧了	弄擰了
弄面吃	弄麵吃
弓浆虫	弓漿蟲
引伸出	引伸出
引出去	引出去
引出来	引出來
引发出	引發出
引导出	引導出
引拉出	引拉出
引牵出	引牽出
弗兰克	弗蘭克
弗里敦	弗裏敦
弗里曼	弗里曼
弘历史	弘歷史
张三丰	張三丰
张世杰	張世傑
张云光	張雲光
张兆志	張兆志
张克帆	張克帆
张勇杰	張勇傑
张勋杰	張勛傑
张基郁	張基郁
张大千	張大千
张志和	張志和
张志家	張誌家
张志弘	張志弘
张志强	張志強
张志忠	張志忠
张志新	張志新
张志贤	張志賢
张志辉	張志輝
张志铭	張志銘
张挂在	張掛在
张挂起	張掛起
张文松	張文松
张斗辉	張斗輝
张智杰	張智傑
张木松	張木松
张栋梁	張棟樑
张琴松	張琴松
张秋明	張秋明
张聪秋	張聰秋
张苙云	張苙雲
张荣发	張榮發
张金涂	張金塗
弥勒佛	彌勒佛
弥勒县	彌勒縣
弥天案	彌天案
弥撒曲	彌撒曲
弥月酒	彌月酒
弥渡县	彌渡縣
弥漫性	瀰漫性
弥漫着	瀰漫着
弥猴桃	彌猴桃
弥赛亚	彌賽亞
弥迦书	彌迦書
弥陀乡	彌陀鄉
弦乐团	弦樂團
弦面板	弦面板
弯出去	彎出去
弯出来	彎出來
弯回去	彎回去
弯回来	彎回來
弯曲度	彎曲度
弯曲状	彎曲狀
弯管面	彎管麵
張三丰	張三丰
弹不出	彈不出
弹出去	彈出去
弹出来	彈出來
弹回去	彈回去
弹回来	彈回來
弹奏出	彈奏出
弹子台	彈子檯
弹射出	彈射出
弹布尔	彈布爾
弹涂鱼	彈塗魚
弹珠台	彈珠檯
弹药兵	彈藥兵
弹药库	彈藥庫
弹药箱	彈藥箱
弹跳板	彈跳板
强制力	強制力
强制性	強制性
强制罪	強制罪
强制险	強制險
强加于	強加於
强占性	強佔性
强奸犯	強姦犯
强奸罪	強姦罪
强心针	強心針
强投松	強投松
强迫症	強迫症
归功于	歸功於
归咎于	歸咎於
归因于	歸因於
归属于	歸屬於
归并不	歸並不
归并且	歸並且
归并到	歸併到
归并在	歸併在
归并非	歸並非
归类于	歸類於
归纳出	歸納出
归罪于	歸罪於
归虚谷	歸虛谷
归诸于	歸諸於
归随于	歸隨於
归顺于	歸順於
当一声	噹一聲
当一当	當一當
当上去	當上去
当上来	當上來
当下去	當下去
当下来	當下來
当不上	當不上
当不了	當不了
当不得	當不得
当不成	當不成
当不来	當不來
当不起	當不起
当不过	當不過
当世冠	當世冠
当事人	當事人
当事国	當事國
当事者	當事者
当代人	當代人
当代史	當代史
当其冲	當其衝
当前季	當前季
当句对	當句對
当回事	當回事
当地人	當地人
当地化	當地化
当头人	當頭人
当头炮	當頭炮
当头阵	當頭陣
当完兵	當完兵
当家人	當家人
当家子	當家子
当家的	當家的
当差的	當差的
当归鸭	當歸鴨
当当当	噹噹噹
当当船	噹噹船
当当车	噹噹車
当得上	當得上
当得来	當得來
当得起	當得起
当政者	當政者
当日份	當日份
当时的	當時的
当时车	當時車
当曲河	當曲河
当月份	當月份
当权派	當權派
当权者	當權者
当涂县	當塗縣
当演员	當演員
当然会	當然會
当然在	當然在
当然是	當然是
当然有	當然有
当直的	當直的
当真假	當真假
当真的	當真的
当眼处	當眼處
当票子	當票子
当艄顺	當艄順
当行家	當行家
当起来	當起來
当路子	當路子
当选为	當選爲
当选人	當選人
当选者	當選者
当道者	當道者
当门户	當門戶
当阳市	當陽市
当雄县	當雄縣
录上去	錄上去
录上来	錄上來
录下去	錄下去
录下来	錄下來
录像带	錄像帶
录像机	錄像機
录像片	錄像片
录取率	錄取率
录录歌	錄錄歌
录录音	錄錄音
录影器	錄影器
录影带	錄影帶
录影机	錄影機
录影碟	錄影碟
录起来	錄起來
录音室	錄音室
录音师	錄音師
录音带	錄音帶
录音机	錄音機
录音间	錄音間
录鬼簿	錄鬼簿
形于色	形於色
彩云国	彩雲國
彩先达	彩先達
彩光板	彩光板
彩券局	彩券局
彩券行	彩券行
彩叶芋	彩葉芋
彩叶草	彩葉草
彩妆品	彩妝品
彩妆师	彩妝師
彩带舞	彩帶舞
彩楼配	彩樓配
彩牌楼	綵牌樓
彩电视	彩電視
彩票卡	彩票卡
彩笔生	綵筆生
彩色照	彩色照
彩色片	彩色片
彩色版	彩色版
彩色笔	彩色筆
彩色米	彩色米
彩虹桥	彩虹橋
彩蝶谷	彩蝶谷
彩饰版	彩飾版
彪个子	彪個子
彭于晏	彭于晏
彭克港	彭克港
彭志光	彭志光
彭志华	彭志華
彭绍升	彭紹升
彭胜竹	彭勝竹
彰显出	彰顯出
往上面	往上面
往下面	往下面
往前面	往前面
往后冲	往後衝
往后方	往後方
往后面	往後面
往复泵	往復泵
往外冲	往外衝
往外面	往外面
往来于	往來於
往还于	往還於
往里面	往裏面
征信录	徵信錄
征信所	徵信所
征信社	徵信社
征候羣	徵候羣
征兵制	徵兵制
征兵法	徵兵法
征兵站	徵兵站
征友栏	徵友欄
征意见	徵意見
征收额	徵收額
征服兵	徵服兵
征服者	征服者
征税额	徵稅額
征稿栏	徵稿欄
征集令	徵集令
征验出	徵驗出
很干了	很乾了
律历志	律曆志
律师团	律師團
徐伟胜	徐偉勝
徐余伟	徐余偉
徐千惠	徐千惠
徐台荪	徐台蓀
徐家汇	徐家彙
徐志摩	徐志摩
徐汇区	徐匯區
徐清云	徐清雲
徐赞升	徐讚昇
得克制	得剋制
得益于	得益於
得胜口	得勝口
得胜课	得勝課
徘徊于	徘徊於
徜徉于	徜徉於
御书房	御書房
御博表	御博表
御史台	御史臺
御史雨	御史雨
御夫座	御夫座
御宅族	御宅族
御手洗	御手洗
御林军	御林軍
御碑亭	御碑亭
御膳房	御膳房
御花园	御花園
循环制	循環制
微孔板	微孔板
微居里	微居里
德国杯	德國杯
德布西	德布西
德意志	德意志
德文系	德文系
德瑞克	德瑞克
德胜门	德勝門
德语系	德語系
德里达	德裏達
心理系	心理系
心理面	心理面
心相系	心相繫
心系一	心繫一
心系万	心繫萬
心系世	心繫世
心系东	心繫東
心系两	心繫兩
心系中	心繫中
心系乔	心繫乔
心系五	心繫五
心系京	心繫京
心系人	心繫人
心系他	心繫他
心系伊	心繫伊
心系众	心繫眾
心系传	心繫傳
心系何	心繫何
心系你	心繫你
心系健	心繫健
心系全	心繫全
心系兰	心繫蘭
心系农	心繫农
心系功	心繫功
心系动	心繫動
心系募	心繫募
心系北	心繫北
心系十	心繫十
心系千	心繫千
心系南	心繫南
心系台	心繫台
心系和	心繫和
心系哪	心繫哪
心系唐	心繫唐
心系嘱	心繫囑
心系四	心繫四
心系困	心繫困
心系国	心繫國
心系在	心繫在
心系地	心繫地
心系大	心繫大
心系天	心繫天
心系夫	心繫夫
心系奥	心繫奧
心系女	心繫女
心系她	心繫她
心系妇	心繫婦
心系妻	心繫妻
心系子	心繫子
心系它	心繫它
心系宣	心繫宣
心系家	心繫家
心系富	心繫富
心系小	心繫小
心系山	心繫山
心系川	心繫川
心系幼	心繫幼
心系广	心繫廣
心系彼	心繫彼
心系德	心繫德
心系您	心繫您
心系慈	心繫慈
心系我	心繫我
心系摩	心繫摩
心系故	心繫故
心系新	心繫新
心系日	心繫日
心系昌	心繫昌
心系晓	心繫曉
心系曼	心繫曼
心系林	心繫林
心系母	心繫母
心系民	心繫民
心系江	心繫江
心系汶	心繫汶
心系沈	心繫沈
心系沙	心繫沙
心系泰	心繫泰
心系浙	心繫浙
心系港	心繫港
心系湖	心繫湖
心系澳	心繫澳
心系灾	心繫災
心系父	心繫父
心系生	心繫生
心系病	心繫病
心系百	心繫百
心系的	心繫的
心系社	心繫社
心系祖	心繫祖
心系神	心繫神
心系红	心繫紅
心系美	心繫美
心系群	心繫羣
心系老	心繫老
心系舞	心繫舞
心系英	心繫英
心系茶	心繫茶
心系西	心繫西
心系贫	心繫貧
心系输	心繫輸
心系近	心繫近
心系远	心繫遠
心系选	心繫選
心系重	心繫重
心系长	心繫長
心系阮	心繫阮
心系震	心繫震
心系非	心繫非
心系风	心繫風
心系香	心繫香
心系高	心繫高
心系麦	心繫麥
心系黄	心繫黃
心脏学	心臟學
心脏瓣	心臟瓣
心脏病	心臟病
心脏科	心臟科
心脏计	心臟計
心脏镜	心臟鏡
心里头	心裏頭
心里话	心裏話
心里面	心裏面
必修科	必修科
必修课	必修課
必胜客	必勝客
必须的	必須的
忍冬花	忍冬花
忏悔录	懺悔錄
志丹县	志丹縣
志工团	志工團
志工队	志工隊
志愿书	志願書
志愿兵	志願兵
志愿军	志願軍
志愿卡	志願卡
志愿役	志願役
志愿者	志願者
志村健	志村健
志留系	志留系
志留纪	志留紀
忘不了	忘不了
忘忧谷	忘憂谷
忧郁剂	憂鬱劑
忧郁症	憂鬱症
快停了	快停了
快克制	快剋制
快出去	快出去
快出来	快出來
快吃干	快吃乾
快回到	快回到
快回去	快回去
快回来	快回來
快好了	快好了
快完了	快完了
快干了	快乾了
快干杯	快乾杯
快干裂	快乾裂
快松下	快鬆下
快板儿	快板兒
快死了	快死了
快没了	快沒了
快满了	快滿了
快熟了	快熟了
快舍下	快捨下
快赢了	快贏了
快递杯	快遞杯
快速面	快速麵
忽舍下	忽捨下
怎么了	怎麼了
怎么干	怎麼幹
怒冲冲	怒沖沖
急松松	急鬆鬆
急进党	急進黨
急重症	急重症
性丑闻	性醜聞
性价比	性價比
性伙伴	性伙伴
性倾向	性傾向
性关系	性關係
性冲动	性衝動
性别比	性別比
性取向	性取向
性恶说	性惡說
性指向	性指向
性饥渴	性飢渴
总会杯	總會杯
总回报	總回報
总干事	總幹事
总批发	總批發
总方针	總方針
总星系	總星系
总机厂	總機廠
总杆数	總桿數
总杆赛	總桿賽
总统制	總統制
总统杯	總統盃
总裁制	總裁制
总面积	總面積
恐变症	恐變症
恐同症	恐同症
恐怖症	恐怖症
恐惧症	恐懼症
恐慌症	恐慌症
恐旷症	恐曠症
恐水症	恐水症
恐法症	恐法症
恐韩症	恐韓症
恐高症	恐高症
恐鸡症	恐雞症
恒星系	恆星系
恒言录	恆言錄
恙虫病	恙蟲病
恢复为	恢復爲
恢复到	恢復到
恢复室	恢復室
恢复期	恢復期
恨透了	恨透了
恩仇记	恩仇記
恩威克	恩威克
恩给制	恩給制
恰克图	恰克圖
恶作剧	惡作劇
恶凶凶	惡兇兇
恶劣性	惡劣性
恶势力	惡勢力
恶名儿	惡名兒
恶哏哏	惡哏哏
恶唑啉	惡唑啉
恶心感	惡心感
恶性瘤	惡性瘤
恶支杀	惡支殺
恶狠狠	惡狠狠
恶病质	惡病質
恶臭味	惡臭味
恶臭性	惡臭性
恶质化	惡質化
恶魔党	惡魔黨
恶魔岛	惡魔島
悟出来	悟出來
悠游卡	悠遊卡
悠游表	悠遊錶
悠闲地	悠閒地
您克制	您剋制
悬挂在	懸掛在
悬挂物	懸掛物
悬臂梁	懸臂樑
悲回风	悲回風
情不愿	情不願
情僧录	情僧錄
情急了	情急了
情欲戏	情慾戲
惊闺叶	驚閨葉
惜别会	惜別會
惠塔克	惠塔克
惠里香	惠里香
惧高症	懼高症
惯性系	慣性系
想不出	想不出
想像出	想像出
想克制	想剋制
想出去	想出去
想出来	想出來
想回去	想回去
想回来	想回來
想当然	想當然
想说出	想說出
惹出来	惹出來
惹口面	惹口面
愁布袋	愁布袋
愁戚戚	愁戚戚
意会出	意會出
意克制	意剋制
意向书	意向書
意志力	意志力
愚公谷	愚公谷
感冒药	感冒藥
感觉出	感覺出
愿不愿	願不願
愿干净	願乾淨
愿干旱	願乾旱
愿干杯	願乾杯
愿干涸	願乾涸
愿干燥	願乾燥
愿干粮	願乾糧
愿干脆	願乾脆
愿意干	願意幹
愿而恭	愿而恭
懒惰虫	懶惰蟲
戏剧台	戲劇台
戏剧团	戲劇團
戏剧系	戲劇系
戏曲馆	戲曲館
成不了	成不了
成个儿	成個兒
成于思	成於思
成交价	成交價
成兆才	成兆才
成名曲	成名曲
成名术	成名術
成本价	成本價
成衣厂	成衣廠
我克制	我剋制
我只有	我只有
我回到	我回到
我回去	我回去
我回来	我回來
我愿意	我願意
戒烟法	戒煙法
战尽墨	戰盡墨
战斗力	戰鬥力
战斗区	戰鬥區
战斗员	戰鬥員
战斗旅	戰鬥旅
战斗机	戰鬥機
战斗羣	戰鬥羣
战斗群	戰鬥羣
战斗者	戰鬥者
战斗舰	戰鬥艦
战斗营	戰鬥營
战斗车	戰鬥車
战胜国	戰勝國
戚凯罗	戚凱羅
戚墅堰	慼墅堰
戚夫人	戚夫人
戚家军	戚家軍
戚继光	戚繼光
截面图	截面圖
戳个儿	戳個兒
戳脊梁	戳脊梁
戴克辛	戴克辛
戴出去	戴出去
戴出来	戴出來
戴胜益	戴勝益
戴胜通	戴勝通
戴蒙德	戴蒙德
戴表元	戴表元
戴诚志	戴誠志
户口制	戶口制
房中术	房中術
房地价	房地價
房屋里	房屋裏
所云云	所云云
所占卜	所占卜
所占星	所占星
所占算	所占算
所发现	所發現
所周知	所周知
所布之	所佈之
所布的	所佈的
所有制	所有制
扇面对	扇面對
扇面琴	扇面琴
手一卷	手一捲
手一松	手一鬆
手不松	手不鬆
手制动	手制動
手同脚	手同腳
手工台	手工檯
手彩儿	手彩兒
手心里	手心裏
手挽手	手挽手
手摇杯	手搖杯
手擀面	手擀麵
手术刀	手術刀
手术台	手術台
手术室	手術室
手术房	手術房
手术用	手術用
手术衣	手術衣
手术费	手術費
手板子	手板子
手表决	手表決
手表带	手錶帶
手表态	手表態
手表明	手表明
手表演	手表演
手表现	手表現
手表示	手表示
手表达	手表達
手表露	手表露
手表面	手表面
手里余	手裏餘
才上到	才上到
才上去	才上去
才上来	才上來
才下去	才下去
才下来	才下來
才不会	才不會
才不是	才不是
才不能	才不能
才会到	才會到
才会在	才會在
才会有	才會有
才像是	才像是
才出去	才出去
才出来	才出來
才可以	才可以
才回到	才回到
才回去	才回去
才回来	才回來
才外流	才外流
才多出	才多出
才夠去	才夠去
才夠来	才夠來
才子书	才子書
才干旱	才乾旱
才干杯	才乾杯
才干涸	才乾涸
才干淨	才乾淨
才干爽	才乾爽
才干耗	才乾耗
才干脆	才乾脆
才干透	才乾透
才开出	才開出
才开到	才開到
才得到	才得到
才打出	才打出
才打到	才打到
才拿出	才拿出
才拿到	才拿到
才来到	才來到
才松下	才鬆下
才没有	才沒有
才没能	才沒能
才派人	才派人
才用到	才用到
才看出	才看出
才看到	才看到
才等到	才等到
才算是	才算是
才能夠	才能夠
才能有	才能有
才艺班	才藝班
才艺秀	才藝秀
才读到	才讀到
才起来	才起來
才过去	才過去
才过来	才過來
扎上去	紮上去
扎上来	紮上來
扎下去	紮下去
扎下来	紮下來
扎伊尔	扎伊爾
扎兰屯	扎蘭屯
扎卡维	扎卡維
扎囊县	扎囊縣
扎好根	扎好根
扎带子	紮帶子
扎猛子	扎猛子
扎空枪	扎空槍
扎窝子	扎窩子
扎筏子	扎筏子
扎线带	紮綫帶
扎罚子	扎罰子
扎耳朵	扎耳朵
扎赉特	扎賚特
扎起来	紮起來
扎鲁特	扎魯特
扑个空	撲個空
扑克牌	撲克牌
扑克脸	撲克臉
扑冬冬	撲鼕鼕
扑出去	撲出去
扑出来	撲出來
打个花	打個花
打中伙	打中伙
打冲锋	打衝鋒
打出去	打出去
打出手	打出手
打出来	打出來
打击板	打擊板
打卡钟	打卡鐘
打卤面	打鹵麵
打印台	打印臺
打发掉	打發掉
打听出	打聽出
打和哄	打和哄
打回去	打回去
打回来	打回來
打回票	打回票
打夜胡	打夜胡
打太极	打太極
打完针	打完針
打对台	打對臺
打干哕	打乾噦
打恶心	打惡心
打扑克	打撲克
打折扣	打折扣
打折网	打折網
打报台	打報台
打抽丰	打抽豐
打摆子	打擺子
打擂台	打擂臺
打斗片	打鬥片
打暗号	打暗號
打来回	打來回
打板子	打板子
打桨杆	打槳桿
打游击	打游擊
打游飞	打游飛
打照面	打照面
打秋丰	打秋豐
打秋千	打鞦韆
打秋风	打秋風
打筋斗	打筋斗
打簧表	打簧錶
打紧板	打緊板
打绝板	打絕板
打胜仗	打勝仗
打胡哨	打胡哨
打蜡机	打蠟機
打谷场	打穀場
打谷机	打穀機
打造出	打造出
打野胡	打野胡
打量出	打量出
打靠后	打靠後
打风后	打風後
打饥荒	打饑荒
扔出去	扔出去
扔出来	扔出來
扔回去	扔回去
扔回来	扔回來
托人情	託人情
托儿所	託兒所
托克托	托克托
托克逊	托克遜
托勒密	托勒密
托勒尔	托勒爾
托勒玫	托勒玫
托塞洛	托塞洛
托尔金	托爾金
托拉司	托拉斯
托拉斯	托拉斯
托斯卡	托斯卡
托木尔	托木爾
托瑞丝	托瑞絲
托瑞赛	托瑞賽
托盘区	托盤區
托福考	托福考
托管国	托管國
托老院	托老院
托莱多	托萊多
托起来	托起來
托辣斯	托辣斯
托里县	托裏縣
托钵人	托鉢人
托钵僧	托鉢僧
托马斯	托馬斯
扛出去	扛出去
扛出来	扛出來
扛大梁	扛大樑
扣回去	扣回去
扣回来	扣回來
扣板机	扣板機
执政党	執政黨
执政团	執政團
执行面	執行面
扩张术	擴張術
扫出去	掃出去
扫出来	掃出來
扫干淨	掃乾淨
扫晴娘	掃晴娘
扭出去	扭出去
扭出来	扭出來
扯出去	扯出去
扯出来	扯出來
扯后腿	扯後腿
扯闲白	扯閒白
扯闲篇	扯閒篇
扰流板	擾流板
扶余县	扶余縣
扶余国	扶餘國
扶出去	扶出去
扶出来	扶出來
扶幼周	扶幼週
批准书	批准書
批准的	批准的
批出去	批出去
批出来	批出來
批发业	批發業
批发价	批發價
批发商	批發商
批发店	批發店
找不准	找不準
找不出	找不出
找借口	找借口
找出去	找出去
找出来	找出來
找出路	找出路
找台阶	找臺階
找回去	找回去
找回来	找回來
找寻出	找尋出
找面子	找面子
承平面	承平面
承销团	承銷團
技术员	技術員
技术团	技術團
技术士	技術士
技术处	技術處
技术官	技術官
技术性	技術性
技术部	技術部
技术面	技術面
技艺团	技藝團
抄后路	抄後路
抄录在	抄錄在
把上了	把上了
把你干	把你幹
把方才	把方纔
抑制剂	抑制劑
抑制器	抑制器
抑制酶	抑制酶
抑郁症	抑鬱症
抒情曲	抒情曲
抓不准	抓不準
抓出去	抓出去
抓出来	抓出來
抓回去	抓回去
抓回来	抓回來
投不准	投不準
投不出	投不出
投出去	投出去
投出来	投出來
投射出	投射出
投影面	投影面
投手板	投手板
投注站	投注站
抖出去	抖出去
抖出来	抖出來
抗癌药	抗癌藥
抗药性	抗藥性
抗菌药	抗菌藥
折上去	折上去
折上来	折上來
折下去	折下去
折下来	折下來
折不断	折不斷
折价券	折價券
折价卷	折價卷
折兑率	折兌率
折刀儿	折刀兒
折叠为	摺疊爲
折叠式	折疊式
折叠扇	摺疊扇
折叠椅	折疊椅
折叠牀	折疊牀
折合椅	折合椅
折向往	折向往
折回去	折回去
折回来	折回來
折壁脚	折壁腳
折子戏	折子戲
折射光	折射光
折射出	折射出
折射波	折射波
折射率	折射率
折射线	折射綫
折射角	折射角
折扣价	折扣價
折扣战	折扣戰
折扣率	折扣率
折损率	折損率
折旧率	折舊率
折旧费	折舊費
折现率	折現率
折算法	折算法
折算率	折算率
折纸工	摺紙工
折腰步	折腰步
折衷法	折衷法
折起来	折起來
折跟头	折跟頭
折过儿	折過兒
折返点	折返點
折进去	折進去
折进来	折進來
抚台街	撫台街
抚松县	撫松縣
抛出去	拋出去
抛出来	拋出來
抛物面	拋物面
抟风板	摶風板
抠出来	摳出來
护发素	護髮素
护壁板	護壁板
护理系	護理系
护面具	護面具
报价单	報價單
报出去	報出去
报出来	報出來
报名表	報名表
报复性	報復性
报废后	報廢後
报录人	報錄人
报税表	報稅表
报表纸	報表紙
抬出去	擡出去
抬出来	擡出來
抬回去	擡回去
抬回来	擡回來
抱出去	抱出去
抱出来	抱出來
抱出笼	抱出籠
抱回家	抱回家
抱回来	抱回來
抱抱团	抱抱團
抱朴子	抱朴子
押回去	押回去
押回来	押回來
押解回	押解回
抽公签	抽公籤
抽出去	抽出去
抽出来	抽出來
抽出空	抽出空
抽后腿	抽後腿
抽烟室	抽煙室
抽穗期	抽穗期
抽绎出	抽繹出
担仔面	擔仔麵
担干系	擔干係
担干纪	擔干紀
担担面	擔擔麵
拆出去	拆出去
拆出来	拆出來
拆回去	拆回去
拆回来	拆回來
拆封后	拆封後
拆白党	拆白黨
拈针指	拈針指
拉个手	拉個手
拉关系	拉關係
拉出去	拉出去
拉出来	拉出來
拉卜楞	拉卜楞
拉合子	拉合子
拉合尔	拉合爾
拉后腿	拉後腿
拉回去	拉回去
拉回来	拉回來
拉布拉	拉布拉
拉杆子	拉桿子
拉法叶	拉法葉
拉涅里	拉涅里
拉狄克	拉狄克
拉祖里	拉祖里
拉达克	拉達克
拉面上	拉面上
拉面具	拉面具
拉面前	拉面前
拉面巾	拉面巾
拉面店	拉麵店
拉面无	拉面無
拉面皮	拉面皮
拉面罩	拉面罩
拉面色	拉面色
拉面部	拉面部
拉饥荒	拉飢荒
拍出去	拍出去
拍出来	拍出來
拍卖价	拍賣價
拍摄出	拍攝出
拐出去	拐出去
拐出来	拐出來
拐回去	拐回去
拐回来	拐回來
拒人于	拒人於
拓朴学	拓樸學
拔不出	拔不出
拔出去	拔出去
拔出来	拔出來
拔回去	拔回去
拔回来	拔回來
拔山志	拔山志
拔山曲	拔山曲
拔萝卜	拔蘿蔔
拔虎须	拔虎鬚
拖出去	拖出去
拖出来	拖出來
拖吊车	拖吊車
拖后腿	拖後腿
拖回去	拖回去
拖回来	拖回來
拖地板	拖地板
拖干淨	拖乾淨
拖板车	拖板車
拖鞋柜	拖鞋櫃
拘泥于	拘泥於
拚命干	拚命幹
招出来	招出來
招回去	招回去
招回来	招回來
拜占庭	拜占庭
拟卤素	擬鹵素
拟定出	擬定出
拨出去	撥出去
拨出来	撥出來
拨回去	撥回去
拨回来	撥回來
拨蜡法	撥蠟法
括弧里	括弧裏
拱极星	拱極星
拳击台	拳擊臺
拷克机	拷克機
拼了命	拼了命
拼凑出	拼湊出
拼出去	拼出去
拼出来	拼出來
拼列出	拼列出
拼回去	拼回去
拼回来	拼回來
拼板胶	拼板膠
拼板舟	拼板舟
拼缀出	拼綴出
拼老命	拚老命
拿下表	拿下錶
拿下钟	拿下鐘
拿不了	拿不了
拿不准	拿不准
拿云手	拿雲手
拿出去	拿出去
拿出手	拿出手
拿出来	拿出來
拿回去	拿回去
拿回家	拿回家
拿回来	拿回來
拿坡里	拿坡里
拿枪杆	拿槍桿
拿波里	拿波里
拿破仑	拿破崙
拿笔杆	拿筆桿
挂一挂	掛一掛
挂上去	掛上去
挂上来	掛上來
挂上钩	掛上鉤
挂下去	掛下去
挂下来	掛下來
挂不上	掛不上
挂不下	掛不下
挂不住	掛不住
挂出去	掛出去
挂出来	掛出來
挂号信	挂號信
挂号处	掛號處
挂号证	掛號證
挂号费	掛號費
挂味儿	掛味兒
挂回去	掛回去
挂回来	掛回來
挂图表	掛圖表
挂坠盒	挂墜盒
挂头牌	掛頭牌
挂幌子	掛幌子
挂招牌	掛招牌
挂杯架	掛杯架
挂球蛋	掛球蛋
挂红灯	掛紅燈
挂络儿	掛絡兒
挂羊头	掛羊頭
挂落儿	掛落兒
挂衣冠	挂衣冠
挂衣架	掛衣架
挂衣钩	掛衣鉤
挂货铺	掛貨鋪
挂起来	掛起來
挂过去	掛過去
挂过来	掛過來
挂进去	掛進去
挂进来	掛進來
挂钩儿	挂鉤兒
挂钩子	掛鉤子
挂镜儿	掛鏡兒
挂龙雨	掛龍雨
指北针	指北針
指南针	指南針
指回到	指回到
指回去	指回去
指回来	指回來
指定曲	指定曲
指挥台	指揮台
指极星	指極星
指示板	指示板
指认出	指認出
指针式	指針式
按出去	按出去
按出来	按出來
按回去	按回去
按回来	按回來
按计划	按計劃
挑了只	挑了隻
挑出去	挑出去
挑出来	挑出來
挑口板	挑口板
挑大梁	挑大樑
挑拣出	挑揀出
挑正梁	挑正梁
挑选出	挑選出
挖出去	挖出去
挖出来	挖出來
挖掘出	挖掘出
挡不了	擋不了
挡回去	擋回去
挡回来	擋回來
挡泥板	擋泥板
挡雨板	擋雨板
挣扎表	掙扎表
挤出去	擠出去
挤出来	擠出來
挤压出	擠壓出
挤身于	擠身於
挥发性	揮發性
挥发油	揮發油
挥发物	揮發物
挥手表	揮手表
挨上去	挨上去
挨不上	挨不上
挨个儿	挨個兒
挨了揍	挨了揍
挨亲儿	挨親兒
挨人儿	挨人兒
挨刀的	挨刀的
挨呲儿	挨呲兒
挨头子	挨頭子
挨得住	捱得住
挨挨儿	挨挨兒
挨日子	捱日子
挨时间	捱時間
挨板子	挨板子
挨棍子	挨棍子
挨肩儿	挨肩兒
挨边儿	挨邊兒
挨过去	捱過去
挨过来	捱過來
挫折感	挫折感
振荡器	振盪器
挺出去	挺出去
挺出来	挺出來
挽手儿	挽手兒
挽歌郎	挽歌郎
挽眉毛	挽眉毛
挽脸师	挽臉師
挽麦子	挽麥子
捉不准	捉不準
捉奸党	捉奸黨
捉奸徒	捉奸徒
捉奸细	捉奸細
捉奸贼	捉奸賊
捋虎须	捋虎鬚
捏不准	捏不準
捏造出	捏造出
捏面人	捏麵人
捐出去	捐出去
捐出来	捐出來
捐益表	捐益表
捕虏岩	捕虜岩
捕虫叶	捕蟲葉
捕虫灯	捕蟲燈
捕虫网	捕蟲網
损益表	損益表
捡回去	撿回去
捡回来	撿回來
换个儿	換個兒
换出去	換出去
换出来	換出來
换向器	換向器
换回去	換回去
换回来	換回來
换挡杆	換擋桿
换档杆	換檔桿
换算表	換算表
捧出去	捧出去
捧出来	捧出來
据了解	據瞭解
据传说	據傳說
据估计	據估計
据我看	據我看
据报导	據報導
据报道	據報道
据统计	據統計
据说在	據說在
据说是	據說是
据说有	據說有
捷克人	捷克人
捷克籍	捷克籍
捷克语	捷克語
捷克队	捷克隊
掀出去	掀出去
掀出来	掀出來
掀帘子	掀簾子
掉价儿	掉價兒
掉出来	掉出來
掉回头	掉回頭
掌柜的	掌櫃的
掏出来	掏出來
排出体	排出體
排出去	排出去
排出来	排出來
排名表	排名表
排放出	排放出
排档杆	排檔桿
排骨面	排骨麵
掘出来	掘出來
探出去	探出去
探出来	探出來
探听出	探聽出
探寻出	探尋出
探知欲	探知慾
探究出	探究出
探询出	探詢出
掣后腿	掣後腿
接关系	接關係
接合上	接合上
接合处	接合處
接合点	接合點
接合面	接合面
接回去	接回去
接回来	接回來
接生术	接生術
接种率	接種率
接触面	接觸面
接近于	接近於
控制住	控制住
控制力	控制力
控制区	控制區
控制卡	控制卡
控制台	控制臺
控制器	控制器
控制塔	控制塔
控制好	控制好
控制室	控制室
控制性	控制性
控制权	控制權
控制杆	控制桿
控制板	控制板
控制棒	控制棒
控制欲	控制慾
控制码	控制碼
控制站	控制站
控制组	控制組
控制论	控制論
控制键	控制鍵
推出去	推出去
推出来	推出來
推回去	推回去
推回来	推回來
推想出	推想出
推断出	推斷出
推派出	推派出
推算出	推算出
推销术	推銷術
描写出	描寫出
描出来	描出來
描绘出	描繪出
提不出	提不出
提出去	提出去
提出来	提出來
提升为	提升爲
提升到	提升到
提回去	提回去
提回来	提回來
提子干	提子乾
提炼出	提煉出
提舍尼	提舍尼
插回去	插回去
插回来	插回來
插图卷	插圖卷
插足于	插足於
握不准	握不準
揪出去	揪出去
揪出来	揪出來
揭发出	揭發出
揭示板	揭示板
揭露出	揭露出
揽胜图	攬勝圖
揽闲事	攬閒事
搁脚板	擱腳板
搜寻到	搜尋到
搜捕到	搜捕到
搜搜客	搜搜客
搜救犬	搜救犬
搜査证	搜査證
搜狐网	搜狐網
搜神记	搜神記
搜索到	搜索到
搜索票	搜索票
搜索队	搜索隊
搜藏家	蒐藏家
搜集到	蒐集到
搞出来	搞出來
搞糊涂	搞糊塗
搢绅录	搢紳錄
搬出去	搬出去
搬出来	搬出來
搬回去	搬回去
搬回来	搬回來
搭克露	搭克露
搭干铺	搭乾鋪
搭机回	搭機回
搯出来	搯出來
摄制厂	攝製廠
摄制成	攝製成
摄影术	攝影術
摆上去	擺上去
摆上来	擺上來
摆下去	擺下去
摆下来	擺下來
摆不下	擺不下
摆不平	擺不平
摆不开	擺不開
摆乌龙	擺烏龍
摆出去	擺出去
摆出来	擺出來
摆列出	擺列出
摆动波	擺動波
摆回去	擺回去
摆回来	擺回來
摆地摊	擺地攤
摆姿势	擺姿勢
摆摆头	擺擺頭
摆摆手	擺擺手
摆摊儿	擺攤兒
摆摊子	擺攤子
摆擂台	擺擂臺
摆放在	擺放在
摆架子	擺架子
摆样子	擺樣子
摆浪子	擺浪子
摆渡船	擺渡船
摆脱到	擺脫到
摆行阵	擺行陣
摆设儿	擺設兒
摆请儿	擺請兒
摆谱儿	擺譜兒
摆起来	擺起來
摆进去	擺進去
摆进来	擺進來
摆酒席	擺酒席
摆门子	擺門子
摆门面	擺門面
摆阔气	擺闊氣
摇摆乐	搖擺樂
摇摆舞	搖擺舞
摇滚团	搖滾團
摇篮曲	搖籃曲
摊了事	攤了事
摊出去	攤出去
摊出来	攤出來
摔断了	摔斷了
摔筋斗	摔筋斗
摔跟斗	摔跟斗
摘出去	摘出去
摘出来	摘出來
摘录自	摘錄自
摘绵术	摘綿術
摩合罗	摩合羅
摩托化	摩托化
摩托船	摩托船
摩托车	摩托車
摩苏尔	摩蘇爾
摸不准	摸不準
摸出去	摸出去
摸出来	摸出來
摸彩券	摸彩券
摸彩品	摸彩品
摸彩箱	摸彩箱
摸索出	摸索出
摹扎特	摹紮特
撑场面	撐場面
撑市面	撐市面
撑杆跳	撐桿跳
撑门面	撐門面
撒克逊	撒克遜
撒呓症	撒囈症
撞出去	撞出去
撞出来	撞出來
撞木钟	撞木鐘
撞球台	撞球檯
撞球杆	撞球桿
撞警钟	撞警鐘
撤出去	撤出去
撤出来	撤出來
撤回去	撤回去
撤回来	撤回來
撩虎须	撩虎鬚
撬出去	撬出去
撬出来	撬出來
播出去	播出去
播出来	播出來
播种期	播種期
播种机	播種機
播种法	播種法
撮合山	撮合山
撰出来	撰出來
撵出去	攆出去
撵出来	攆出來
擀面杖	擀麵杖
擂台赛	擂臺賽
擅长于	擅長於
操作台	操作台
操作钟	操作鐘
操纵台	操縱臺
操纵杆	操縱桿
操船术	操船術
擦俊药	擦俊藥
擦出爱	擦出愛
擦干净	擦乾淨
擦干淨	擦乾淨
擦碗布	擦碗布
擦面子	擦面子
攀关系	攀關係
支努干	支努干
支系统	支系統
收出去	收出去
收出来	收出來
收发器	收發器
收发室	收發室
收发站	收發站
收回到	收回到
收回去	收回去
收回来	收回來
收录在	收錄在
收款台	收款臺
收盘价	收盤價
收获节	收穫節
收获量	收穫量
收购价	收購價
收银台	收銀台
改不了	改不了
改制为	改制爲
改回去	改回去
改回来	改回來
改良种	改良種
攻击面	攻擊面
放出去	放出去
放出来	放出來
放回去	放回去
放学后	放學後
放射出	放射出
放射虫	放射蟲
放屁虫	放屁蟲
放暗箭	放暗箭
放烟幕	放煙幕
放烟火	放煙火
放蒙挣	放懞掙
放轻松	放輕鬆
政治系	政治系
政治面	政治面
政策面	政策面
故事里	故事裏
效价能	效價能
敌占区	敵佔區
敌后方	敵後方
敌百虫	敵百蟲
敏于伎	敏於伎
救出去	救出去
救出来	救出來
救回去	救回去
救回来	救回來
救国团	救國團
教准部	教準部
教学钟	教學鐘
教练团	教練團
教育系	教育系
敢出去	敢出去
敢出来	敢出來
敢情欲	敢情欲
散发出	散發出
散布开	散佈開
散布者	散佈者
数万人	數萬人
数万元	數萬元
数不尽	數不盡
数位板	數位板
数十万	數十萬
数千万	數千萬
数千亿	數千億
数天后	數天後
数字钟	數字鐘
数学系	數學系
数据卡	數據卡
数据库	數據庫
数据机	數據機
数据段	數據段
数据流	數據流
数据源	數據源
数据链	數據鏈
数百万	數百萬
敲丧钟	敲喪鐘
整个人	整個人
整个月	整個月
整修费	整修費
整出剧	整齣劇
整出戏	整齣戲
整合出	整合出
整合到	整合到
整合商	整合商
整合型	整合型
整合式	整合式
整合性	整合性
整合成	整合成
整合法	整合法
整型术	整型術
整容术	整容術
整形术	整形術
整杯水	整杯水
整杯茶	整杯茶
整杯酒	整杯酒
整根烟	整根煙
整理出	整理出
整风后	整風後
敷面膜	敷面膜
敹一针	敹一針
文件柜	文件櫃
文复会	文復會
文学系	文學系
文征明	文徵明
文曲星	文曲星
文汇报	文匯報
文汇阁	文匯閣
斗一斗	鬥一鬥
斗不过	鬥不過
斗争性	鬥爭性
斗六市	斗六市
斗内力	鬥內力
斗分子	鬥分子
斗别气	鬥彆氣
斗十余	鬥十餘
斗南镇	斗南鎮
斗口齿	鬥口齒
斗叶儿	鬥葉兒
斗叶子	鬥葉子
斗地主	鬥地主
斗小马	斗小馬
斗尾港	斗尾港
斗幌子	鬥幌子
斗心眼	鬥心眼
斗批改	鬥批改
斗斗嘴	鬥鬥嘴
斗烟丝	斗煙絲
斗牛㹴	鬥牛㹴
斗牛场	鬥牛場
斗牛士	鬥牛士
斗牛梗	鬥牛梗
斗牛赛	鬥牛賽
斗牛阵	鬥牛陣
斗犀台	鬥犀臺
斗百余	鬥百餘
斗百草	鬥百草
斗筲役	斗筲役
斗蓬装	斗蓬裝
斗蟋蟀	鬥蟋蟀
斗起来	鬥起來
斗趣儿	鬥趣兒
斗门区	斗門區
斗闲气	鬥閒氣
斗闷子	鬥悶子
斗雪红	鬥雪紅
斗鸡台	鬥雞臺
斗鸡场	鬥雞場
斗鸡眼	鬥雞眼
斗鹌鹑	鬥鵪鶉
料不准	料不準
斜对面	斜對面
斜管面	斜管麵
斜纹布	斜紋布
断不了	斷不了
断仇谷	斷仇谷
断后路	斷後路
断头台	斷頭臺
断面图	斷面圖
斯当东	斯當東
斯诺克	斯諾克
斯迪里	斯迪里
新丰乡	新豐鄉
新丰县	新豐縣
新丰酒	新豐酒
新余市	新餘市
新出土	新出土
新出来	新出來
新出炉	新出爐
新出生	新出生
新制度	新制度
新单曲	新單曲
新历史	新歷史
新发明	新發明
新发村	新發村
新台币	新臺幣
新娘子	新娘子
新娘花	新娘花
新娘车	新娘車
新嫁娘	新嫁娘
新局面	新局面
新干县	新干縣
新干线	新幹綫
新庄市	新莊市
新德里	新德里
新技术	新技術
新报台	新報台
新注音	新注音
新纪录	新紀錄
新胜利	新勝利
新艺术	新藝術
新芬党	新芬黨
新规范	新規範
新闻台	新聞台
新闻系	新聞系
新集团	新集團
新面孔	新面孔
方便面	方便麵
方公里	方公里
方向仪	方向儀
方向往	方向往
方向性	方向性
方向感	方向感
方向灯	方向燈
方向盘	方向盤
方向线	方向綫
方向舵	方向舵
方彩绫	方彩綾
方志友	方志友
方志贤	方志賢
方言志	方言志
方面官	方面官
於夫罗	於夫羅
於夫羅	於夫羅
於梨華	於梨華
施佳升	施佳昇
施瓦布	施瓦布
施耐庵	施耐庵
旁系亲	旁系親
旅游业	旅遊業
旅游书	旅遊書
旅游区	旅遊區
旅游卡	旅遊卡
旅游史	旅遊史
旅游团	旅遊團
旅游客	旅遊客
旅游局	旅遊局
旅游展	旅遊展
旅游村	旅遊村
旅游点	旅遊點
旅游界	旅遊界
旅游社	旅遊社
旅游线	旅遊綫
旅游网	旅遊網
旅游者	旅遊者
旅游馆	旅遊館
旅程表	旅程表
旅行团	旅行團
旋毛虫	旋毛蟲
旋转台	旋轉台
旋转极	旋轉極
无主尸	無主屍
无价事	無价事
无价宝	無價寶
无党派	無黨派
无党籍	無黨籍
无农药	無農藥
无助于	無助於
无厘头	無厘頭
无回豁	無回豁
无头愿	無頭願
无尽期	無盡期
无尽藏	無盡藏
无尿症	無尿症
无店面	無店面
无异于	無異於
无愧于	無愧於
无损于	無損於
无期别	無期別
无极县	無極縣
无梁斗	無梁斗
无止尽	無止盡
无烟炭	無煙炭
无烟煤	無煙煤
无畏于	無畏於
无穷尽	無窮盡
无表情	無表情
无视于	無視於
无计向	無計向
无限制	無限制
无面目	無面目
日历史	日歷史
日历年	日歷年
日历纸	日曆紙
日历经	日歷經
日历表	日曆表
日均价	日均價
日子里	日子裏
日文系	日文系
日本制	日本製
日本台	日本台
日本团	日本團
日番谷	日番谷
日知录	日知錄
日程表	日程表
日语系	日語系
旧公烟	舊公煙
旧制度	舊制度
旧历史	舊歷史
旧历年	舊曆年
旧皇历	舊皇曆
旧钟表	舊鐘錶
早自修	早自修
旱烟筒	旱煙筒
旱烟袋	旱煙袋
时刻表	時刻表
时宪历	時憲曆
时尚周	時尚週
时干下	時幹下
时程表	時程表
时装周	時裝週
时钟座	時鐘座
时间表	時間表
时间里	時間裏
昂纳克	昂納克
昆仑山	昆崙山
昆虫学	昆蟲學
昆虫纲	昆蟲綱
昆都仑	昆都侖
明后天	明後天
明实录	明實錄
明摆着	明擺著
明斯克	明斯克
明确性	明確性
明细表	明細表
易克制	易剋制
易卜生	易卜生
易容术	易容術
易游网	易遊網
星云表	星雲表
星占学	星占學
星历史	星歷史
星历表	星曆錶
星巴克	星巴克
星期几	星期幾
星期后	星期後
星相术	星相術
星系团	星系團
星系羣	星系羣
星辰表	星辰錶
映照出	映照出
春假里	春假裏
春卷皮	春捲皮
春天里	春天裏
春日里	春日裏
春秋儿	春秋兒
春秋榜	春秋榜
春秋配	春秋配
春风面	春風面
昨夜里	昨夜裏
昭苏县	昭蘇縣
是干的	是乾的
昴星团	昴星團
显现出	顯現出
显示出	顯示出
显示板	顯示板
显示表	顯示錶
显示钟	顯示鐘
显露出	顯露出
晋升为	晉升爲
晋阳秋	晉陽秋
晏几道	晏幾道
晒图纸	曬圖紙
晒谷场	曬穀場
晕船药	暈船藥
晕血症	暈血症
晕车药	暈車藥
普冬冬	普鼕鼕
普庵咒	普庵咒
普朗克	普朗克
普隆克	普隆克
景谷县	景谷縣
晴雨表	晴雨表
晶圆厂	晶圓廠
智囊团	智囊團
智慧板	智慧板
暂并列	暫並列
暑修班	暑修班
暑假里	暑假裏
暖云兜	暖雲兜
暖气团	暖氣團
暖色系	暖色系
暗下去	暗下去
暗下来	暗下來
暗光鸟	暗光鳥
暗公鸟	暗公鳥
暗反应	暗反應
暗号灯	暗號燈
暗地里	暗地裏
暗底下	暗底下
暗星云	暗星雲
暗杀党	暗殺黨
暗杀案	暗殺案
暗楼子	暗樓子
暗沈沈	暗沈沈
暗沟里	暗溝裏
暗灰色	暗灰色
暗电流	暗電流
暗紫色	暗紫色
暗红色	暗紅色
暗色彩	暗色彩
暗花儿	暗花兒
暗蓝发	闇藍髮
暗藏着	暗藏着
暗褐色	暗褐色
暗记儿	暗記兒
暗适应	暗適應
暗门子	暗門子
暗间儿	暗間兒
暗顺应	暗順應
暗黑王	暗黑王
暴发户	暴發戶
暴露出	暴露出
暴食症	暴食症
曝光表	曝光表
曝露出	曝露出
曲别针	曲別針
曲周县	曲周縣
曲射炮	曲射炮
曲希瑞	曲希瑞
曲松县	曲松縣
曲柄笠	曲柄笠
曲柄钻	曲柄鑽
曲棍球	曲棍球
曲水县	曲水縣
曲江区	曲江區
曲江县	曲江縣
曲江宴	曲江宴
曲江池	曲江池
曲池穴	曲池穴
曲沃县	曲沃縣
曲秀才	麴秀才
曲线图	曲綫圖
曲线板	曲綫板
曲线美	曲綫美
曲线论	曲綫論
曲膝礼	曲膝禮
曲艾玲	曲艾玲
曲躬躬	曲躬躬
曲辫子	曲辮子
曲道士	麴道士
曲道赛	曲道賽
曲阜县	曲阜縣
曲阜市	曲阜市
曲阳县	曲陽縣
曲靖市	曲靖市
曲面论	曲面論
曲项目	曲項目
曲颈瓶	曲頸瓶
曲颈甑	曲頸甑
曲麻莱	曲麻萊
更动表	更動表
更愿意	更願意
更甚于	更甚於
曹余章	曹餘章
曹郁芬	曹郁芬
曼苏尔	曼蘇爾
曼谷人	曼谷人
曼谷包	曼谷包
曼谷市	曼谷市
曾台霖	曾台霖
曾孝谷	曾孝谷
曾志伟	曾志偉
曾志朗	曾志朗
曾砚闲	曾硯閒
最上面	最上面
最下面	最下面
最低价	最低價
最低谷	最低谷
最前面	最前面
最后面	最後面
最适化	最適化
最适合	最適合
最里面	最裏面
會干擾	會干擾
月光曲	月光曲
月历史	月歷史
月台票	月臺票
月桂叶	月桂葉
月牙铲	月牙鏟
月相表	月相錶
有个人	有個人
有了胎	有了胎
有价值	有價值
有关于	有關於
有关系	有關係
有准儿	有準兒
有出入	有出入
有出息	有出息
有利于	有利於
有别于	有別於
有助于	有助於
有勾当	有勾當
有只不	有只不
有只允	有只允
有只容	有只容
有只採	有只採
有只是	有只是
有只用	有只用
有只采	有只採
有够赞	有夠讚
有孔虫	有孔蟲
有害于	有害於
有征伐	有征伐
有征战	有征戰
有征服	有征服
有征讨	有征討
有志于	有志於
有志气	有志氣
有恒街	有恒街
有意志	有意志
有感于	有感於
有才干	有才幹
有损于	有損於
有栖川	有栖川
有烟煤	有煙煤
有益于	有益於
有种人	有種人
有系统	有系統
有联系	有聯繫
有脸面	有臉面
有致癌	有致癌
有节制	有節制
有计划	有計劃
有赖于	有賴於
有鉴于	有鑑於
有针线	有針綫
有面儿	有面兒
朋党论	朋黨論
服从于	服從於
服务于	服務於
服务台	服務臺
服务团	服務團
服用药	服用藥
服装周	服裝週
服饰周	服飾週
望乡台	望鄉臺
望了望	望了望
望出去	望出去
望后石	望后石
望弥撒	望彌撒
望楼台	望樓台
朝东面	朝東面
朝北面	朝北面
朝南面	朝南面
朝圣团	朝聖團
朝西面	朝西面
期货价	期貨價
木制品	木製品
木心板	木心板
木板凳	木板凳
木板地	木板地
木板墙	木板牆
木板牀	木板牀
木板画	木板畫
木芍药	木芍藥
木表法	木表法
木雕像	木雕像
木雕家	木雕家
木雕师	木雕師
木雕节	木雕節
未了因	未了因
未了情	未了情
未了缘	未了緣
未出去	未出去
未出来	未出來
未出货	未出貨
未发货	未發貨
未折现	未折現
未易才	未易才
未松下	未鬆下
未确定	未確定
未获得	未獲得
末末了	末末了
本位制	本位制
本周一	本週一
本周三	本週三
本周二	本週二
本周五	本週五
本周六	本週六
本周四	本週四
本垒板	本壘板
本征值	本徵值
本报台	本報台
本杰明	本傑明
本科系	本科系
札夸威	札夸威
札板儿	札板兒
朱一贵	朱一貴
朱丽亚	朱麗亞
朱丽叶	朱麗葉
朱书麟	朱書麟
朱买臣	朱買臣
朱云鹏	朱雲鵬
朱仑街	朱崙街
朱仙镇	朱仙鎮
朱俊彰	朱俊彰
朱俊晓	朱俊曉
朱允炆	朱允炆
朱元璋	朱元璋
朱元祥	朱元祥
朱全忠	朱全忠
朱兴荣	朱興榮
朱凤芝	朱鳳芝
朱利娅	朱利娅
朱利安	朱利安
朱印本	朱印本
朱古力	朱古力
朱咏薇	朱詠薇
朱哲琴	朱哲琴
朱培庆	朱培慶
朱墨本	朱墨本
朱士行	朱士行
朱天文	朱天文
朱婉琪	朱婉琪
朱子学	朱子學
朱孝天	朱孝天
朱宏瑜	朱宏瑜
朱宗庆	朱宗慶
朱家兴	朱家興
朱家彦	朱家彥
朱家欣	朱家欣
朱家鼎	朱家鼎
朱容基	朱容基
朱尉铭	朱尉銘
朱尔典	朱爾典
朱尔金	朱爾金
朱尼奥	朱尼奧
朱巴一	朱巴一
朱希真	朱希真
朱广沪	朱廣滬
朱庆余	朱慶餘
朱庆馀	朱慶餘
朱庇特	朱庇特
朱延平	朱延平
朱彝尊	朱彝尊
朱执信	朱執信
朱敦儒	朱敦儒
朱敬一	朱敬一
朱文庆	朱文慶
朱智勳	朱智勳
朱朝亮	朱朝亮
朱木炎	朱木炎
朱柏庐	朱柏廬
朱比特	朱比特
朱永弘	朱永弘
朱泽民	朱澤民
朱洪武	朱洪武
朱淑真	朱淑真
朱熔基	朱熔基
朱由校	朱由校
朱瞻基	朱瞻基
朱砂痣	硃砂痣
朱砂符	朱砂符
朱砂红	硃砂紅
朱祁钰	朱祁鈺
朱祁镇	朱祁鎮
朱祖谋	朱祖謀
朱立伦	朱立倫
朱红灯	朱紅燈
朱红色	硃紅色
朱经武	朱經武
朱自清	朱自清
朱舜水	朱舜水
朱莉娅	朱莉婭
朱衣吏	朱衣吏
朱衣神	朱衣神
朱贝尔	朱貝爾
朱迪亚	朱迪亞
朱郁信	朱郁信
朱镕基	朱鎔基
朱阿英	朱阿英
朱雀号	朱雀號
朱雀桥	朱雀橋
朱马亚	朱馬亞
朱骏声	朱駿聲
朱高炽	朱高熾
朴世莉	朴世莉
朴京琳	朴京琳
朴仔树	朴仔樹
朴修斯	樸修斯
朴克牌	樸克牌
朴凤柱	朴鳳柱
朴吉渊	朴吉淵
朴周永	朴周永
朴子市	朴子市
朴子溪	朴子溪
朴宣英	朴宣英
朴志胤	朴志胤
朴念仁	樸念仁
朴恩惠	朴恩惠
朴新阳	朴新陽
朴智星	朴智星
朴槿惠	朴槿惠
朴正恩	朴正恩
朴正熙	朴正熙
朴正祥	朴正祥
朴永训	朴永訓
朴泰桓	朴泰桓
朴璐美	朴璐美
朴真熙	朴真熙
朴诗妍	朴詩妍
朴赞浩	朴贊浩
机修厂	機修廠
机壳厂	機殼廠
机械系	機械系
机械表	機械錶
机械钟	機械鐘
朽木虫	朽木蟲
杀出去	殺出去
杀出来	殺出來
杀千刀	殺千刀
杀虫剂	殺蟲劑
杀虫器	殺蟲器
杀虫药	殺蟲藥
杀蠹药	殺蠹藥
杂交种	雜交種
杂合菜	雜合菜
杂和面	雜和麵
杂婚制	雜婚制
杂志奖	雜誌獎
杂志社	雜誌社
杂志纸	雜志紙
杂技团	雜技團
杂板令	雜板令
杂种人	雜種人
杂种狗	雜種狗
杂谷脑	雜谷腦
杂酱面	雜醬麵
权力欲	權力慾
杆菌性	桿菌性
杆菌类	桿菌類
杆菌素	桿菌素
杈杆儿	杈桿兒
李万进	李萬進
李三娘	李三娘
李丰永	李豐永
李云光	李雲光
李云娜	李雲娜
李修贤	李修賢
李克强	李克強
李克昂	李克昂
李克齐	李克齊
李公朴	李公樸
李准基	李準基
李千娜	李千娜
李叔同	李叔同
李后主	李後主
李咸阳	李咸陽
李国修	李國修
李圣杰	李聖傑
李复兴	李復興
李复甸	李復甸
李大同	李大同
李安修	李安修
李家同	李家同
李干龙	李乾龍
李开复	李開復
李志勳	李志勳
李志宏	李志宏
李志强	李志強
李洪志	李洪志
李炳千	李炳千
李百药	李百藥
李盟干	李盟乾
李秋静	李秋靜
李胜琛	李勝琛
李连杰	李連杰
李連杰	李連杰
李鉴原	李鑑原
李钟奭	李鐘奭
李钟郁	李鍾郁
李链福	李鍊福
李锺郁	李鍾郁
杏干儿	杏乾兒
材料系	材料系
材积表	材積表
村子里	村子裏
村干事	村幹事
村落发	村落發
村里长	村里長
杜丽娘	杜麗娘
杜寅杰	杜寅傑
杜尚别	杜尚別
杜尼克	杜尼克
杜杰利	杜傑利
杜杰尔	杜傑爾
杜正胜	杜正勝
杜秋娘	杜秋娘
杞梁妻	杞梁妻
条板箱	條板箱
条纹布	條紋布
来回票	來回票
来复日	來復日
来复枪	來復槍
来复线	來復綫
来自于	來自於
来苏水	來蘇水
来苏糖	來蘇糖
杨万发	楊萬發
杨万里	楊萬里
杨云龙	楊雲龍
杨俊胜	楊俊勝
杨千霈	楊千霈
杨士梁	楊士樑
杨宏志	楊宏志
杨文志	楊文誌
杨日松	楊日松
杨松弦	楊松弦
杨秋兴	楊秋興
杨胜帆	楊勝帆
杨胜旭	楊勝旭
杨致远	楊致遠
杨苏棣	楊甦棣
杨采妮	楊採妮
杨雅筑	楊雅筑
杯中物	杯中物
杯白干	杯白乾
杯盘舞	杯盤舞
杰乐米	傑樂米
杰佛兹	傑佛茲
杰佛利	傑佛利
杰佛士	傑佛士
杰佛森	傑佛森
杰佛瑞	傑佛瑞
杰佛逊	傑佛遜
杰克森	傑克森
杰克逊	傑克遜
杰卡伯	傑卡伯
杰士派	傑士派
杰奎琳	傑奎琳
杰尔村	傑爾村
杰尼斯	傑尼斯
杰弗逊	傑弗遜
杰拉德	傑拉德
杰福斯	傑福斯
杰福瑞	傑福瑞
杰米森	傑米森
杰西卡	傑西卡
杰迪卓	傑迪卓
杰里森	傑里森
杰里科	傑里科
杰里米	傑里米
松一下	鬆一下
松一些	鬆一些
松一松	鬆一鬆
松下了	鬆下了
松下来	鬆下來
松不开	鬆不開
松不松	鬆不鬆
松不紧	鬆不緊
松了松	鬆了鬆
松井秀	松井秀
松元音	鬆元音
松出一	鬆出一
松出口	鬆出口
松化石	松化石
松北区	松北區
松原市	松原市
松口气	鬆口氣
松口蘑	松口蘑
松叶蕨	松葉蕨
松土机	鬆土機
松大辅	松大輔
松山区	松山區
松山庄	松山庄
松岭区	松嶺區
松巴哇	松巴哇
松弛到	鬆弛到
松弛剂	鬆弛劑
松弛法	鬆弛法
松得多	鬆得多
松懈下	鬆懈下
松指部	松指部
松智路	松智路
松本仞	松本仞
松本润	松本潤
松果体	松果體
松果腺	松果腺
松柏园	松柏園
松桃县	松桃縣
松毛虫	松毛蟲
松江区	松江區
松江省	松江省
松江路	松江路
松油管	鬆油管
松油门	鬆油門
松浦亚	松浦亞
松溪县	松溪縣
松滋市	鬆滋市
松潘县	松潘縣
松烟墨	松煙墨
松焦油	松焦油
松狮犬	松獅犬
松球鱼	松球魚
松皮癣	松皮癬
松竹梅	松竹梅
松竹路	松竹路
松紧带	鬆緊帶
松脂石	松脂石
松脆饼	鬆脆餅
松节油	松節油
松花江	松花江
松花砚	松花硯
松花纸	松花紙
松花蛋	松花蛋
松花饼	松花餅
松藻虫	松藻蟲
松蛋包	鬆蛋包
松起来	鬆起來
松阳县	松陽縣
松隆子	松隆子
松露猪	松露豬
松风流	松風流
松香水	松香水
松香油	松香油
松高路	松高路
松鼠猴	松鼠猴
板凳区	板凳區
板南线	板南綫
板土线	板土綫
板式塔	板式塔
板擦儿	板擦兒
板条箱	板條箱
板桥市	板橋市
板梁桥	板梁橋
板着脸	板着臉
板羽球	板羽球
板著脸	板著臉
板蓝根	板藍根
板金工	板金工
板门店	板門店
极乐舞	極樂舞
极乐鸟	極樂鳥
极便当	極便當
极右派	極右派
极右翼	極右翼
极地年	極地年
极地狐	極地狐
极坐标	極座標
极大值	極大值
极大期	極大期
极小值	極小值
极少数	極少數
极左派	極左派
极待救	亟待救
极待解	亟待解
极性键	極性鍵
极短篇	極短篇
极端派	極端派
极细小	極細小
极限值	極限值
极高点	極高點
构筑物	構築物
林丰正	林豐正
林义杰	林義傑
林云阁	林雲閣
林俊杰	林俊杰
林克谟	林克謨
林克谦	林克謙
林占梅	林占梅
林合隆	林合隆
林周县	林周縣
林国梁	林國樑
林宏岳	林宏嶽
林布兰	林布蘭
林干闵	林乾閔
林志嘉	林志嘉
林志坚	林志堅
林志声	林志聲
林志杰	林志傑
林志炫	林志炫
林志玲	林志玲
林志翔	林志翔
林志辉	林志輝
林志隆	林志隆
林志雄	林志雄
林志颖	林志穎
林恢复	林恢復
林承志	林承志
林振丰	林振豐
林敬杰	林敬傑
林智胜	林智勝
林杰梁	林杰樑
林杰闵	林傑閔
林松焕	林松煥
林正杰	林正杰
林永发	林永發
林秀合	林秀合
林秋桂	林秋桂
林羣志	林羣志
林致光	林致光
林芳郁	林芳郁
林英杰	林英傑
林荣松	林榮松
林谷桦	林谷樺
林谷芳	林谷芳
林郁方	林郁方
林靖杰	林靖傑
林颖穗	林穎穗
林默娘	林默娘
果子干	果子乾
果子药	果子藥
枪杆儿	槍桿兒
枪杆子	槍桿子
枫之谷	楓之谷
枯叶蝶	枯葉蝶
架出去	架出去
架出来	架出來
架回去	架回去
架回来	架回來
柏克莱	柏克萊
柏克郡	柏克郡
柏南克	柏南克
柏卡里	柏卡里
柏戴克	柏戴克
柏梁体	柏梁體
柏梁台	柏梁臺
柏梁诗	柏梁詩
柏里斯	柏里斯
某个人	某個人
某方面	某方面
某种人	某種人
染发剂	染髮劑
染指于	染指於
染殿后	染殿后
染织厂	染織廠
柜员机	櫃員機
柜身子	櫃身子
柜面儿	櫃面兒
查克拉	査克拉
查克瑞	査克瑞
查准率	査準率
柯克斯	柯克斯
柯札克	柯札克
柳升耀	柳昇耀
柳叶儿	柳葉兒
柳叶刀	柳葉刀
柳叶描	柳葉描
柳叶眉	柳葉眉
柳叶鱼	柳葉魚
柳斌杰	柳斌杰
柳诒征	柳詒徵
柴埼幸	柴埼幸
査不出	査不出
査克拉	査克拉
査兑克	査兌克
査出来	査出來
査号台	査號臺
査回去	査回去
査回来	査回來
査报表	査報表
査询台	査詢台
査问出	査問出
标准值	標準值
标准像	標準像
标准制	標準制
标准化	標準化
标准型	標準型
标准局	標準局
标准差	標準差
标准时	標準時
标准木	標準木
标准杆	標準桿
标准版	標準版
标准组	標準組
标准舞	標準舞
标准规	標準規
标准语	標準語
标准间	標準間
标准音	標準音
标出去	標出去
标出来	標出來
标志性	標志性
标志着	標志着
标本虫	標本蟲
标示出	標示出
栉发工	櫛髮工
树虫子	樹蟲子
样板戏	樣板戲
核二厂	核二廠
核僵持	核僵持
核冬天	核冬天
核准的	核准的
核发电	核發電
核合成	核合成
核子厂	核子廠
核对表	核對表
核当量	核當量
核技术	核技術
核电厂	核電廠
核融合	核融合
核计划	核計劃
核防御	核防御
根据地	根據地
根目录	根目錄
根茎叶	根莖葉
格兰杰	格蘭傑
格别乌	格別烏
格子布	格子布
格斗王	格鬥王
格斗者	格鬥者
格斗赛	格鬥賽
格里历	格里曆
栽种机	栽種機
栽种法	栽種法
栽觔斗	栽觔斗
栽跟斗	栽跟斗
桂仔云	桂仔云
桂圆干	桂圓乾
桂林团	桂林團
桃叶歌	桃葉歌
桃叶渡	桃葉渡
桃核雕	桃核雕
桃花面	桃花面
桃金娘	桃金娘
框出来	框出來
案发前	案發前
案发后	案發後
案发时	案發時
案头柜	案頭櫃
桉叶油	桉葉油
桌别林	桌別林
桌历史	桌歷史
桌面上	桌面上
桌面儿	桌面兒
桐花烟	桐花煙
桑定党	桑定黨
桑布森	桑布森
桑干河	桑乾河
桑托斯	桑托斯
桑托荣	桑托榮
桑杰士	桑傑士
桓台县	桓台縣
档案柜	檔案櫃
桥面上	橋面上
梁世煌	梁世煌
梁仙台	梁仙台
梁任公	梁任公
梁伟聪	梁偉聰
梁伟铭	梁偉銘
梁修身	梁修身
梁元帝	梁元帝
梁又琳	梁又琳
梁启超	梁啓超
梁咏琪	梁詠琪
梁园区	梁園區
梁国荣	梁國榮
梁太祖	梁太祖
梁子湖	梁子湖
梁实秋	梁實秋
梁家辉	梁家輝
梁容银	梁容銀
梁山伯	梁山伯
梁山县	梁山縣
梁山市	梁山市
梁山泊	梁山泊
梁平县	梁平縣
梁建伟	梁建偉
梁德馨	梁德馨
梁心颐	梁心頤
梁惠王	梁惠王
梁敬帝	梁敬帝
梁文冲	梁文沖
梁文音	梁文音
梁文骐	梁文騏
梁朝伟	梁朝偉
梁次震	梁次震
梁武帝	梁武帝
梁河县	梁河縣
梁漱溟	梁漱溟
梁父吟	梁父吟
梁玉芳	梁玉芳
梁皇忏	梁皇懺
梁红玉	梁紅玉
梁经伦	梁經倫
梁茜雯	梁茜雯
梁辰鱼	梁辰魚
梁锦兴	梁錦興
梁静茹	梁靜茹
梁靜茹	梁靜茹
梅克尔	梅克爾
梅布托	梅布托
梅干菜	梅乾菜
梅西叶	梅西葉
梅里亚	梅里亞
梅里斯	梅里斯
梅里美	梅里美
梦周公	夢周公
梦工厂	夢工廠
梦游症	夢遊症
梦粱录	夢粱錄
梦行症	夢行症
梨干儿	梨乾兒
梳头发	梳頭髮
梳妆台	梳妝臺
检字表	檢字表
检査出	檢査出
检核表	檢核表
检测出	檢測出
检阅台	檢閱台
检验出	檢驗出
棉布婚	棉布婚
棉纤维	棉纖維
棉纺厂	棉紡廠
棉花布	棉花布
棉药签	棉藥簽
棉铃虫	棉鈴蟲
棒子面	棒子麵
棒极了	棒極了
棒针衫	棒針衫
棕色种	棕色種
棘针科	棘針科
棘针门	棘針門
森林里	森林裏
棱等登	棱等登
棱锥台	棱錐台
棺材板	棺材板
棺材里	棺材裏
植基于	植基於
植根于	植根於
植物志	植物誌
植病系	植病系
椭圆面	橢圓面
椰枣干	椰棗乾
楚庄王	楚莊王
楞了楞	楞了楞
楼台会	樓臺會
楼梯台	樓梯臺
榆叶梅	榆葉梅
榨油厂	榨油廠
樊于期	樊於期
模制品	模製品
模块板	模塊板
模型板	模型板
模式种	模式種
模拟出	模擬出
模板工	模板工
模组厂	模組廠
模范区	模範區
模范村	模範村
模范生	模範生
模范省	模範省
模范章	模範章
横了心	橫了心
横切面	橫切面
横剖面	橫剖面
横截面	橫截面
横断面	橫斷面
横筋斗	横筋斗
横须贺	橫須賀
樱花杯	櫻花盃
橄榄岩	橄欖岩
機械系	機械系
橡子面	橡子麵
橡木叶	橡木葉
次一个	次一個
次分面	次分面
欢乐谷	歡樂谷
欧伯托	歐伯托
欧佩克	歐佩克
欧克曼	歐克曼
欧克莱	歐克萊
欧战后	歐戰後
欧洲杯	歐洲杯
欧秋雅	歐秋雅
欧胡岛	歐胡島
欧里桑	歐里桑
欧阳修	歐陽修
欧雷克	歐雷克
欸乃曲	欸乃曲
歇后语	歇後語
歇马杯	歇馬杯
歌剧团	歌劇團
歌坛上	歌壇上
歌舞团	歌舞團
歌风台	歌風臺
歛出来	歛出來
止不了	止不了
止咳药	止咳藥
止泻药	止瀉藥
止痛药	止痛藥
止血药	止血藥
正义党	正義黨
正反合	正反合
正反面	正反面
正合适	正合適
正后像	正後像
正后方	正後方
正处于	正處於
正官庄	正官庄
正对面	正對面
正当中	正當中
正当化	正當化
正当性	正當性
正当时	正當時
正手板	正手板
正方向	正方向
正电极	正電極
正确度	正確度
正确性	正確性
正误表	正誤表
正集团	正集團
正面图	正面圖
步兵团	步兵團
步后尘	步後塵
步枪团	步槍團
步行虫	步行蟲
步进制	步進制
步青云	步青雲
武当山	武當山
武当派	武當派
武曲星	武曲星
武胜关	武勝關
武胜县	武勝縣
武里省	武里省
歪摆布	歪擺佈
死不了	死不了
死定了	死定了
死板板	死板板
死胡同	死胡同
残余物	殘餘物
残废后	殘廢後
段皇云	段皇雲
毋须乎	毋須乎
母大虫	母大蟲
母权制	母權制
母音表	母音表
每个人	每個人
每个月	每個月
每公里	每公里
每分钟	每分鐘
每每只	每每只
每秒钟	每秒鐘
毒僵指	毒殭指
比不了	比不了
比杆赛	比桿賽
比表面	比表面
毕业于	畢業於
毛囊虫	毛囊蟲
毛巾布	毛巾布
毛栗子	毛栗子
毛毛虫	毛毛蟲
毛纺厂	毛紡廠
毛线针	毛綫針
毛织布	毛織布
毛语录	毛語錄
毫仑目	毫侖目
毫居里	毫居里
民丰县	民豐縣
民主党	民主黨
民众党	民眾黨
民政里	民政里
民族党	民族黨
民族志	民族誌
民社党	民社黨
民进党	民進黨
气一冲	氣一衝
气冲冲	氣沖沖
气压表	氣壓表
气吁吁	氣吁吁
气象台	氣象臺
氢卤酸	氫鹵酸
氮血症	氮血症
水一冲	水一衝
水俣症	水俁症
水再冲	水再衝
水准仪	水準儀
水准器	水準器
水准图	水準圖
水利制	水利制
水又冲	水又衝
水合物	水合物
水已冲	水已衝
水已干	水已乾
水帘洞	水簾洞
水干尽	水乾盡
水干掉	水乾掉
水平面	水平面
水当当	水噹噹
水彩画	水彩畫
水彩笔	水彩筆
水急冲	水急衝
水成岩	水成岩
水才干	水才乾
水斧虫	水斧蟲
水晶杯	水晶杯
水曲柳	水曲柳
水泥厂	水泥廠
水泥板	水泥板
水温表	水溫表
水烟袋	水煙袋
水秋千	水鞦韆
水管系	水管系
水管面	水管麵
水精帘	水精簾
水经注	水經注
水蜡树	水蠟樹
水蜡虫	水蠟蟲
水谷隼	水谷隼
水里乡	水里鄉
水里鄉	水里鄉
水面上	水面上
水面舰	水面艦
水龙卷	水龍卷
永丰县	永豐縣
永丰堂	永豐堂
永丰舰	永豐艦
永丰金	永豐金
永丰馀	永豐餘
永修县	永修縣
永别酒	永別酒
永历史	永歷史
永胜县	永勝縣
求助于	求助於
求古录	求古錄
求教于	求教於
求知欲	求知慾
求胜心	求勝心
汇出行	匯出行
汇川区	匯川區
汇款人	匯款人
汇款单	匯款單
汇流处	匯流處
汇流排	匯流排
汇流点	匯流點
汇流环	匯流環
汇率制	匯率制
汇集点	匯集點
汉台区	漢臺區
汉学系	漢學係
汉宫秋	漢宮秋
汉药方	漢藥方
汞合金	汞合金
江宏杰	江宏傑
江干区	江乾區
江志雄	江志雄
江苏人	江蘇人
江苏省	江蘇省
江苏队	江蘇隊
江采苹	江采蘋
江面上	江面上
江韦仑	江韋侖
汤下面	湯下麵
汪少杰	汪少傑
汪曲克	汪曲克
汲汲于	汲汲於
汽车厂	汽車廠
沃达丰	沃達豐
沈世宏	沈世宏
沈世朋	沈世朋
沈丘县	沈丘縣
沈云英	沈雲英
沈亚之	沈亞之
沈从文	沈從文
沈伟豪	沈偉豪
沈传芷	沈傳芷
沈住气	沈住氣
沈佳颖	沈佳穎
沈佺期	沈佺期
沈兼士	沈兼士
沈北新	沈北新
沈吉线	瀋吉綫
沈哲鲲	沈哲鯤
沈国放	沈國放
沈塔尼	沈塔尼
沈天俞	沈天俞
沈如峰	沈如峰
沈家诚	沈家誠
沈富雄	沈富雄
沈尹默	沈尹默
沈山线	瀋山綫
沈崇诲	沈崇誨
沈庆京	沈慶京
沈庆光	沈慶光
沈建宏	沈建宏
沈惠珍	沈惠珍
沈振来	沈振來
沈文台	沈文台
沈文成	沈文成
沈明伦	沈明倫
沈春华	沈春華
沈昭铭	沈昭銘
沈柏苍	沈柏蒼
沈殿霞	沈殿霞
沈河区	沈河區
沈淀法	沈澱法
沈淀物	沈澱物
沈淑敏	沈淑敏
沈滞性	沈滯性
沈玉琳	沈玉琳
沈璀庭	沈璀庭
沈甸甸	沈甸甸
沈砂池	沈砂池
沈积岩	沈積岩
沈积石	沈積石
沈筱珺	沈筱珺
沈继昌	沈繼昌
沈葆桢	沈葆楨
沈葆祯	沈葆禎
沈诗钧	沈詩鈞
沈钧启	沈鈞啓
沈钰杰	沈鈺傑
沈阳市	沈陽市
沈雁冰	沈雁冰
沈雨庭	沈雨庭
沈靳扬	沈靳揚
沉浸于	沉浸於
沉淀剂	沉澱劑
沉淀法	沉澱法
沉淀物	沉澱物
沉湎于	沉湎於
沉溺于	沉溺於
沉积岩	沉積岩
沉迷于	沉迷於
沉醉于	沉醉於
沉陷于	沉陷於
沙发垫	沙發墊
沙发椅	沙發椅
沙发牀	沙發牀
沙坑杆	沙坑桿
沙弥戒	沙彌戒
沙茶面	沙茶麵
沙里夫	沙里夫
沙雕赛	沙雕賽
没乱里	沒亂裏
没了当	沒了當
没了期	沒了期
没了法	沒了法
没了落	沒了落
没事干	沒事幹
没人烟	沒人煙
没体面	沒體面
没关系	沒關係
没准儿	沒準兒
没准头	沒準頭
没出去	沒出去
没出息	沒出息
没出来	沒出來
没出豁	沒出豁
没出长	沒出長
没合杀	沒合殺
没合煞	沒合煞
没后跟	沒後跟
没回去	沒回去
没回来	沒回來
没地里	沒地里
没头当	沒頭當
没干头	沒幹頭
没干淨	沒乾淨
没志气	沒志氣
没志行	沒志行
没意志	沒意志
没折至	沒摺至
没担当	沒擔當
没来历	沒來歷
没来回	沒來回
没松下	沒鬆下
没样范	沒樣範
没梁桶	沒梁桶
没梢干	沒梢幹
没算当	沒算當
没脊梁	沒脊梁
没脸面	沒臉面
没说出	沒說出
没量斗	沒量斗
没雕当	沒雕當
没面子	沒面子
没面皮	沒面皮
没面目	沒面目
河升镇	河昇鎮
河曲县	河曲縣
河面上	河面上
油伙儿	油夥兒
油当量	油當量
油烟机	油煙機
油花卜	油花卜
油里滑	油裏滑
油页岩	油頁岩
泄出去	泄出去
泄出来	泄出來
法云地	法雲地
法克斯	法克斯
法兰克	法蘭克
法制化	法制化
法制局	法制局
法向量	法向量
法国杯	法國杯
法布尔	法布爾
法布施	法佈施
法律系	法律系
法律面	法律面
法拉托	法拉托
法文系	法文系
法自制	法自制
法语系	法語系
法鲁克	法魯克
泛出来	泛出來
波克夏	波克夏
波克特	波克特
波发藻	波髮藻
波塞冬	波塞冬
波尔干	波爾干
波布那	波布那
波形板	波形板
波拉克	波拉克
波来克	波來克
波杰曼	波傑曼
波棱菜	波棱菜
波洛克	波洛克
波状云	波狀雲
波里斯	波里斯
泥土面	泥土面
泥板岩	泥板岩
泥灰岩	泥灰岩
泥质岩	泥質岩
注中奖	注中獎
注冊单	註冊單
注冊日	註冊日
注冊码	註冊碼
注冊组	註冊組
注冊费	註冊費
注册人	注冊人
注册表	注冊表
注射剂	注射劑
注射器	注射器
注射液	注射液
注射筒	注射筒
注射针	注射針
注意到	注意到
注意力	注意力
注意看	注意看
注目礼	注目禮
注音文	注音文
注音法	註音法
泳气钟	泳氣鐘
泻出去	瀉出去
泻出来	瀉出來
泼出去	潑出去
泼出来	潑出來
泼毛团	潑毛團
泼烟花	潑煙花
泼脏水	潑髒水
泼花团	潑花團
泽当镇	澤當鎮
泽里可	澤里可
洁面乳	潔面乳
洁面露	潔面露
洋干漆	洋乾漆
洋紫苏	洋紫蘇
洗出去	洗出去
洗出来	洗出來
洗发乳	洗髮乳
洗发剂	洗髮劑
洗发水	洗髮水
洗发皂	洗髮皂
洗发粉	洗髮粉
洗发精	洗髮精
洗发膏	洗髮膏
洗发露	洗髮露
洗地板	洗地板
洗头发	洗頭髮
洗干淨	洗乾淨
洗手台	洗手檯
洗脑术	洗腦術
洗脸台	洗臉臺
洗衣板	洗衣板
洗面乳	洗面乳
洗面奶	洗面奶
洗面皂	洗面皂
洛克比	洛克比
洛扎县	洛扎縣
洛迪克	洛迪克
洪万春	洪萬春
洪信杰	洪信傑
洪士杰	洪士杰
洪志善	洪志善
洪志宏	洪志宏
洪杰鸿	洪傑鴻
洪若朴	洪若樸
洲际杯	洲際盃
洴澼药	洴澼藥
活不了	活不了
活动于	活動於
活塞杆	活塞桿
活饥荒	活饑荒
派出去	派出去
派出所	派出所
派出来	派出來
派屈克	派屈克
派崔克	派崔克
派拉蒙	派拉蒙
派翠克	派翠克
流亡曲	流亡曲
流出去	流出去
流出来	流出來
流回去	流回去
流回来	流回來
流当品	流當品
流水板	流水板
流涎症	流涎症
流理台	流理台
流程表	流程表
流纹岩	流紋岩
流苏帐	流蘇帳
流苏髻	流蘇髻
流行于	流行於
流行曲	流行曲
流行症	流行症
流量表	流量表
流露出	流露出
流风余	流風餘
浅尝者	淺嘗者
浅浮雕	淺浮雕
浊积岩	濁積岩
测不准	測不準
测光表	測光表
测出来	測出來
测录到	測錄到
测量出	測量出
测量术	測量術
测量杆	測量桿
测验卷	測驗卷
浑仪注	渾儀註
浑闲事	渾閒事
浓血症	濃血症
浪又冲	浪又衝
浪漫曲	浪漫曲
浪琴表	浪琴錶
浪荡子	浪蕩子
浪荡灯	浪蕩燈
浮梁县	浮梁縣
浮现出	浮現出
浮雕像	浮雕像
海上游	海上遊
海丰县	海豐縣
海参威	海參威
海参崴	海參崴
海埔姜	海埔姜
海带卷	海帶卷
海平面	海平面
海德里	海德里
海水面	海水面
海淀区	海澱區
海漂杯	海漂杯
海百合	海百合
海藻虫	海藻蟲
海马回	海馬迴
海鲜面	海鮮麵
海默症	海默症
涂善妮	涂善妮
涂壮勋	涂壯勳
涂壯勳	涂壯勳
涂天相	涂天相
涂尔干	涂爾干
涂居贤	涂居賢
涂序瑄	涂序瑄
涂惠元	涂惠元
涂惠源	涂惠源
涂敏恆	涂敏恆
涂敏恒	涂敏恆
涂文生	涂文生
涂永辉	涂永輝
涂油于	塗油於
涂泽民	涂澤民
涂浆台	塗漿檯
涂澤民	涂澤民
涂绍煃	涂紹煃
涂美伦	涂美倫
涂羽卿	涂羽卿
涂色板	塗色板
涂謹申	涂謹申
涂谨申	涂謹申
涂过去	塗過去
涂过来	塗過來
涂逢年	涂逢年
涂醒哲	涂醒哲
涂長望	涂長望
涂长望	涂長望
涂饰剂	塗飾劑
涂鴻欽	涂鴻欽
涂鸦区	塗鴉區
涂鸿钦	涂鴻欽
消息面	消息面
消极性	消極性
消极论	消極論
消毒药	消毒藥
消渴症	消渴症
消炎药	消炎藥
消肿药	消腫藥
消费欲	消費慾
消闲儿	消閒兒
涉足于	涉足於
涌出去	涌出去
涌出来	涌出來
涌升流	涌升流
涌现出	涌現出
涡虫纲	渦蟲綱
涨停板	漲停板
涨回去	漲回去
涨回来	漲回來
液晶板	液晶板
液晶表	液晶錶
淀北片	澱北片
淀山湖	澱山湖
淀积物	淀积物
淀粉样	澱粉樣
淀粉类	澱粉類
淀粉糖	澱粉糖
淀粉脢	澱粉脢
淀粉质	澱粉質
淀解物	澱解物
淋余土	淋餘土
淌板船	淌板船
淘汰制	淘汰制
淘闲气	淘閒氣
淡蒙蒙	淡濛濛
淨水厂	淨水廠
淨流出	淨流出
淨胜球	淨勝球
淩云笔	淩雲筆
深成岩	深成岩
深渊里	深淵裏
淳于意	淳于意
淳于髡	淳于髡
混出去	混出去
混出来	混出來
混合体	混合體
混合器	混合器
混合型	混合型
混合层	混合層
混合式	混合式
混合性	混合性
混合林	混合林
混合比	混合比
混合法	混合法
混合泳	混合泳
混合物	混合物
混合组	混合組
混合语	混合語
混同江	混同江
混血种	混血種
清丰县	清豐縣
清实录	清實錄
清异录	清異錄
清晨杯	清晨盃
清水烟	清水煙
清芬志	清芬志
渊源录	淵源錄
渍已干	漬已乾
渔获量	漁獲量
渗出来	滲出來
渗出物	滲出物
渗出量	滲出量
渡头云	渡頭雲
温布敦	溫布敦
温布里	溫布里
温布顿	溫布頓
温度表	溫度表
温祥云	溫祥雲
港制品	港製品
港澳台	港澳臺
游上去	游上去
游上来	游上來
游下去	游下去
游下来	游下來
游中国	遊中國
游乃海	游乃海
游乐区	遊樂區
游乐器	遊樂器
游乐园	遊樂園
游乐场	遊樂場
游乐林	遊樂林
游亚洲	遊亞洲
游仙区	游仙區
游仙枕	遊仙枕
游仙窟	游仙窟
游仙诗	遊仙詩
游击区	游擊區
游击战	游擊戰
游击手	游擊手
游击队	游擊隊
游北美	遊北美
游台湾	遊臺灣
游回去	游回去
游回来	游回來
游园会	遊園會
游囿伦	游囿倫
游子吟	遊子吟
游学生	遊學生
游客量	遊客量
游志宏	游志宏
游憩区	遊憩區
游戏业	遊戲業
游戏包	遊戲包
游戏区	遊戲區
游戏场	遊戲場
游戏机	遊戲機
游戏池	游戲池
游戏王	遊戲王
游戏町	遊戲町
游戏说	遊戲說
游文宏	游文宏
游明金	游明金
游易网	遊易網
游昭钦	游昭欽
游欧洲	遊歐洲
游泳圈	游泳圈
游泳池	游泳池
游泳衣	游泳衣
游泳裤	游泳褲
游泳课	游泳課
游泳赛	游泳賽
游泳镜	游泳鏡
游泳队	游泳隊
游泳馆	游泳館
游澳洲	遊澳洲
游牧区	遊牧區
游皓玮	游皓瑋
游盈隆	游盈隆
游益网	遊益網
游离层	游離層
游离票	游離票
游禽类	游禽類
游美洲	遊美洲
游艇业	遊艇業
游艺会	遊藝會
游艺团	遊藝團
游艺场	遊藝場
游芳来	游芳來
游行到	遊行到
游行法	遊行法
游览区	遊覽區
游览车	遊覽車
游说团	游說團
游过去	游過去
游过来	游過來
游进去	游進去
游进来	游進來
游锡坤	游錫坤
游锡堃	游錫堃
游锡昆	游錫昆
游非洲	遊非洲
游香港	遊香港
游骑兵	遊騎兵
游鸿儒	游鴻儒
游鸿明	游鴻明
游龙荣	游龍榮
湖里区	湖里區
湾里区	灣裏區
湿地松	濕地松
湿度表	濕度表
源汇区	源匯區
源自于	源自於
溜冰团	溜冰團
溜出去	溜出去
溜出来	溜出來
溜回去	溜回去
溜回来	溜回來
溜滑板	溜滑板
溢出来	溢出來
溶岩流	溶岩流
滑动面	滑動面
滑水板	滑水板
滑雪术	滑雪術
滑雪板	滑雪板
滚出去	滾出去
滚出来	滾出來
滚回去	滾回去
滚回来	滾回來
滚彩蛋	滾彩蛋
满出来	滿出來
满堂彩	滿堂彩
满好个	滿好個
满当当	滿當當
满洲里	滿洲裏
滤出去	濾出去
滤出来	濾出來
滨松市	濱松市
滴了天	滴了天
滴出来	滴出來
漆器雕	漆器雕
漏了眼	漏了眼
漏出去	漏出去
漏出来	漏出來
漏尽通	漏盡通
漏斗器	漏斗器
漏斗管	漏斗管
漏斗胸	漏斗胸
漏面贼	漏面賊
演出人	演出人
演出来	演出來
演出者	演出者
演化出	演化出
演员表	演員表
演奏出	演奏出
演奏台	演奏臺
演奏曲	演奏曲
演绎出	演繹出
演讲台	演講台
漫出来	漫出來
漫游费	漫遊費
漱口杯	漱口杯
潘威志	潘威誌
潘越云	潘越雲
潘连周	潘連周
潜出去	潛出去
潜出来	潛出來
潜台词	潛臺詞
潜水表	潛水錶
潜水钟	潛水鐘
激发出	激發出
激发态	激發態
激发起	激發起
激荡出	激盪出
激进党	激進黨
瀑布区	瀑布區
瀑布羣	瀑布羣
灌云县	灌雲縣
灌出去	灌出去
灌出来	灌出來
灌回去	灌回去
灌注器	灌注器
火云邪	火雲邪
火山岩	火山岩
火并非	火並非
火彩儿	火彩兒
火成岩	火成岩
火折子	火摺子
火柴杆	火柴桿
火浣布	火浣布
火炬松	火炬松
火烧云	火燒雲
火绳杆	火繩桿
火药味	火藥味
火药库	火藥庫
火虫儿	火蟲兒
火里赤	火裏赤
火链片	火鏈片
灭不个	滅不個
灭种罪	滅種罪
灭虫剂	滅蟲劑
灭虫宁	滅蟲寧
灰同协	灰同協
灰姑娘	灰姑娘
灰蒙蒙	灰濛濛
灵台县	靈台縣
灵谷寺	靈谷寺
灾害链	災害鏈
炎症性	炎癥性
炒栗子	炒栗子
炒菜铲	炒菜鏟
炕面砖	炕面磚
炸药箱	炸藥箱
炸酱面	炸醬麵
点出去	點出去
点出来	點出來
点半钟	點半鐘
点名表	點名表
点回去	點回去
点回来	點回來
点多钟	點多鐘
点将录	點將錄
点播曲	點播曲
点烟器	點煙器
点线面	點綫面
点集合	點集合
炼丹术	煉丹術
炼制厂	煉製廠
炼油厂	煉油廠
炼焦厂	煉焦廠
炼焦炉	煉焦爐
炼焦煤	煉焦煤
炼糖厂	煉糖廠
炼金术	鍊金術
炼钢业	煉鋼業
炼钢厂	煉鋼廠
炼钢炉	煉鋼爐
炼铁厂	煉鐵廠
炼铁炉	煉鐵爐
炼铜厂	煉銅廠
烂了嘴	爛了嘴
烘干机	烘乾機
烘托出	烘托出
烟傢伙	煙傢伙
烟卷儿	煙捲兒
烟台市	煙臺市
烟合包	煙合包
烟嘴儿	菸嘴兒
烟夜蛾	煙夜蛾
烟屁股	菸屁股
烟幕弹	煙幕彈
烟斗丝	菸斗絲
烟月场	煙月場
烟月牌	煙月牌
烟枪洞	煙槍洞
烟毒犯	煙毒犯
烟波客	煙波客
烟火气	煙火氣
烟火秀	煙火秀
烟火节	煙火節
烟火食	煙火食
烟灰缸	菸灰缸
烟熏妆	煙熏妝
烟硝味	煙硝味
烟碱酸	煙鹼酸
烟筒山	煙筒山
烟管面	煙管麵
烟纸店	菸紙店
烟臭味	煙臭味
烟花债	煙花債
烟花厂	煙花廠
烟花场	煙花場
烟花女	煙花女
烟花寨	煙花寨
烟花巷	煙花巷
烟花市	煙花市
烟花窟	煙花窟
烟花簿	煙花簿
烟花队	煙花隊
烟花阵	煙花陣
烟草味	煙草味
烟袋嘴	煙袋嘴
烟酒税	菸酒稅
烟雨楼	煙雨樓
烟雾剂	煙霧劑
烟雾弹	煙霧彈
烟雾症	煙霧症
烟霞癖	煙霞癖
烤漆板	烤漆板
烤面包	烤麵包
烦死了	煩死了
烧出去	燒出去
烧出来	燒出來
烧录器	燒錄器
烧录机	燒錄機
烧杯架	燒杯架
烫个发	燙個髮
烫发师	燙髮師
烫头发	燙頭髮
烫完发	燙完髮
烫次发	燙次髮
烫衣板	燙衣板
热干面	熱幹面
热当量	熱當量
热电厂	熱電廠
热脉冲	熱脈衝
热衷于	熱衷於
热量表	熱量表
烹调术	烹調術
烽火台	烽火臺
焚化厂	焚化廠
焚尸案	焚屍案
焚尸炉	焚屍爐
焦化厂	焦化廠
焦虑症	焦慮症
然后就	然後就
煎药法	煎藥法
煎蛋卷	煎蛋卷
煤气表	煤氣表
照入签	照入籤
照出去	照出去
照出来	照出來
照后镜	照後鏡
照相术	照相術
煮出来	煮出來
煮沸后	煮沸後
熊克武	熊克武
熏草纸	熏草紙
熏蒸剂	燻蒸劑
熏蒸室	燻蒸室
熏衣草	熏衣草
熏鱼儿	燻魚兒
熏黑了	燻黑了
熔岩流	熔岩流
熔岩湖	熔岩湖
熔炼炉	熔煉爐
熟面人	熟面人
熟面孔	熟面孔
熬出头	熬出頭
熬出来	熬出來
熬药汤	熬藥湯
爆发出	爆發出
爆发力	爆發力
爆发性	爆發性
爆发星	爆發星
爆发音	爆發音
爆破术	爆破術
爬出去	爬出去
爬出来	爬出來
爬满了	爬滿了
爬虫类	爬蟲類
爰历篇	爰歷篇
爱克斯	愛克斯
爱弥儿	愛彌兒
爱彼表	愛彼錶
爱德蒙	愛德蒙
爱情里	愛情裏
爱抽烟	愛抽煙
爱游玩	愛遊玩
爱面子	愛面子
父权制	父權制
牀头柜	牀頭櫃
片头曲	片頭曲
片尾曲	片尾曲
片面性	片面性
片麻岩	片麻岩
牌子曲	牌子曲
牙克石	牙克石
牙医系	牙醫系
牙后慧	牙後慧
牙周炎	牙周炎
牙周病	牙周病
牙缝里	牙縫裏
牛仔布	牛仔布
牛柳面	牛柳麵
牛肉干	牛肉乾
牛肉面	牛肉麵
物理系	物理系
牲干下	牲幹下
牵一发	牽一髮
牵出去	牽出去
牵出来	牽出來
牵回去	牽回去
牵回来	牽回來
牵引出	牽引出
牵机药	牽機藥
特价品	特價品
特价菜	特價菜
特使团	特使團
特克斯	特克斯
特别号	特別號
特别奖	特別獎
特别座	特別座
特别是	特別是
特别法	特別法
特别版	特別版
特别组	特別組
特别股	特別股
特别致	特别致
特别费	特別費
特别长	特別長
特制住	特制住
特制品	特製品
特制定	特制定
特制止	特制止
特制订	特制訂
特地回	特地回
特征值	特徵值
特惠价	特惠價
特技团	特技團
特效药	特效藥
特有种	特有種
特松加	特松加
特种兵	特種兵
特种钢	特種鋼
特蒙德	特蒙德
特里尔	特里爾
状态表	狀態表
犹太历	猶太曆
犹如表	猶如錶
犹如钟	猶如鐘
狂并潮	狂併潮
狂想曲	狂想曲
狂牛症	狂牛症
狄仁杰	狄仁傑
狄克森	狄克森
狄志杰	狄志杰
狄拉克	狄拉克
狄里斯	狄里斯
狗嘴里	狗嘴裏
狗杂种	狗雜種
独占性	獨佔性
独占权	獨佔權
独唱曲	獨唱曲
独奏曲	獨奏曲
独立党	獨立黨
独自个	獨自個
狭心症	狹心症
狼卜食	狼卜食
狼来了	狼來了
狼虎药	狼虎藥
猎获物	獵獲物
猛个劲	猛個勁
猛可里	猛可裏
猛回头	猛回頭
猛地里	猛地裏
猜出来	猜出來
猜得出	猜得出
猜测出	猜測出
猪肉干	豬肉乾
猪肝面	豬肝麵
猪脚面	豬腳麵
猪舌面	豬舌麵
猴面包	猴麵包
玄武岩	玄武岩
玉历史	玉歷史
玉参差	玉參差
玉台体	玉臺體
玉山杯	玉山杯
玉米面	玉米麵
玉米须	玉米鬚
玉里镇	玉里鎮
玉镜台	玉鏡臺
玉面貍	玉面貍
王于真	王于真
王云五	王雲五
王余鱼	王餘魚
王侯后	王侯后
王太后	王太后
王子面	王子麵
王干发	王乾發
王幸男	王幸男
王彩桦	王彩樺
王彩碧	王彩碧
王志华	王志華
王志文	王志文
王志羣	王志羣
王志贞	王志貞
王杰胜	王傑勝
王正杰	王正杰
王涂发	王塗發
王熙松	王熙松
王献极	王獻極
王秋凤	王秋鳳
王茂松	王茂松
玛斯克	瑪斯克
玛曲县	瑪曲縣
玛泰克	瑪泰克
玩具厂	玩具廠
玩出去	玩出去
玩出来	玩出來
环安系	環安系
环工系	環工系
现制性	現制性
现实面	現實面
现货价	現貨價
玳瑁梁	玳瑁梁
玻璃布	玻璃布
玻璃杯	玻璃杯
玻璃板	玻璃板
玻璃柜	玻璃櫃
珊瑚虫	珊瑚蟲
珍珠岩	珍珠岩
珐瑯彩	琺瑯彩
班代表	班代表
班克斯	班克斯
班兰叶	班蘭葉
球后小	球后小
球团矿	球團礦
球坛上	球壇上
球面体	球面體
球面镜	球面鏡
理个发	理個髮
理发匠	理髮匠
理发厅	理髮廳
理发员	理髮員
理发师	理髮師
理发店	理髮店
理发院	理髮院
理头发	理頭髮
理完发	理完髮
理次发	理次髮
理胡子	理鬍子
琉璃厂	琉璃廠
琵琶录	琵琶錄
琵琶虫	琵琶蟲
琼瑶曲	瓊瑤曲
瑜伽术	瑜伽術
瑜珈术	瑜珈術
瑞克希	瑞克希
瑞士卷	瑞士捲
瑞穗乡	瑞穗鄉
瑞贝里	瑞貝里
瑶台镜	瑤臺鏡
璧炉台	璧爐台
瓦历斯	瓦歷斯
瓦当文	瓦當文
瓦特表	瓦特表
瓦萨里	瓦薩里
瓦西里	瓦西裏
瓦达克	瓦達克
瓦里斯	瓦裏斯
甘巴里	甘巴裏
甘托克	甘托克
甘谷县	甘谷縣
甚至于	甚至於
甜水面	甜水麵
甜萝卜	甜蘿蔔
甜面酱	甜麵醬
甜面醬	甜麵醬
生出来	生出來
生力面	生力麵
生华发	生華髮
生发剂	生髮劑
生发水	生髮水
生发生	生發生
生发药	生髮藥
生命表	生命表
生姜丝	生薑丝
生姜汁	生薑汁
生姜片	生薑片
生字表	生字表
生态系	生態系
生死斗	生死鬥
生活杯	生活杯
生活面	生活面
生物系	生物系
生物钟	生物鐘
生田斗	生田斗
生药局	生藥局
生词表	生詞表
生长板	生長板
生面团	生麵糰
生面孔	生面孔
用不了	用不了
用幸福	用幸福
用报台	用報台
甩出去	甩出去
甩出来	甩出來
田园曲	田園曲
田字面	田字面
田家庵	田家庵
田志兴	田志興
田秋堇	田秋堇
田种玉	田種玉
田舍奴	田舍奴
田舍翁	田舍翁
田舍郎	田舍郎
甲壳虫	甲殼蟲
甲虫类	甲蟲類
甲虫车	甲蟲車
申扎县	申扎縣
申请表	申請表
电冰柜	電冰櫃
电力厂	電力廠
电压表	電壓表
电唱针	電唱針
电子云	電子雲
电子系	電子系
电子表	電子錶
电子钟	電子鐘
电宰厂	電宰廠
电度表	電度表
电影台	電影台
电机系	電機系
电检制	電檢制
电池厂	電池廠
电池板	電池板
电流表	電流表
电热杯	電熱杯
电熨斗	電熨斗
电码表	電碼表
电线杆	電綫杆
电胡刀	電鬍刀
电脑台	電腦檯
电视台	電視臺
电视柜	電視櫃
电路板	電路板
电量表	電量表
电须刀	電鬚刀
男佣人	男佣人
男同学	男同學
男同志	男同志
男用表	男用錶
画出来	畫出來
画表格	畫表格
畅销曲	暢銷曲
留余地	留餘地
留后手	留後手
留后步	留後步
留后路	留後路
留头发	留頭髮
留种地	留種地
留胡子	留鬍子
留胡须	留鬍鬚
留脸面	留臉面
留言板	留言板
留面子	留面子
略低于	略低於
略大于	略大於
略语表	略語表
略高于	略高於
番泻叶	番瀉葉
疋先里	疋先裏
疏松症	疏鬆症
疟原虫	瘧原蟲
疥癣虫	疥癬蟲
疲劳症	疲勞症
病历卡	病歷卡
病历室	病歷室
病历表	病歷表
病原虫	病原蟲
病虫害	病蟲害
症侯群	症侯羣
症候羣	症候羣
症候群	症候羣
症状性	症狀性
症结点	癥結點
痴呆症	癡呆症
瘙痒症	瘙痒症
癡呆症	癡呆症
癫痫症	癲癇症
登云梯	登雲梯
登出去	登出去
登出来	登出來
登科录	登科錄
登记表	登記表
登龙术	登龍術
白了了	白了了
白云乡	白雲鄉
白云区	白雲區
白云山	白雲山
白云岩	白雲岩
白云母	白雲母
白云石	白雲石
白云观	白雲觀
白僵蚕	白殭蠶
白化症	白化症
白千层	白千層
白发人	白髮人
白变种	白變種
白合金	白合金
白团扇	白團扇
白垩系	白堊系
白娘子	白娘子
白干儿	白干兒
白斑症	白斑症
白杆兵	白桿兵
白板笔	白板筆
白果松	白果松
白洋淀	白洋澱
白皮松	白皮松
白种人	白種人
白粉面	白粉麵
白胡椒	白胡椒
白色系	白色系
白苹洲	白蘋洲
白菜价	白菜價
白萝卜	白蘿蔔
白蒙蒙	白濛濛
白蜡树	白蠟樹
白蜡虫	白蠟蟲
白蜡蜡	白蠟蠟
白里安	白里安
白雪曲	白雪曲
白面儿	白麵兒
白面皮	白面皮
白骨松	白骨松
白鹤梁	白鶴梁
百万位	百萬位
百万吨	百萬噸
百万年	百萬年
百余只	百餘隻
百余里	百餘里
百几个	百幾個
百分制	百分制
百分表	百分表
百只可	百只可
百只够	百只夠
百只怕	百只怕
百叶卷	百葉捲
百叶窗	百葉窗
百叶箱	百葉箱
百合子	百合子
百合科	百合科
百合花	百合花
百多只	百多隻
百天后	百天後
百年后	百年後
百度表	百度表
百折裙	百摺裙
百科里	百科裏
百老汇	百老匯
百脑汇	百腦匯
百花历	百花曆
百谷王	百谷王
百足虫	百足蟲
百里侯	百里侯
百里傒	百里傒
百里香	百里香
百链刚	百鍊剛
百链金	百鍊金
百链钢	百鍊鋼
百链铁	百鍊鐵
百面雷	百面雷
的亮发	的亮髮
的克制	的剋制
的确会	的確會
的确是	的確是
的确良	的確良
的范围	的範圍
的钟表	的鐘錶
皇历史	皇歷史
皇后区	皇后區
皇后号	皇后號
皇后镇	皇后鎮
皇太后	皇太后
皇太极	皇太極
皇极历	皇極曆
皇极数	皇極數
皮克斯	皮克斯
皮克林	皮克林
皮划艇	皮劃艇
皮制品	皮製品
皮制服	皮制服
皮困秋	皮困秋
皮夹克	皮夾克
皮托管	皮托管
皮板儿	皮板兒
盐水针	鹽水針
盖维克	蓋維克
盗御马	盜御馬
盗版党	盜版黨
盛行于	盛行於
目力表	目力表
目录卡	目錄卡
目录学	目錄學
目标价	目標價
直升机	直升機
直发女	直髮女
直发毛	直發毛
直系亲	直系親
相克制	相剋制
相克服	相克服
相同于	相同於
相同点	相同點
相对于	相對於
相对极	相對極
相平面	相平面
相当于	相當於
相符合	相符合
相等于	相等於
相结合	相結合
相融合	相融合
相适应	相適應
省党部	省黨部
省出来	省出來
省可里	省可裏
省道台	省道台
看上了	看上了
看下表	看下錶
看下钟	看下鐘
看不出	看不出
看中了	看中了
看出去	看出去
看出来	看出來
看台股	看台股
看得出	看得出
看终了	看終了
看花了	看花了
看表面	看表面
看风向	看風向
看麦娘	看麥娘
真主党	真主黨
真保志	真保志
真值表	真值表
真实面	真實面
真彩色	真彩色
真成了	真成了
真服了	真服了
真面目	真面目
眺望台	眺望臺
眼干症	眼乾症
眼扎毛	眼扎毛
眼眶里	眼眶裏
眼睛里	眼睛裏
眼药水	眼藥水
眼药膏	眼藥膏
眼镜布	眼鏡布
睡个夠	睡個夠
睡个觉	睡個覺
睡游病	睡遊病
睡病虫	睡病蟲
睡眠曲	睡眠曲
睡眠欲	睡眠慾
睡眠虫	睡眠蟲
睡莲叶	睡蓮葉
瞄不准	瞄不準
瞄准到	瞄準到
瞅下表	瞅下錶
瞅下钟	瞅下鐘
瞅不准	瞅不準
瞌睡虫	瞌睡蟲
瞎了眼	瞎了眼
瞎扎呼	瞎扎呼
瞑子里	瞑子裏
瞧不准	瞧不準
瞧不出	瞧不出
瞭望台	瞭望臺
瞿秋白	瞿秋白
知制诰	知制誥
知道了	知道了
矫正术	矯正術
矬个儿	矬個兒
短不了	短不了
短发性	短發性
短纤维	短纖維
矮个儿	矮個兒
矮个子	矮個子
矮冬瓜	矮冬瓜
石內卜	石內卜
石化厂	石化廠
石台县	石臺縣
石头布	石頭布
石家庄	石家莊
石工术	石工術
石志伟	石志偉
石敢当	石敢當
石松粉	石松粉
石板屋	石板屋
石板瓦	石板瓦
石板路	石板路
石板道	石板道
石棉布	石棉布
石棉板	石棉板
石棉症	石棉症
石油蜡	石油蠟
石灰岩	石灰岩
石炭系	石炭系
石版术	石版術
石百合	石百合
石绵板	石綿板
石胡荽	石胡荽
石英岩	石英岩
石英表	石英錶
石英钟	石英鐘
石蜡像	石蠟像
石钟乳	石鐘乳
石雕像	石雕像
石雕家	石雕家
石黑彩	石黑彩
矽肺症	矽肺症
矽质岩	矽質岩
砂锅面	砂鍋麵
砌合法	砌合法
砍出去	砍出去
砍出来	砍出來
研修员	研修員
研修班	研修班
研判出	研判出
研制出	研製出
研发出	研發出
研发部	研發部
研拟出	研擬出
研究出	研究出
砭灸术	砭灸術
破了脸	破了臉
破发点	破發點
破坏欲	破壞慾
破布子	破布子
破折号	破折號
破盘价	破盤價
破纪录	破紀錄
破记录	破記錄
砻谷机	礱穀機
硅质岩	硅質岩
硫磺谷	硫磺谷
硬化症	硬化症
硬纸板	硬紙板
硬里子	硬裏子
硬页岩	硬頁岩
确切性	確切性
确定会	確定會
确定性	確定性
确定是	確定是
确定有	確定有
确定能	確定能
确实会	確實會
确实在	確實在
确实性	確實性
确实是	確實是
确实有	確實有
确实能	確實能
确山县	確山縣
确系著	確繫著
确认为	確認爲
确认是	確認是
碌曲县	碌曲縣
碍面子	礙面子
碎修儿	碎修兒
碎屑岩	碎屑岩
碎布条	碎布條
碗白干	碗白乾
碧云寺	碧雲寺
碧眼胡	碧眼胡
碰碰胡	碰碰胡
碱性岩	鹼性巖
碳纤维	碳纖維
碳酸岩	碳酸岩
碾米厂	碾米廠
磁北极	磁北極
磁南极	磁南極
磕个头	磕個頭
磕头虫	磕頭蟲
磨变岩	磨變岩
磨合期	磨合期
磨合罗	磨合羅
磨皮术	磨皮術
磨粉厂	磨粉廠
磨耗症	磨耗症
磨脊梁	磨脊梁
磨针溪	磨針溪
示范区	示範區
示范厂	示範廠
示范园	示範園
示范场	示範場
示范岗	示範崗
示范带	示範帶
示范店	示範店
示范性	示範性
示范户	示範戶
示范村	示範村
示范校	示範校
示范法	示範法
示范点	示範點
示范片	示範片
示范班	示範班
示范田	示範田
示范街	示範街
示范课	示範課
示范赛	示範賽
社会党	社會黨
社会系	社會系
社团课	社團課
社工系	社工系
社教系	社教系
社民党	社民黨
祈仙台	祈仙台
祈祷团	祈禱團
祖冲之	祖沖之
祛痰药	祛痰藥
祝年丰	祝年豐
祝英台	祝英臺
神圣周	神聖週
神曲茶	神麴茶
神经干	神經幹
神经症	神經症
神经系	神經系
神雕像	神雕像
祥丰街	祥豐街
祥云县	祥雲縣
票据法	票據法
票选出	票選出
票面值	票面值
祭吊文	祭弔文
祸种头	禍種頭
禁制令	禁制令
禁制品	禁製品
禁烟令	禁煙令
禁烟节	禁煙節
禁药案	禁藥案
禄丰县	祿豐縣
福克斯	福克斯
福克纳	福克納
福兰克	福蘭克
福布斯	福布斯
福瑞克	福瑞克
福维克	福維克
禹余粮	禹餘糧
禹王台	禹王台
离不了	離不了
离合器	離合器
离合板	離合板
离合诗	離合詩
离娘饭	離娘飯
离岸价	離岸價
禽滑厘	禽滑釐
私下里	私下裏
私有制	私有制
秃发症	禿髮症
秃秃里	禿禿裏
秉台衡	秉臺衡
秋不干	秋不乾
秋假里	秋假裏
秋刀鱼	秋刀魚
秋分点	秋分點
秋叶原	秋葉原
秋声赋	秋聲賦
秋天里	秋天裏
秋季档	秋季檔
秋季班	秋季班
秋季赛	秋季賽
秋庄稼	秋莊稼
秋日里	秋日裏
秋海棠	秋海棠
秋牡丹	秋牡丹
秋田县	秋田縣
秋篠宫	秋篠宮
秋老虎	秋老虎
秋葵荚	秋葵莢
秋风辞	秋風辭
种公畜	種公畜
种出来	種出來
种姓制	種姓制
种子园	種子園
种子地	種子地
种子岛	種子島
种子田	種子田
种子队	種子隊
种师中	种師中
种师道	种師道
种庄稼	種莊稼
种植业	種植業
种植区	種植區
种植园	種植園
种植户	種植戶
种概念	種概念
种源论	種源論
种牛痘	種牛痘
种花草	種花草
种过去	種過去
种过来	種過來
科举制	科舉制
科克林	科克林
科学面	科學麵
科布多	科布多
科托努	科托努
科斗书	科斗書
科斗文	科斗文
科目表	科目表
秒表明	秒表明
秒表示	秒表示
秘书党	秘書黨
秘雕鱼	秘雕魚
租借人	租借人
租借地	租借地
租借给	租借給
租出去	租出去
秦吉了	秦吉了
秦少游	秦少游
积分制	積分制
积层云	積層雲
积极型	積極型
积极性	積極性
积极论	積極論
积雨云	積雨雲
称谓录	稱謂錄
移出去	移出去
移出来	移出來
移山志	移山志
移祸于	移禍於
稀释后	稀釋後
程砚秋	程硯秋
稍干的	稍乾的
稍高于	稍高於
税负制	稅負制
稳当性	穩當性
稽征处	稽徵處
稽征所	稽徵所
穆克吉	穆克吉
穗花杉	穗花杉
空出来	空出來
空当儿	空當兒
空当子	空當子
空柜子	空櫃子
空荡荡	空蕩蕩
空调症	空調症
空集合	空集合
穿不出	穿不出
穿出去	穿出去
穿出来	穿出來
穿跟斗	穿跟斗
突出去	突出去
突出来	突出來
突发性	突發性
突显出	突顯出
突触后	突觸後
窃占罪	竊占罪
窗台上	窗台上
窗帘布	窗簾布
窝里反	窩裏反
窝里炮	窩裏炮
窝里翻	窩裏翻
窝阔台	窩闊臺
窦太后	竇太后
立面图	立面圖
站出去	站出去
站出来	站出來
站台票	站臺票
站柜台	站櫃臺
章台柳	章臺柳
章回体	章回體
童军团	童軍團
童蒙训	童蒙訓
端出去	端出去
端出来	端出來
端系统	端系統
竹叶青	竹葉青
竹叶鲢	竹葉鰱
竹板书	竹板書
竹板歌	竹板歌
竹笋干	竹筍乾
竹节虫	竹節蟲
笑出来	笑出來
笑面虎	笑面虎
笔杆子	筆桿子
笔管面	筆管麵
笛布斯	笛布斯
符号表	符號表
笨蛋挂	笨蛋掛
第一个	第一個
第一千	第一千
第一卷	第一卷
第一回	第一回
第七个	第七個
第七回	第七回
第三个	第三個
第三回	第三回
第九个	第九個
第九回	第九回
第二个	第二個
第二回	第二回
第五个	第五個
第五回	第五回
第八个	第八個
第八回	第八回
第六个	第六個
第六回	第六回
第几个	第幾個
第几冊	第幾冊
第几名	第幾名
第几回	第幾回
第几次	第幾次
第几章	第幾章
第几节	第幾節
第几课	第幾課
第十个	第十個
第十回	第十回
第四个	第四個
第四台	第四臺
第四回	第四回
等于在	等於在
等于是	等於是
等于有	等於有
等于零	等於零
等价物	等價物
等势面	等勢面
等同于	等同於
筋斗云	筋斗雲
筋面粉	筋麵粉
筑土墙	築土牆
筑底巷	築底巷
答不出	答不出
答出来	答出來
答剌苏	答剌蘇
答录机	答錄機
答案卷	答案卷
策划人	策劃人
策划者	策劃者
筛检出	篩檢出
筛选出	篩選出
筹码面	籌碼面
签上去	簽上去
签上来	簽上來
签下去	簽下去
签下来	簽下來
签书会	簽書會
签到处	簽到處
签到簿	簽到簿
签名会	簽名會
签名信	簽名信
签名球	簽名球
签名簿	簽名簿
签唱会	簽唱會
签字笔	簽字筆
签字者	簽字者
签字费	簽字費
签帐卡	簽帳卡
签押房	簽押房
签派室	簽派室
签约人	簽約人
签约国	簽約國
签约金	簽約金
签署人	簽署人
签署国	簽署國
签证费	簽證費
签语饼	簽語餅
签赌案	簽賭案
签赌站	簽賭站
简余晏	簡余晏
简历表	簡歷表
简字表	簡字表
简朝仑	簡朝崙
算不了	算不了
算不出	算不出
算出去	算出去
算出来	算出來
算历史	算歷史
算得了	算得了
算术和	算術和
算术家	算術家
算术式	算術式
算术课	算術課
管不了	管不了
管乐团	管樂團
管制区	管制區
管制员	管制員
管制品	管制品
管制局	管制局
管制法	管制法
管制点	管制點
管制站	管制站
管理系	管理系
管道升	管道昇
管闲事	管閒事
篮板王	籃板王
篮板球	籃板球
篮虹杯	籃虹盃
篷盖布	篷蓋佈
簳面杖	簳麵杖
米克森	米克森
米利托	米利托
米卤蛋	米滷蛋
米纳谷	米納谷
米苏里	米蘇里
米蛀虫	米蛀蟲
类似于	類似於
类同法	類同法
类球面	類球面
粉丝团	粉絲團
粉丝谷	粉絲谷
粉团儿	粉團兒
粉砂岩	粉砂岩
粉签子	粉籤子
粒变岩	粒變岩
粗制品	粗製品
粗布条	粗布條
粗毛布	粗毛布
粗管面	粗管麵
粗纤维	粗纖維
粗面岩	粗面岩
粘合剂	粘合劑
粘板岩	粘板岩
粲夸克	粲夸克
粽粑叶	粽粑葉
精兵制	精兵制
精准度	精準度
精制伏	精制伏
精制住	精制住
精制品	精製品
精制服	精制服
精彩度	精彩度
精炼厂	精煉廠
精炼炉	精煉爐
精确到	精確到
精确度	精確度
精确性	精確性
精致化	精緻化
精致度	精緻度
精通于	精通於
精采度	精采度
糊涂帐	糊塗帳
糊涂虫	糊塗蟲
糊涂蛋	糊塗蛋
糊涂账	糊塗賬
糖萝卜	糖蘿蔔
糙叶树	糙葉樹
糟糕了	糟糕了
糟透了	糟透了
系一片	係一片
系一番	係一番
系一种	係一種
系一线	繫一綫
系丝带	繫絲帶
系主任	系主任
系争物	係爭物
系列化	系列化
系列战	系列戰
系列片	系列片
系列赛	系列賽
系列里	系列裏
系发带	繫髮帶
系头巾	繫頭巾
系学会	系學會
系捻儿	繫捻兒
系统化	系統化
系统商	系統商
系统图	系統圖
系统性	系統性
系统级	繫統級
系统论	系統論
系统部	繫統部
系船桩	繫船樁
系裤子	繫褲子
系铃人	繫鈴人
系鞋带	繫鞋帶
素食面	素食麵
索夫克	索夫克
索杰纳	索傑納
索里亚	索里亚
索里士	索里士
索馬里	索馬里
索马里	索馬里
紧关里	緊關裏
紧绷绷	緊繃繃
紫云乡	紫雲鄉
紫云英	紫雲英
紫穗槐	紫穗槐
紫苏属	紫蘇属
紫苏梅	紫蘇梅
紫药水	紫藥水
經有云	經有云
红冬冬	紅冬冬
红叶村	紅葉村
红叶杯	紅葉盃
红叶树	紅葉樹
红头发	紅頭髮
红姑娘	紅姑娘
红孩症	紅孩症
红牙板	紅牙板
红眼症	紅眼症
红种人	紅種人
红胡子	紅鬍子
红色系	紅色系
红药水	紅藥水
红萝卜	紅蘿蔔
红醋栗	紅醋栗
红铃虫	紅鈴蟲
红霉素	紅黴素
纤毛虫	纖毛蟲
纤细画	纖細畫
纤维丛	纖維叢
纤维化	纖維化
纤维板	纖維板
纤维状	纖維狀
纤维素	纖維素
纤维胶	纖維膠
纤维质	纖維質
纤维镜	纖維鏡
约克夏	約克夏
约克曼	約克曼
约克郡	約克郡
约等于	約等於
约维克	約維克
约翰松	約翰松
级任制	級任制
纪元后	紀元後
纪历史	紀歷史
纪录器	紀錄器
纪录点	紀錄點
纪录片	紀錄片
纪录表	紀錄表
纪念周	紀念週
纪里谷	紀里谷
纯种牛	純種牛
纯种马	純種馬
纳修斯	納修斯
纳吉布	納吉布
纳杰夫	納傑夫
纳粹党	納粹黨
纵切面	縱切面
纵剖面	縱剖面
纵断面	縱斷面
纵谷区	縱谷區
纷如烟	紛如煙
纸卷子	紙卷子
纸叶子	紙葉子
纸尿布	紙尿布
纸扎店	紙紮店
纸板盒	紙板盒
纸板部	紙板部
纸浆厂	紙漿廠
纹光针	紋光針
纺纱厂	紡紗廠
纺织厂	紡織廠
纺织娘	紡織娘
纺锤虫	紡錘蟲
纽华克	紐華克
纽瓦克	紐瓦克
纽蒙特	紐蒙特
线板儿	綫板兒
线虫病	綫蟲病
练习曲	練習曲
练出来	練出來
练团室	練團室
练声曲	練聲曲
练武术	練武術
组合为	組合爲
组合式	組合式
组合成	組合成
组合法	組合法
组合菜	組合菜
组合论	組合論
细叶脉	細葉脈
细如发	細如髮
细蒙蒙	細濛濛
细袅袅	細裊裊
织布厂	織布廠
织布娘	織布娘
织布机	織布機
终归于	終歸於
终止症	終止症
终端台	終端台
经厂本	經廠本
经历过	經歷過
经合会	經合會
经折装	經摺裝
经有云	經有云
经板儿	經板兒
经济系	經濟系
经济面	經濟面
绑回去	綁回去
绑回来	綁回來
结发人	結髮人
结合为	結合爲
结合体	結合體
结合剂	結合劑
结合律	結合律
结合成	結合成
结合水	結合水
结合点	結合點
结合线	結合綫
结合能	結合能
结合韵	結合韻
结扎术	結紮術
结晶岩	結晶岩
结梁子	結梁子
结汇证	結匯證
结草虫	結草蟲
绘制图	繪製圖
绘图板	繪圖板
绘彩陶	繪彩陶
绘画板	繪畫板
络合物	絡合物
络腮胡	絡腮鬍
绝后患	絕後患
绝后计	絕後計
绝缘台	絕緣台
绞刑台	絞刑台
绞包针	絞包針
统一党	統一黨
统合体	統合體
统合力	統合力
统合性	統合性
统计出	統計出
统计表	統計表
绢布版	絹布版
绣花针	繡花針
绦虫纲	絛蟲綱
继续干	繼續幹
续发性	續發性
续通志	續通志
绮想曲	綺想曲
绰板婆	綽板婆
维修区	維修區
维修费	維修費
维克利	維克利
维克托	維克托
维斯杯	維斯杯
维杰辛	維傑辛
维苏威	維蘇威
绵里针	綿裏針
绷场面	繃場面
绸缎庄	綢緞莊
综合体	綜合體
综合型	綜合型
综合征	綜合徵
综合性	綜合性
综合法	綜合法
综合症	綜合症
综合类	綜合類
综合语	綜合語
综合课	綜合課
综合险	綜合險
综艺团	綜藝團
绽放出	綻放出
绿松石	綠松石
绿游网	綠遊網
缓冲体	緩衝體
缓冲剂	緩衝劑
缓冲区	緩衝區
缓冲器	緩衝器
缓冲国	緩衝國
缓冲地	緩衝地
缓冲式	緩衝式
缓冲期	緩衝期
缓冲液	緩衝液
缔造出	締造出
编写出	編寫出
编出来	編出來
编列出	編列出
编制成	編製成
编制法	編制法
编构出	編構出
编码表	編碼表
编算出	編算出
编织出	編織出
编选出	編選出
编造出	編造出
缙云县	縉雲縣
缝制成	縫製成
缝合处	縫合處
缝合带	縫合帶
缝合线	縫合綫
缝衣针	縫衣針
缝针迹	縫針蹟
缩回去	縮回去
缩回来	縮回來
缴出去	繳出去
缴出来	繳出來
缴白卷	繳白卷
缺乏症	缺乏症
缺氧症	缺氧症
网坛史	網壇史
网志上	網誌上
罗克耶	羅克耶
罗兴梁	羅興樑
罗圣杰	羅聖傑
罗宗胜	羅宗勝
罗布森	羅布森
罗布泊	羅布泊
罗布麻	羅布麻
罗彦杰	羅彥傑
罗志恩	羅志恩
罗志明	羅志明
罗志祥	羅志祥
罗志良	羅志良
罗时丰	羅時豐
罗杰斯	羅傑斯
罗汉松	羅漢松
罗盘针	羅盤針
罗胡斯	羅胡斯
罗致政	羅致政
罗迪克	羅迪克
罚出去	罰出去
罚出来	罰出來
罪恶感	罪惡感
置换术	置換術
置物柜	置物櫃
羊布婚	羊布婚
羊须疮	羊鬚瘡
美发业	美髮業
美发师	美髮師
美发店	美髮店
美国制	美國製
美国谷	美國谷
美娇娘	美嬌娘
美容术	美容術
美术史	美術史
美术品	美術品
美术商	美術商
美术字	美術字
美术家	美術家
美术灯	美術燈
美术班	美術班
美术界	美術界
美术系	美術系
美术节	美術節
美术课	美術課
美术馆	美術館
美沙冬	美沙冬
美洲杯	美洲盃
美白针	美白針
美耐板	美耐板
美里达	美里達
翁同和	翁同和
翁同龢	翁同龢
翁干晃	翁乾晃
翁郁容	翁郁容
翘出去	翹出去
翘出来	翹出來
翘翘板	翹翹板
翠云裘	翠雲裘
翡翠谷	翡翠谷
翰墨志	翰墨志
翻出去	翻出去
翻出来	翻出來
翻新后	翻新後
翻筋斗	翻筋斗
翻觔斗	翻觔斗
翻译出	翻譯出
翻跟斗	翻跟斗
翻面皮	翻面皮
老不修	老不修
老古板	老古板
老合儿	老合兒
老同学	老同學
老咬虫	老咬蟲
老大娘	老大娘
老奴才	老奴才
老姑娘	老姑娘
老娘儿	老娘兒
老婆娘	老婆娘
老干部	老幹部
老板人	老闆人
老板娘	老闆娘
老板家	老闆家
老烟枪	老煙槍
老烟鬼	老煙鬼
老爷钟	老爺鐘
老皇历	老皇曆
老糊涂	老糊塗
老腌儿	老醃兒
老腌瓜	老醃瓜
老臊胡	老臊胡
老郎庵	老郎庵
老面子	老面子
老面孔	老面孔
老面皮	老面皮
考信录	考信錄
考克斯	考克斯
考出来	考出來
考卷纸	考卷紙
考察团	考察團
考据学	考據學
考试卷	考試卷
而克制	而剋制
耍笔杆	耍筆桿
耍老千	耍老千
耐多药	耐多藥
耐药性	耐藥性
耕御路	耕御路
耳刮子	耳刮子
耶烈万	耶烈萬
耸了耸	聳了聳
耽干系	耽干繫
聊个天	聊個天
聋哑症	聾啞症
职员录	職員錄
职员表	職員表
联准会	聯準會
联发科	聯發科
联合会	聯合會
联合体	聯合體
联合党	聯合黨
联合制	聯合制
联合号	聯合號
联合国	聯合國
联合报	聯合報
联合机	聯合機
联合水	聯合水
联合社	聯合社
联合行	聯合行
联盟党	聯盟黨
联盟杯	聯盟杯
联系到	聯繫到
联系国	聯繫國
联系统	聯系統
联赛杯	聯賽杯
联邦制	聯邦制
联集团	聯集團
聘任制	聘任制
聘姑娘	聘姑娘
聚合体	聚合體
聚合果	聚合果
聚合物	聚合物
聚合脢	聚合脢
聚合酶	聚合酶
肇因于	肇因於
肉丝面	肉絲麵
肉吊窗	肉吊窗
肉汤面	肉湯麵
肉羹面	肉羹麵
肉里钱	肉裏錢
肌纤维	肌纖維
肌腺症	肌腺症
肘后方	肘後方
肚皮里	肚皮裏
肝吸虫	肝吸蟲
肠系膜	腸繫膜
肠胃药	腸胃藥
股份制	股份制
肥料厂	肥料廠
肥胖症	肥胖症
肥虫蚁	肥蟲蟻
肩并肩	肩並肩
肩须拍	肩須拍
肮脏鬼	骯髒鬼
肯出去	肯出去
肯出来	肯出來
肯回去	肯回去
肯回来	肯回來
肯干啊	肯幹啊
育乐台	育樂台
肺出血	肺出血
肺吸虫	肺吸蟲
肾脏炎	腎臟炎
肾脏病	腎臟病
肾脏癌	腎臟癌
肾脏科	腎臟科
肿大症	腫大症
胃出血	胃出血
胃药片	胃藥片
胆石症	膽石症
背了时	背了時
背出去	背出去
背出来	背出來
背包游	背包遊
背地里	背地裏
背梁骨	背梁骨
背胶布	背膠布
背风面	背風面
胎里坏	胎裏壞
胎里富	胎裏富
胎里毒	胎裏毒
胎里素	胎裏素
胚胎干	胚胎幹
胜不骄	勝不驕
胜利组	勝利組
胜利者	勝利者
胜利队	勝利隊
胜博殿	勝博殿
胜投数	勝投數
胜投王	勝投王
胜落袋	勝落袋
胞子虫	胞子蟲
胞芽杯	胞芽杯
胡三省	胡三省
胡为慎	胡爲慎
胡佩兰	胡佩蘭
胡元辉	胡元輝
胡兰成	胡蘭成
胡卢提	胡盧提
胡厮哄	胡廝哄
胡厮混	胡廝混
胡厮缠	胡廝纏
胡国强	胡國強
胡图族	胡圖族
胡如虹	胡如虹
胡姑姑	胡姑姑
胡姬花	胡姬花
胡婷婷	胡婷婷
胡子昂	胡子昂
胡子渣	鬍子渣
胡孟轩	胡孟軒
胡学东	胡學東
胡安国	胡安國
胡宝元	胡寶元
胡富雄	胡富雄
胡幼伟	胡幼偉
胡幼凤	胡幼鳳
胡幼幼	胡幼幼
胡建雄	胡建雄
胡弄局	胡弄局
胡彦斌	胡彥斌
胡德夫	胡德夫
胡心夫	胡心夫
胡志强	胡志強
胡志明	胡志明
胡志隆	胡志隆
胡忠信	胡忠信
胡惟庸	胡惟庸
胡慧中	胡慧中
胡才勇	胡才勇
胡扑掩	胡撲掩
胡扑搭	胡撲搭
胡托莫	胡托莫
胡扯淡	胡扯淡
胡技烜	胡技烜
胡拨四	胡撥四
胡支对	胡支對
胡旋舞	胡旋舞
胡晓菁	胡曉菁
胡朴安	胡樸安
胡林翼	胡林翼
胡枝子	胡枝子
胡桃木	胡桃木
胡桃科	胡桃科
胡桃钳	胡桃鉗
胡梦卜	胡夢卜
胡椒子	胡椒子
胡椒属	胡椒屬
胡椒盐	胡椒鹽
胡椒粉	胡椒粉
胡椒粒	胡椒粒
胡椒面	胡椒麵
胡椒饼	胡椒餅
胡母敬	胡母敬
胡汉民	胡漢民
胡浩德	胡浩德
胡海峰	胡海峰
胡涂虫	胡塗蟲
胡淑贞	胡淑貞
胡清晖	胡清暉
胡燕妮	胡燕妮
胡琴儿	胡琴兒
胡瓜鱼	胡瓜魚
胡碴子	鬍碴子
胡祖庆	胡祖慶
胡立宗	胡立宗
胡素秋	胡素秋
胡紫微	胡紫微
胡紫薇	胡紫薇
胡耀邦	胡耀邦
胡胜川	胡勝川
胡胜正	胡勝正
胡自强	胡自強
胡芦巴	胡蘆巴
胡萝卜	胡蘿蔔
胡蔓草	胡蔓草
胡蔓藤	胡蔓藤
胡蝶梦	胡蝶夢
胡适之	胡適之
胡遮刺	胡遮刺
胡鄂公	胡鄂公
胡金龙	胡金龍
胡铺搭	胡鋪搭
胡锦涛	胡錦濤
胡长豪	胡長豪
胡雕刺	胡雕刺
胡雪岩	胡雪巖
胡须渣	鬍鬚渣
胡颓子	胡頹子
胡麻油	胡麻油
胡麻籽	胡麻籽
胰脏炎	胰臟炎
胰脏癌	胰臟癌
胶合板	膠合板
胶布膏	膠布膏
胶彩画	膠彩畫
胼胚种	胼胚種
能克制	能剋制
能干休	能干休
能干嚎	能乾嚎
能干戈	能干戈
能干扰	能干擾
能干搁	能乾擱
能干政	能干政
能干杯	能乾杯
能干涉	能干涉
能干瞪	能乾瞪
能干笑	能乾笑
能干耗	能乾耗
能干脆	能乾脆
能干预	能干預
能自制	能自制
脆谷乐	脆穀樂
脉冲光	脈衝光
脉冲式	脈衝式
脉冲数	脈衝數
脉冲星	脈衝星
脊梁背	脊梁背
脊梁骨	脊梁骨
脊百合	脊百合
脏东西	髒東西
脏乱点	髒亂點
脏兮兮	髒兮兮
脏字儿	髒字兒
脑出血	腦出血
脑子里	腦子裏
脑震荡	腦震盪
脚划船	腳划船
脚后跟	腳後跟
脚底板	腳底板
脚踏板	腳踏板
脣彩盘	脣彩盤
脱不了	脫不了
脱发剂	脫髮劑
脱谷机	脫穀機
腊斯克	臘斯克
腌渍物	醃漬物
腌猪肉	醃豬肉
腌起来	醃起來
腌酱瓜	醃醬瓜
腌鱼肉	醃魚肉
腌黄瓜	醃黃瓜
腰一卷	腰一捲
腰杆子	腰桿子
腰板儿	腰板兒
腰里硬	腰裏硬
腰间系	腰間繫
腹泻药	腹瀉藥
腹语术	腹語術
腾冲县	騰沖縣
腾出来	騰出來
腾格里	騰格里
腿后腱	腿後腱
膊风板	膊風板
膏药旗	膏藥旗
膨土岩	膨土岩
膨松剂	膨鬆劑
臂一卷	臂一捲
臣服于	臣服於
自个儿	自個兒
自主游	自主遊
自交系	自交系
自修室	自修室
自修法	自修法
自修课	自修課
自制不	自制不
自制他	自制他
自制伏	自制伏
自制你	自制你
自制力	自制力
自制地	自制地
自制她	自制她
自制情	自制情
自制我	自制我
自制服	自制服
自动表	自動錶
自助游	自助遊
自发性	自發性
自度曲	自度曲
自愿书	自願書
自愿性	自願性
自愿者	自願者
自民党	自民黨
自治制	自治制
自点曲	自點曲
自然卷	自然捲
自然历	自然歷
自由党	自由黨
自由面	自由面
自适应	自適應
自选曲	自選曲
自闭症	自閉症
自鸣钟	自鳴鐘
臭熏熏	臭燻燻
致冷劑	致冷劑
致力于	致力於
致命伤	致命傷
致命处	致命處
致命性	致命性
致死性	致死性
致死案	致死案
致死率	致死率
致死量	致死量
致病性	致病性
致病菌	致病菌
致癌物	致癌物
致胜率	致勝率
致胜球	致勝球
舆地志	輿地志
舌一卷	舌一捲
舌叶音	舌葉音
舌面音	舌面音
舍下他	捨下他
舍下你	捨下你
舍下她	捨下她
舍下我	捨下我
舍不得	捨不得
舍利佛	舍利佛
舍利塔	舍利塔
舍利子	舍利子
舍利弗	舍利弗
舍弗勒	舍弗勒
舒适度	舒適度
舒适性	舒適性
舒适感	舒適感
舒适音	舒適音
舒马克	舒馬克
舔干淨	舔乾淨
舞台剧	舞臺劇
舞台区	舞台區
舞台戏	舞臺戲
舞台秀	舞臺秀
舞蹈团	舞蹈團
舞蹈症	舞蹈症
舞蹈系	舞蹈系
舟曲县	舟曲縣
航发会	航發會
航太系	航太系
航海历	航海曆
航班表	航班表
航空术	航空術
船只得	船只得
船只有	船只有
船只能	船只能
船员表	船員表
船期表	船期表
艇甲板	艇甲板
色彩学	色彩學
色盲症	色盲症
艺文志	藝文志
艺术化	藝術化
艺术区	藝術區
艺术厅	藝術廳
艺术史	藝術史
艺术品	藝術品
艺术团	藝術團
艺术奖	藝術獎
艺术字	藝術字
艺术季	藝術季
艺术家	藝術家
艺术展	藝術展
艺术性	藝術性
艺术村	藝術村
艺术片	藝術片
艺术界	藝術界
艺术类	藝術類
艺术系	藝術系
艺术美	藝術美
艺术者	藝術者
艺术节	藝術節
艺术街	藝術街
艺术院	藝術院
艺术馆	藝術館
艺穗节	藝穗節
艾万斯	艾萬斯
艾克尔	艾克爾
艾克斯	艾克斯
艾克曼	艾克曼
艾克森	艾克森
艾力克	艾力克
艾布兰	艾布蘭
艾弥尔	艾彌爾
艾瑞克	艾瑞克
艾瑞里	艾瑞里
艾米里	艾米里
艾达克	艾達克
艾里斯	艾里斯
艾里森	艾里森
节录自	節錄自
节目表	節目表
芍药花	芍藥花
芒果干	芒果乾
芦花荡	蘆花蕩
芫荽叶	芫荽葉
芭托莉	芭托莉
芭蕉布	芭蕉布
芯片厂	芯片廠
花儿针	花兒針
花六出	花六出
花冈岩	花岡岩
花发老	花髮老
花叶病	花葉病
花园里	花園裏
花坛乡	花壇鄉
花岗岩	花崗岩
花布包	花布包
花旗参	花旗參
花栗鼠	花栗鼠
花椒面	花椒麵
花烟馆	花煙館
花盆里	花盆裏
花粉症	花粉症
花胡同	花衚衕
花胡瓜	花胡瓜
花药瓣	花葯瓣
花雕酒	花雕酒
花面狸	花面狸
芳名录	芳名錄
苏东坡	蘇東坡
苏丹人	蘇丹人
苏丽文	蘇麗文
苏乐明	蘇樂明
苏乐桃	蘇樂桃
苏仙区	甦仙區
苏伊士	蘇伊士
苏俊仁	蘇俊仁
苏俊宾	蘇俊賓
苏克雷	蘇克雷
苏公隄	蘇公隄
苏利南	蘇利南
苏利文	蘇利文
苏占区	蘇佔區
苏合香	蘇合香
苏启荣	蘇啓榮
苏哈托	蘇哈托
苏哲毅	蘇哲毅
苏嘉全	蘇嘉全
苏圣斌	蘇聖斌
苏妮儿	蘇妮兒
苏妮妮	蘇妮妮
苏妮萨	蘇妮薩
苏子油	蘇子油
苏家屯	甦家屯
苏家明	蘇家明
苏富比	蘇富比
苏小妹	蘇小妹
苏尔坦	蘇爾坦
苏尔奈	蘇爾奈
苏州人	蘇州人
苏州城	蘇州城
苏州市	蘇州市
苏州片	蘇州片
苏州码	蘇州碼
苏州话	蘇州話
苏巴猜	蘇巴猜
苏帕瑞	蘇帕瑞
苏建和	蘇建和
苏建忠	蘇建忠
苏建荣	蘇建榮
苏彝士	蘇彝士
苏德曼	蘇德曼
苏志明	蘇志明
苏志燮	蘇志燮
苏打水	蘇打水
苏打粉	蘇打粉
苏打绿	蘇打綠
苏扬托	蘇揚托
苏报案	蘇報案
苏拉威	蘇拉威
苏拉朋	蘇拉朋
苏拉特	蘇拉特
苏拉育	蘇拉育
苏拾平	蘇拾平
苏振平	蘇振平
苏文生	蘇文生
苏易简	蘇易簡
苏曼殊	蘇曼殊
苏有朋	蘇有朋
苏枋木	蘇枋木
苏格兰	蘇格蘭
苏梅岛	蘇梅島
苏步青	蘇步青
苏民峰	蘇民峰
苏氨酸	蘇氨酸
苏永康	蘇永康
苏永耀	蘇永耀
苏永钦	蘇永欽
苏治芬	蘇治芬
苏泽光	蘇澤光
苏澳港	蘇澳港
苏澳镇	蘇澳鎮
苏炎坤	蘇炎坤
苏炳宪	蘇炳憲
苏焕智	蘇煥智
苏玲瑶	蘇玲瑤
苏珊娜	蘇珊娜
苏盈贵	蘇盈貴
苏禄岛	蘇祿島
苏福男	蘇福男
苏立吉	蘇立吉
苏维埃	蘇維埃
苏维成	蘇維成
苏罗河	蘇羅河
苏美人	蘇美人
苏美尔	蘇美爾
苏翊杰	蘇翊傑
苏联人	蘇聯人
苏胺酸	蘇胺酸
苏舜钦	蘇舜欽
苏花高	蘇花高
苏莱曼	蘇萊曼
苏菲亚	蘇菲亞
苏菲雅	蘇菲雅
苏西洛	蘇西洛
苏谢配	蘇謝配
苏贞昌	蘇貞昌
苏超凡	蘇超凡
苏轩弘	蘇軒弘
苏达拉	蘇達拉
苏醒剂	蘇醒劑
苏里南	蘇里南
苏金达	蘇金達
苏镇霖	蘇鎮霖
苏雷曼	蘇雷曼
苏黎世	蘇黎世
苏黎士	蘇黎士
苑里镇	苑裏鎮
苗栗人	苗栗人
苗栗县	苗栗縣
苗栗市	苗栗市
若干个	若干個
若干人	若干人
若干年	若干年
苦瓜干	苦瓜乾
英文系	英文系
英语系	英語系
苹果园	蘋果園
苹果干	蘋果乾
苹果树	蘋果樹
苹果核	蘋果核
苹果汁	蘋果汁
苹果派	蘋果派
苹果皮	蘋果皮
苹果绿	蘋果綠
苹果肉	蘋果肉
苹果脸	蘋果臉
苹果螺	蘋果螺
苹果迷	蘋果迷
苹果酒	苹果酒
苹果酱	蘋果醬
苹果酸	蘋果酸
茂都淀	茂都澱
范不著	範不著
范仲淹	范仲淹
范佩西	范佩西
范光羣	范光羣
范公偁	範公偁
范公堤	范公堤
范冰冰	范冰冰
范可钦	范可欽
范哈能	范哈能
范嘉骅	范嘉驊
范围内	範圍內
范围是	範圍是
范国铨	范國銓
范士丹	范士丹
范家谦	范家謙
范小姐	范小姐
范履霜	范履霜
范德萨	范德薩
范志毅	范志毅
范戈德	范戈德
范成大	范成大
范文同	范文同
范文澜	范文瀾
范文瀾	范文瀾
范文照	范文照
范文程	范文程
范文网	範文網
范文芳	范文芳
范文藤	范文藤
范文虎	范文虎
范斯坦	範斯坦
范晓萱	范曉萱
范植伟	范植偉
范植谷	范植谷
范欣妤	范欣妤
范正祥	范正祥
范洪森	范洪森
范湘暄	范湘暄
范特尔	范特爾
范玮琪	范瑋琪
范琪斐	范琪斐
范甘迪	范甘迪
范畴内	範疇內
范畴论	範疇論
范登堡	范登堡
范皓阗	范皓闐
范筱梵	范筱梵
范纲武	范綱武
范织钦	范織欽
范绮馨	范綺馨
范逸臣	范逸臣
范陈柏	范陳柏
范靖瑶	范靖瑤
茄克衫	茄克衫
茅以升	茅以升
茅台酒	茅臺酒
茉莉克	茉莉克
茧纤维	繭纖維
茱丽叶	茱麗葉
茶叶末	茶葉末
茶叶碱	茶葉鹼
茶叶罐	茶葉罐
茶叶蛋	茶葉蛋
茶已干	茶已乾
茶干尽	茶乾盡
茶干掉	荼乾掉
茶毛虫	茶毛蟲
茶里王	茶裏王
茶面子	茶麵子
茹志鹃	茹誌鵑
草丛里	草叢裏
草叶集	草葉集
草团瓢	草團瓢
草头药	草頭藥
草字汇	草字彙
草履虫	草履蟲
草枝摆	草枝擺
草药方	草藥方
荒年谷	荒年穀
荞麦面	蕎麥麵
荡悠悠	蕩悠悠
荡漾出	蕩漾出
荡秋千	盪鞦韆
药事法	藥事法
药价差	藥價差
药剂士	藥劑士
药剂学	藥劑學
药剂师	藥劑師
药剂量	藥劑量
药吊子	藥吊子
药品店	藥品店
药妆品	藥妝品
药妆店	藥妝店
药学系	藥學系
药师佛	藥師佛
药师经	藥師經
药师节	藥師節
药引子	藥引子
药性气	藥性氣
药捻子	藥捻子
药政处	藥政處
药方儿	藥方兒
药检局	藥檢局
药水儿	藥水兒
药水味	藥水味
药物学	藥物學
药理学	藥理學
药瓶子	藥瓶子
药监局	藥監局
药罐子	藥罐子
药而愈	藥而癒
药草茶	藥草茶
药衣子	藥衣子
药面儿	藥麵兒
荷叶肉	荷葉肉
荷尔蒙	荷爾蒙
荷花淀	荷花澱
荷里活	荷里活
荷雷克	荷雷克
莒光周	莒光週
莫吉托	莫吉托
莫布里	莫布里
莫干山	莫干山
莫扎特	莫扎特
莫莉克	莫莉克
莫过于	莫過於
莫里叶	莫里葉
莫里哀	莫里哀
莫里希	莫里希
莫里斯	莫里斯
莫里森	莫里森
莫里纳	莫里納
莫霍面	莫霍面
莫须有	莫須有
莱德杯	萊德杯
莱索托	萊索托
莱里达	莱里达
获利率	獲利率
获利王	獲利王
获嘉县	獲嘉縣
获奖人	獲獎人
获奖率	獲獎率
获奖者	穫獎者
获得四	獲得四
获得性	獲得性
获得者	獲得者
获益者	獲益者
获胜者	獲勝者
获选为	獲選爲
获鹿县	獲鹿縣
获鹿镇	獲鹿鎮
菁英杯	菁英盃
菌丝体	菌絲體
菌胶团	菌膠團
菌血症	菌血症
菜瓜布	菜瓜布
菜青虫	菜青蟲
菠棱菜	菠棱菜
菠萝干	菠蘿乾
菲舍尔	菲捨爾
萎缩症	萎縮症
萝卜头	蘿蔔頭
萝卜干	蘿蔔乾
萝卜精	蘿蔔精
萝卜糕	蘿蔔糕
萝卜腿	蘿蔔腿
萤光板	螢光板
萤火虫	螢火蟲
营养系	營養系
营建厂	營建廠
营造出	營造出
营造厂	營造廠
萧万长	蕭萬長
萧太后	蕭太后
萧扎某	蕭扎某
萧玮志	蕭瑋志
萨克号	薩克號
萨克斯	薩克斯
萨克森	薩克森
萨克管	薩克管
萨克逊	薩克遜
萨巴托	薩巴托
萨布里	薩布里
萨瓦里	薩瓦里
萨迪克	薩迪克
萨里郡	薩裏郡
落了灶	落了竈
落叶剂	落葉劑
落叶层	落葉層
落叶松	落葉松
落叶林	落葉林
落叶树	落葉樹
落腮胡	落腮鬍
著手于	著手於
著眼于	著眼於
著迷于	著迷於
著重于	著重於
葛里芬	葛里芬
葡萄干	葡萄乾
董里府	董里府
葫芦谷	葫蘆谷
葱姜蒜	葱薑蒜
葱胡子	蔥鬍子
蒋国梁	蔣國樑
蒋百里	蔣百里
蒙代尔	蒙代爾
蒙兀儿	蒙兀兒
蒙古人	蒙古人
蒙古儿	蒙古兒
蒙古包	蒙古包
蒙古国	蒙古國
蒙古文	蒙古文
蒙古斑	蒙古斑
蒙古族	蒙古族
蒙古症	蒙古症
蒙古话	蒙古話
蒙古语	蒙古語
蒙嘉慧	蒙嘉慧
蒙城县	蒙城縣
蒙塔丝	蒙塔絲
蒙塔斯	蒙塔斯
蒙塔达	蒙塔達
蒙大拿	蒙大拿
蒙太奇	蒙太奇
蒙头转	矇頭轉
蒙山县	蒙山縣
蒙巴萨	蒙巴薩
蒙巴顿	矇巴頓
蒙故业	蒙故業
蒙松雨	矇松雨
蒙汗药	蒙汗藥
蒙特利	蒙特利
蒙特娄	蒙特婁
蒙特雷	蒙特雷
蒙特鲁	蒙特魯
蒙自县	蒙自縣
蒙蒙亮	矇矇亮
蒙蒙谷	濛濛谷
蒙蒙黑	矇矇黑
蒙贝列	蒙貝列
蒙起来	蒙起來
蒙阴县	蒙陰縣
蒙难记	蒙難記
蒙雾露	蒙霧露
蒙面人	蒙面人
蒙面侠	蒙面俠
蒙面客	蒙面客
蒲松龄	蒲松齡
蒸便当	蒸便當
蒸发器	蒸發器
蒸发掉	蒸發掉
蒸发散	蒸發散
蒸发热	蒸發熱
蒸发皿	蒸發皿
蒸发计	蒸發計
蒸发量	蒸發量
蓄长发	蓄長髮
蓝托斯	藍托斯
蓝胡子	藍鬍子
蓝色系	藍色系
蓝采和	藍采和
蔡丰州	蔡豐州
蔡仰秋	蔡仰秋
蔡克嵩	蔡克嵩
蔡同荣	蔡同榮
蔡志忠	蔡志忠
蔡志杰	蔡志傑
蔡文丰	蔡文豐
蔡松坡	蔡松坡
蔡清游	蔡清遊
蔡秋炎	蔡秋炎
蔡细历	蔡細歷
蔽形术	蔽形術
蕃薯叶	蕃薯葉
蕈状云	蕈狀雲
薄幸人	薄倖人
薄松松	薄鬆鬆
薄荷叶	薄荷葉
薙发令	薙髮令
薛松干	薛松乾
薪资表	薪資表
藏匿于	藏匿於
藏历史	藏歷史
藏针缝	藏針縫
蘑菇云	蘑菇雲
虎克党	虎克黨
虎甲虫	虎甲蟲
虎皮松	虎皮松
虫吃牙	蟲吃牙
虫媒花	蟲媒花
虫子牙	蟲子牙
虫白蜡	蟲白蠟
虹彩炎	虹彩炎
虹彩膜	虹彩膜
蚀船虫	蝕船蟲
蚕豆症	蠶豆症
蛇皮松	蛇皮松
蛇纹岩	蛇紋岩
蛇绿岩	蛇綠岩
蛋彩画	蛋彩畫
蛓毛虫	蛓毛蟲
蛔虫病	蛔蟲病
蛔虫症	蛔蟲症
蛔虫药	蛔蟲藥
蛮干淨	蠻乾淨
蛮干爽	蠻乾爽
蛲虫病	蟯蟲病
蜡人馆	蠟人館
蜡像馆	蠟像館
蜡光纸	蠟光紙
蜡原型	蠟原型
蜡坨儿	蠟坨兒
蜡坨子	蠟坨子
蜡头儿	蠟頭兒
蜡枪头	蠟槍頭
蜡烛台	蠟燭台
蜡烛油	蠟燭油
蜡烛相	蠟燭相
蜡烛线	蠟燭綫
蜡笔画	蠟筆畫
蜡芯儿	蠟芯兒
蜡黄色	蠟黃色
蝴蝶谷	蝴蝶谷
融合为	融合爲
融合式	融合式
融合线	融合綫
螺旋面	螺旋麵
蟠龙松	蟠龍松
蟭蟟虫	蟭蟟蟲
蠕虫形	蠕蟲形
蠹书虫	蠹書蟲
血制品	血製品
血吸虫	血吸蟲
血小板	血小板
血已干	血已乾
血才干	血才乾
血栓症	血栓症
血线虫	血綫蟲
血胡同	血衚衕
行业别	行業別
行事历	行事曆
行修寺	行修寺
行凶前	行兇前
行凶后	行兇後
行凶後	行兇後
行凶者	行兇者
行动党	行動黨
行情价	行情價
行情表	行情表
行政系	行政系
行李卷	行李捲
行百里	行百里
行程表	行程表
衍生出	衍生出
街面儿	街面兒
衡量制	衡量制
衣斗木	衣斗木
衣物柜	衣物櫃
补回来	補回來
补票价	補票價
补血药	補血藥
补血针	補血針
表兄弟	表兄弟
表决权	表決權
表出来	表出來
表列出	表列出
表同情	表同情
表土层	表土層
表壳儿	錶殼兒
表姊妹	表姊妹
表姊家	表姊家
表姐妹	表姐妹
表姨父	表姨父
表层水	表層水
表态句	表態句
表沃夫	表沃夫
表演会	表演會
表演区	表演區
表演厅	表演廳
表演性	表演性
表演欲	表演慾
表演秀	表演秀
表演给	表演給
表演赛	表演賽
表现为	表現爲
表现出	表現出
表现力	表現力
表现型	表現型
表现形	表現形
表皮层	表皮層
表示出	表示出
表示层	表示層
表舅母	表舅母
表蒙子	錶蒙子
表达出	表達出
表达力	表達力
表达式	表達式
表错情	表錯情
表露出	表露出
表面上	表面上
表面化	表面化
表面性	表面性
表面流	表面流
表面的	表面的
表面积	表面積
衬托出	襯托出
衬托底	襯托底
衬托物	襯托物
衰变链	衰變鏈
袁于令	袁于令
袁友范	袁友范
袁承志	袁承志
袒露出	袒露出
袖一卷	袖一捲
被服厂	被服廠
被窝里	被窩裏
裁样板	裁樣板
裂解厂	裂解廠
裂谷热	裂谷熱
装出去	裝出去
装出来	裝出來
装岩机	裝岩機
装糊涂	裝糊塗
装订厂	裝訂廠
装配厂	裝配廠
装门面	裝門面
裴松之	裴松之
裴里诺	裴里諾
裸露出	裸露出
裹尸布	裹屍布
裹脚布	裹腳布
褚人获	褚人獲
褶子了	褶子了
西丰县	西豐縣
西北台	西北颱
西北向	西北向
西北面	西北面
西南向	西南向
西南面	西南面
西历史	西歷史
西台人	西臺人
西周时	西周時
西周钟	西周鐘
西太后	西太后
西文系	西文系
西来庵	西來庵
西洋参	西洋參
西游补	西遊補
西游记	西遊記
西米谷	西米谷
西药房	西藥房
西蒙斯	西蒙斯
西蒙逊	西蒙遜
西西里	西西里
西谷米	西谷米
西里尔	西裏爾
要克制	要剋制
要占卜	要占卜
要干了	要乾了
要自制	要自制
要面子	要面子
覃天同	覃天同
覆盖面	覆蓋面
见世面	見世面
见个情	見個情
见了面	見了面
见到面	見到面
见见面	見見面
见面会	見面會
见面礼	見面禮
观众台	觀眾臺
观光台	觀光台
观光周	觀光週
观光团	觀光團
观后感	觀後感
观察团	觀察團
观星台	觀星台
观景台	觀景台
观望台	觀望台
观测台	觀測台
观礼台	觀禮臺
观象台	觀象臺
观音庵	觀音庵
规划为	規劃爲
规划出	規劃出
规划好	規劃好
规划局	規劃局
规划成	規劃成
规划案	規劃案
规画出	規畫出
规范化	規範化
规范司	規範司
规范名	規範名
规范字	規範字
规范学	規範學
规范性	規範性
规范的	規範的
视力表	視力表
视觉系	視覺系
觉察出	覺察出
角化症	角化症
角斗场	角鬥場
角斗士	角鬥士
角曲尺	角曲尺
角砾岩	角礫岩
角落发	角落發
角落里	角落裏
角页岩	角頁岩
觔斗云	觔斗雲
解出来	解出來
解当铺	解當鋪
解放后	解放後
解毒药	解毒藥
解理面	解理面
解痛药	解痛藥
解酸药	解酸藥
触发器	觸發器
触发式	觸發式
触技曲	觸技曲
触控板	觸控板
言行录	言行錄
詹千慧	詹千慧
詹宏志	詹宏志
詹志宏	詹志宏
詹志维	詹誌維
誊写板	謄寫板
誊出来	謄出來
誊录所	謄錄所
語有云	語有云
警世钟	警世鐘
警报钟	警報鐘
警示钟	警示鐘
譬似闲	譬似閒
譬如闲	譬如閒
计价器	計價器
计分板	計分板
计划书	計劃書
计划图	計劃圖
计划好	計劃好
计划性	計劃性
计划案	計劃案
计划署	計劃署
计划者	計劃者
计时表	計時錶
计算出	計算出
计量制	計量制
订出来	訂出來
订制服	訂製服
订杂志	訂雜誌
认不出	認不出
认出来	認出來
认制修	認製修
认同卡	認同卡
认同度	認同度
认同感	認同感
认得出	認得出
讨出来	討出來
讨针线	討針綫
讨面皮	討面皮
让位于	讓位於
让出去	讓出去
让出来	讓出來
让胡路	讓胡路
训兽术	訓獸術
训练出	訓練出
议事录	議事錄
议会制	議會制
议和团	議和團
记不了	記不了
记事板	記事板
记分板	記分板
记录下	記錄下
记录为	記錄爲
记录仪	記錄儀
记录到	記錄到
记录员	記錄員
记录器	記錄器
记录本	記錄本
记录板	記錄板
记录片	記錄片
记录簿	記錄簿
记者团	記者團
讲出去	講出去
讲出来	講出來
讲情面	講情面
讲闲话	講閒話
讲面子	講面子
许人丰	許人丰
许凯克	許凱克
许历农	許歷農
许圣杰	許聖杰
许建发	許建發
许志华	許志華
许志彰	許志彰
许志煌	許志煌
许志雄	許志雄
许志鸿	許志鴻
许愿树	許願樹
许愿池	許願池
许愿牌	許願牌
许振发	許振發
许智杰	許智傑
许杰辉	許傑輝
许胜发	許勝發
许胜雄	許勝雄
许至胜	許至勝
许致强	許致強
许豪升	許豪升
许铭杰	許銘傑
论坛区	論壇區
论坛报	論壇報
设计出	設計出
设计系	設計系
设限于	設限於
访华团	訪華團
访察团	訪察團
访日团	訪日團
访问团	訪問團
访韩团	訪韓團
诀别书	訣別書
证出来	證出來
证据力	證據力
评估板	評估板
评出来	評出來
评判出	評判出
评审团	評審團
评选出	評選出
评鉴为	評鑑爲
识别力	識別力
识别区	識別區
识别号	識別號
识别字	識別字
识别码	識別碼
识别証	識別証
识别证	識別證
诉愿权	訴願權
诉愿状	訴願狀
诉诸于	訴諸於
诊断出	診斷出
词汇学	詞彙學
词语汇	詞語彙
试出来	試出來
试算表	試算表
试验台	試驗台
诙谐曲	詼諧曲
诠释出	詮釋出
诡辩术	詭辯術
诬蔑性	誣衊性
语有云	語有云
诱发型	誘發型
诱发式	誘發式
诱虫灯	誘蟲燈
说不了	說不了
说不准	說不準
说不出	說不出
说不尽	說不盡
说了算	說了算
说出去	說出去
说出口	說出口
说出来	說出來
说参请	說參請
说回来	說回來
说好了	說好了
说定了	說定了
说教术	說教術
说白了	說白了
说穿了	說穿了
说闲话	說閒話
诵经台	誦經臺
请出去	請出去
请出来	請出來
请参阅	請參閱
请回到	請回到
请回去	請回去
请回来	請回來
请愿书	請願書
请愿团	請願團
请愿权	請願權
请愿案	請願案
请说出	請說出
诺瓦克	諾瓦克
诺福克	諾福克
读出来	讀出來
读后感	讀後感
读心术	讀心術
读脣术	讀脣術
课田制	課田制
课程表	課程表
课表上	課表上
谁干净	誰乾淨
谁干的	誰幹的
调出去	調出去
调出来	調出來
调制出	調製出
调制法	調製法
调制波	調製波
调合漆	調合漆
调回去	調回去
调回来	調回來
调幅台	調幅台
调查团	調査團
调查表	調査表
调査出	調査出
调査团	調査團
调査表	調査表
调画出	調畫出
调色板	調色板
调药刀	調藥刀
调配出	調配出
调钟表	調鐘錶
调频台	調頻臺
谈不出	談不出
谈得出	談得出
谈论出	談論出
谋出路	謀出路
谎敲才	謊敲才
谢克尔	謝克爾
谢叶配	謝葉配
谢志伟	謝志偉
谢福松	謝福松
谢秋华	謝秋華
谢苏叶	謝蘇葉
谢苏配	謝蘇配
谢里夫	謝里夫
谨于心	謹於心
谭嗣同	譚嗣同
谱出来	譜出來
谷中谷	谷中谷
谷垣祯	谷垣禎
谷城县	谷城縣
谷月涵	谷月涵
谷树皮	谷樹皮
谷梁传	穀梁傳
谷氨酸	穀氨酸
谷神星	穀神星
豁上干	豁上幹
豁出去	豁出去
豁出来	豁出來
豁命干	豁命幹
豁死干	豁死幹
豆制品	豆製品
豆姑娘	豆姑娘
豆娘子	豆娘子
豆干展	豆乾展
豆腐干	豆腐乾
象征性	象徵性
象征着	象徵着
象牙雕	象牙雕
象鼻虫	象鼻蟲
豪华游	豪華遊
貂复额	貂覆額
贝克勒	貝克勒
贝克尔	貝克爾
贝克曼	貝克曼
贝克汉	貝克漢
贝克特	貝克特
贝叶书	貝葉書
贝叶树	貝葉樹
贝叶棕	貝葉棕
贝叶经	貝葉經
贝尔杰	貝爾傑
贝理克	貝理克
贝西克	貝西克
贝里拉	貝里拉
贝里斯	貝里斯
贞丰县	貞豐縣
负债表	負債表
负后像	負後像
负回馈	負回饋
负手板	負手板
负面性	負面性
贡献出	貢獻出
财划法	財劃法
财布施	財佈施
财金系	財金系
责任制	責任制
败血症	敗血症
货柜场	貨櫃場
货柜屋	貨櫃屋
货柜船	貨櫃船
货柜车	貨櫃車
货柜轮	貨櫃輪
货物柜	貨物櫃
贪睡虫	貪睡蟲
贫困化	貧困化
贫困率	貧困率
贫血症	貧血症
购买欲	購買慾
购并案	購併案
购物台	購物台
购物欲	購物慾
贯云石	貫雲石
贴出去	貼出去
贴出来	貼出來
费卢杰	費盧傑
费周章	費周章
费杰罗	費傑羅
费洛蒙	費洛蒙
费舍尔	費舍爾
费达克	費達克
费里尼	費里尼
贺尔蒙	賀爾蒙
贾克逊	賈克遜
贾斯克	賈斯克
贾氏症	賈氏症
贾第虫	賈第蟲
贾里尔	賈里爾
贾鸿秋	賈鴻秋
资料录	資料錄
资料表	資料表
资管系	資管系
资讯系	資訊系
资金面	資金面
赋格曲	賦格曲
赌钱厂	賭錢廠
赎回权	贖回權
赏面子	賞面子
赖幸媛	賴幸媛
赖索托	賴索托
赖蒙特	賴蒙特
赚不了	賺不了
赚个饱	賺個飽
赚回来	賺回來
赛德克	賽德克
赛程表	賽程表
赞一句	讚一句
赞一声	讚一聲
赞一赞	讚一讚
赞两句	讚兩句
赞个不	讚個不
赞助人	贊助人
赞助商	贊助商
赞助者	贊助者
赞口不	讚口不
赞叹声	讚歎聲
赞成票	贊成票
赞成者	贊成者
赞比亚	贊比亞
赞皇县	贊皇縣
赞美歌	讚美歌
赞美诗	讚美詩
赞自己	讚自己
赞西佩	赞西佩
赞誉为	讚譽爲
赡表子	贍表子
赢不了	贏不了
赢回去	贏回去
赢回来	贏回來
赢定了	贏定了
赤松子	赤松子
赤道面	赤道面
赤霉素	赤黴素
赫克比	赫克比
赫里斯	赫里斯
走上台	走上臺
走下台	走下臺
走不了	走不了
走亲戚	走親戚
走出去	走出去
走出来	走出來
走后门	走後門
走回去	走回去
走回头	走回頭
走回来	走回來
走回路	走迴路
走娘家	走孃家
走来回	走來回
走板眼	走板眼
赵丰邦	趙豐邦
赵五娘	趙五娘
赵坤郁	趙坤郁
赵志坚	趙志堅
赵无极	趙無極
赵治勋	趙治勳
赵玄坛	趙玄壇
赶下台	趕下臺
赶不出	趕不出
赶出去	趕出去
赶出来	趕出來
赶回到	趕回到
赶回去	趕回去
赶回来	趕回來
赶得出	趕得出
赶面棍	趕麵棍
起不了	起不了
起发性	起發性
起因于	起因於
起居注	起居注
起扑杆	起撲桿
起模范	起模範
起源于	起源於
起跳价	起跳價
起跳板	起跳板
超低价	超低價
超党派	超黨派
超平面	超平面
超然台	超然臺
超级杯	超級盃
超范围	超範圍
超链接	超鏈接
趋近于	趨近於
足协杯	足協盃
足总杯	足總杯
跃升为	躍升爲
跌停板	跌停板
跌打药	跌打藥
跑不了	跑不了
跑出去	跑出去
跑出来	跑出來
跑台子	跑檯子
跑回去	跑回去
跑回来	跑回來
跛行症	跛行症
跟出去	跟出去
跟出来	跟出來
跟头虫	跟頭蟲
跟屁虫	跟屁蟲
跨出去	跨出去
跨出来	跨出來
跨平台	跨平臺
路克索	路克索
路怒症	路怒症
路码表	路碼表
跳伞台	跳傘台
跳出去	跳出去
跳出来	跳出來
跳只舞	跳隻舞
跳回去	跳回去
跳回来	跳回來
跳水台	跳水台
跳脱出	跳脫出
跷跷板	蹺蹺板
跻身于	躋身於
踏出去	踏出去
踏出来	踏出來
踏板车	踏板車
踏脚板	踏腳板
踏足板	踏足板
踢不出	踢不出
踢出去	踢出去
踢出来	踢出來
踢回去	踢回去
踢回来	踢回來
踩坏了	踩壞了
蹦出来	蹦出來
蹭棱子	蹭棱子
躁狂症	躁狂症
躁郁症	躁鬱症
身历声	身歷聲
身后事	身後事
身板儿	身板兒
躯干骨	軀幹骨
躲不了	躲不了
躲清闲	躲清閒
躺出去	躺出去
躺出来	躺出來
车仔面	車仔麵
车厂子	車廠子
车叶草	車葉草
车后箱	車後箱
车库里	車庫裏
车百合	車百合
车站里	車站裏
轧钢厂	軋鋼廠
轨道面	軌道面
转个弯	轉個彎
转关系	轉關係
转出去	轉出去
转出来	轉出來
转向器	轉向器
转向往	轉向往
转向架	轉向架
转向灯	轉向燈
转回去	轉回去
转回来	轉回來
转折亲	轉折親
转折点	轉折點
转播台	轉播台
转注字	轉註字
转车台	轉車台
转速表	轉速錶
轮休制	輪休制
轮值表	輪值表
轮台县	輪臺縣
轮唱曲	輪唱曲
轮旋曲	輪旋曲
轮流制	輪流制
轮流干	輪流幹
轮班制	輪班制
轮生叶	輪生葉
轮种法	輪種法
软面筋	軟麵筋
轰出去	轟出去
轰出来	轟出來
轴根系	軸根系
轻松地	輕鬆地
轻蔑性	輕蔑性
轻袅袅	輕嫋嫋
载出去	載出去
载出来	載出來
载满了	載滿了
辅导团	輔導團
辈子干	輩子幹
辉格党	輝格黨
辉绿岩	輝綠岩
辉长岩	輝長岩
辍耕录	輟耕錄
输出业	輸出業
输出入	輸出入
输出到	輸出到
输出区	輸出區
输出去	輸出去
输出品	輸出品
输出国	輸出國
输出来	輸出來
输出管	輸出管
输出表	輸出表
输出量	輸出量
辗米厂	輾米廠
辛辣面	辛辣麵
辛里希	辛里希
辜濂松	辜濂松
辟支佛	辟支佛
辟雍砚	辟雍硯
辣哈布	辣哈布
辣椒面	辣椒麵
辣胡椒	辣胡椒
辨别力	辨別力
辨奸论	辨姦論
辨认出	辨認出
辨识出	辨識出
辩才天	辯才天
辩论术	辯論術
辫穗头	辮穗頭
辽三彩	遼三彩
辽太后	遼太后
达克龙	達克龍
达欣杯	達欣盃
达瓦党	達瓦黨
迁出去	遷出去
迁出来	遷出來
迁回去	遷回去
迁回来	遷回來
迁就于	遷就於
迁怒于	遷怒於
过不了	過不了
过世面	過世面
过云雨	過雲雨
过傢伙	過傢伙
过动症	過動症
过去了	過去了
过干瘾	過乾癮
过庭录	過庭錄
过得了	過得了
过折了	過折了
过敏症	過敏症
过水面	過水麵
迈克尔	邁克爾
迈科里	邁科裏
迎宾曲	迎賓曲
迎斗灯	迎斗燈
迎春曲	迎春曲
运出去	運出去
运出来	運出來
运动党	運動黨
运回去	運回去
运回来	運回來
运用于	運用於
近似于	近似於
近几年	近幾年
近思录	近思錄
近日里	近日裏
还不出	還不出
还乡团	還鄉團
还了得	還了得
还出去	還出去
还出来	還出來
还只是	還只是
还只有	還只有
还回到	還回到
还回去	還回去
还回来	還回來
还愿意	還願意
还用于	還用於
还让出	還讓出
这一个	這一個
这个月	這個月
这么个	這麼個
这么干	這麼幹
这些个	這些個
这伙人	這夥人
这几个	這幾個
这几天	這幾天
这几次	這幾次
这出剧	這齣劇
这只不	這只不
这只允	這只允
这只容	這只容
这只是	這只是
这只用	這只用
这只采	這只採
这回事	這回事
这当儿	這當兒
这方面	這方面
这种事	這種事
这种人	這種人
这里会	這裏會
这里在	這裏在
这里是	這裏是
这里有	這裏有
这里能	這裏能
进不了	進不了
进修班	進修班
进出口	進出口
进出境	進出境
进度表	進度表
进得了	進得了
进步党	進步黨
进行曲	進行曲
进货价	進貨價
进香团	進香團
远征军	遠征軍
连云区	連雲區
连云港	連雲港
连系词	連繫詞
连胜文	連勝文
迦叶佛	迦葉佛
迪克斯	迪克斯
迪化厂	迪化廠
迷幻药	迷幻藥
迷彩服	迷彩服
迷彩裤	迷彩褲
迷魂药	迷魂藥
迸出去	迸出去
迸出来	迸出來
迸发出	迸發出
追回去	追回去
追回来	追回來
追査出	追査出
退出去	退出去
退出来	退出來
退回去	退回去
退回来	退回來
退烧药	退燒藥
送出去	送出去
送出来	送出來
送回到	送回到
送回去	送回去
送回来	送回來
送客台	送客檯
送秋波	送秋波
适合于	適合於
适合者	適合者
适婚期	適婚期
适婚者	適婚者
适应力	適應力
适应性	適應性
适应期	適應期
适应症	適應症
适当地	適當地
适当性	適當性
适当的	適當的
适时地	適時地
适法性	適法性
适用于	適用於
适用性	適用性
适用者	適用者
适航性	適航性
适配器	適配器
适配层	適配層
逃不了	逃不了
逃不出	逃不出
逃债台	逃債臺
逃出去	逃出去
逃出来	逃出來
逃脱出	逃脫出
逆价差	逆價差
逆时针	逆時針
逆转录	逆轉錄
逆钟向	逆鐘向
选举制	選舉制
选修科	選修科
选修课	選修課
选出来	選出來
选拔出	選拔出
逊克县	遜克縣
逍遥游	逍遙遊
透出去	透出去
透出来	透出來
透漏出	透漏出
透露出	透露出
递出去	遞出去
递出来	遞出來
递回去	遞回去
递回来	遞回來
通便药	通便藥
通党库	通黨庫
通历史	通歷史
通奸罪	通姦罪
通布图	通佈圖
通心面	通心麵
通志馆	通志館
通讯录	通訊錄
逛出去	逛出去
逛出来	逛出來
逛回去	逛回去
逛回来	逛回來
速克达	速克達
速食面	速食麵
造出来	造出來
造就出	造就出
造币厂	造幣廠
造纸厂	造紙廠
造纸术	造紙術
造船厂	造船廠
造船系	造船系
造血干	造血幹
造钟表	造鐘錶
逸出功	逸出功
逸周书	逸周書
逼下台	逼下臺
逼出去	逼出去
逼出来	逼出來
逼回去	逼回去
逼回来	逼回來
遇风后	遇風後
遏云社	遏雲社
道不了	道不了
道不出	道不出
道克鲁	道克魯
道种智	道種智
道里区	道里區
遗传钟	遺傳鐘
遗忘症	遺忘症
遗风余	遺風餘
遣送回	遣送回
遥地里	遙地裏
遮不了	遮不了
遮光板	遮光板
遮场面	遮場面
遮护板	遮護板
遮羞布	遮羞布
遮阳板	遮陽板
遴选出	遴選出
避孕药	避孕藥
避雷针	避雷針
避风台	避風臺
邢台县	邢臺縣
邢台市	邢臺市
那个人	那個人
那么干	那麼幹
那伙人	那夥人
那几个	那幾個
那几天	那幾天
那几次	那幾次
那出剧	那齣劇
那只是	那只是
那只有	那只有
那当儿	那當兒
那方面	那方面
那曲县	那曲縣
那曲市	那曲市
那种人	那種人
那维克	那維克
邮汇局	郵匯局
邱富郁	邱富郁
邱正杰	邱正傑
邱胜琦	邱勝琦
邱胜翊	邱勝翊
邱郁婷	邱郁婷
邵廷采	邵廷采
邵维杰	邵維傑
邻里长	鄰里長
郁南县	鬱南縣
郁沉沉	鬱沉沉
郁离子	郁離子
郁达夫	郁達夫
郁金香	鬱金香
郁闭度	鬱閉度
郎之万	郎之萬
郑丞杰	鄭丞傑
郑丰喜	鄭豐喜
郑余豪	鄭余豪
郑俊杰	鄭俊傑
郑克塽	鄭克塽
郑克爽	鄭克爽
郑凯云	鄭凱云
郑家钟	鄭家鐘
郑幸娟	鄭幸娟
郑庄公	鄭莊公
郑志龙	鄭志龍
郑明修	鄭明修
郑易里	鄭易里
郑杰文	鄭傑文
郑板桥	鄭板橋
郑梦准	鄭夢準
郑苹如	鄭蘋如
郑荣松	鄭榮松
郡县制	郡縣制
郡国制	郡國制
部胡林	部胡林
部落发	部落發
郭勇志	郭勇志
郭台成	郭台成
郭台铭	郭台銘
郭子干	郭子乾
郭志明	郭志明
郭松焘	郭松焘
郭泓志	郭泓志
郭采洁	郭采潔
都出去	都出去
都出来	都出來
都卜勒	都卜勒
都发局	都發局
都受了	都受了
都回去	都回去
都回来	都回來
都必须	都必須
都肯干	都肯幹
都舍下	都捨下
鄂托克	鄂托克
鄭凱云	鄭凱云
配出来	配出來
配合上	配合上
配合度	配合度
配合款	配合款
配合着	配合著
配合题	配合題
配膳台	配膳檯
配药师	配藥師
酒娘子	酒娘子
酒已干	酒已乾
酒帘子	酒帘子
酒干了	酒乾了
酒干尽	酒乾盡
酒干掉	酒乾掉
酒注子	酒注子
酒游花	酒游花
酝酿出	醞釀出
酩子里	酩子裏
酮体症	酮體症
酷毙了	酷斃了
酿酒厂	釀酒廠
醉心于	醉心於
醉熏熏	醉熏熏
醋坛子	醋罈子
醒狮团	醒獅團
采下去	採下去
采下来	採下來
采回去	採回去
采回来	採回來
采收期	採收期
采收率	採收率
采树种	採樹種
采样法	採樣法
采样率	採樣率
采棉机	採棉機
采樵人	採樵人
采煤矿	採煤礦
采珠人	採珠人
采用到	採用到
采用率	採用率
采石厂	採石廠
采石场	採石場
采矿业	採礦業
采矿场	採礦場
采矿工	採礦工
采砂场	採砂場
采空区	採空區
采花贼	採花賊
采芹人	採芹人
采茶戏	採茶戲
采茶歌	採茶歌
采药人	採藥人
采莲曲	採蓮曲
采莲船	採蓮船
采访使	採訪使
采访员	採訪員
采访团	採訪團
采访权	採訪權
采购员	採購員
采购团	採購團
采购案	採購案
采购法	採購法
采购站	採購站
采购量	採購量
采过去	採過去
采过来	採過來
采集到	採集到
采集法	採集法
采风录	采風錄
釉下彩	釉下彩
释放出	釋放出
里克特	里克特
里包恩	里包恩
里士满	裏士滿
里外里	裏外裏
里奇蒙	里奇蒙
里契蒙	里契蒙
里奥斯	里奧斯
里尔队	里爾隊
里干事	里幹事
里怀里	裏懷裏
里斯本	里斯本
里昂市	里昂市
里昂队	里昂隊
里槅子	裏槅子
里欧斯	里歐斯
里港乡	里港鄉
里牵绵	裏牽綿
里程碑	里程碑
里程表	里程錶
里程计	里程計
里维拉	里維拉
里肌肉	里肌肉
里脊肉	裏脊肉
里贝利	里貝利
里贾纳	里賈納
里边儿	裏邊兒
里邻长	里鄰長
里长伯	里長伯
里面儿	裏面兒
里面包	裏面包
重估后	重估後
重划区	重劃區
重划局	重劃局
重力摆	重力擺
重复式	重複式
重复本	重複本
重复法	重複法
重复节	重複節
重定向	重定向
重罗面	重羅麵
野台戏	野臺戲
野姜花	野薑花
野百合	野百合
野获编	野獲編
量回去	量回去
量回来	量回來
量雨表	量雨表
金万福	金萬福
金云母	金雲母
金仆姑	金僕姑
金仑溪	金崙溪
金光党	金光黨
金创药	金創藥
金升圭	金昇圭
金升渊	金升淵
金台区	金臺區
金合欢	金合歡
金周成	金周成
金坛市	金壇市
金基范	金基範
金士杰	金士傑
金属制	金屬製
金属杆	金屬桿
金属板	金屬板
金布道	金布道
金曲奖	金曲獎
金正云	金正雲
金甲虫	金甲蟲
金疮药	金瘡藥
金石录	金石錄
金穗奖	金穗獎
金线虫	金綫蟲
金花虫	金花蟲
金衡制	金衡制
金表态	金表態
金表情	金表情
金表扬	金表揚
金表明	金表明
金表演	金表演
金表现	金表現
金表示	金表示
金表达	金表達
金表露	金表露
金表面	金表面
金谷园	金谷園
金里奇	金裏奇
金针山	金針山
金针花	金針花
金针菇	金針菇
金针菜	金針菜
金钟儿	金鐘兒
金钟奖	金鐘獎
金钟罩	金鐘罩
金钟铲	金鐘鏟
金钱板	金錢板
金马克	金馬克
鉴别力	鑑別力
鉴别器	鑑別器
鉴定为	鑑定爲
鉴定书	鑑定書
鉴定人	鑑定人
鉴藏印	鑑藏印
鉴赏力	鑑賞力
鉴赏印	鑑賞印
鉴赏家	鑑賞家
鉴频器	鑑頻器
针叶林	針葉林
针叶树	針葉樹
针对于	針對於
针对性	針對性
针尖儿	針尖兒
针形叶	針形葉
针梳机	針梳機
针状物	針狀物
针眼子	針眼子
针笔匠	針筆匠
针箍儿	針箍兒
针线包	針綫包
针线娘	針綫娘
针线扁	針綫扁
针线活	針綫活
针线盒	針綫盒
针织厂	針織廠
针织品	針織品
针织料	針織料
针鼻儿	針鼻兒
钉书针	釘書針
钓鱼台	釣魚臺
钓鱼杆	釣魚杆
钛合金	鈦合金
钟乳洞	鐘乳洞
钟乳石	鐘乳石
钟发音	鐘發音
钟响声	鐘響聲
钟山区	鐘山區
钟山县	鐘山縣
钟左右	鐘左右
钟形虫	鐘形蟲
钟无豔	鍾無豔
钟楚红	鐘楚紅
钟楼区	鐘樓區
钟欣桐	鍾欣桐
钟点房	鐘點房
钟点费	鐘點費
钟珮瑄	鐘珮瑄
钟祥县	鐘祥縣
钟祥市	鐘祥市
钟福松	鐘福松
钟表停	鐘錶停
钟表决	鍾表決
钟表店	鐘錶店
钟表快	鐘錶快
钟表态	鍾表態
钟表慢	鐘錶慢
钟表明	鍾表明
钟表演	鐘表演
钟表王	鐘錶王
钟表现	鐘表現
钟表的	鐘錶的
钟表盘	鐘表盤
钟表示	鍾表示
钟表行	鐘錶行
钟表速	鐘錶速
钟表露	鍾表露
钟表面	鐘表面
钟陈列	鐘陳列
钟鼎文	鐘鼎文
钢制品	鋼製品
钢曲尺	鋼曲尺
钢琴曲	鋼琴曲
钢笔杆	鋼筆桿
钢铁厂	鋼鐵廠
钥匙链	鑰匙鏈
钩出来	鉤出來
钩勒出	鉤勒出
钩虫病	鉤蟲病
钱板儿	錢板兒
钱玄同	錢玄同
钱钟书	錢鐘書
钻个洞	鑽個洞
钻出来	鑽出來
钻心虫	鑽心蟲
铁了心	鐵了心
铁人团	鐵人團
铁克人	鐵克人
铁合金	鐵合金
铁娘子	鐵娘子
铁工厂	鐵工廠
铁布衫	鐵布衫
铁拍板	鐵拍板
铁板烧	鐵板燒
铁板路	鐵板路
铁板面	鐵板麵
铁栏杆	鐵欄杆
铁甲虫	鐵甲蟲
铁胃团	鐵胃團
铁苏木	鐵蘇木
铃响后	鈴響後
铜制品	銅製品
铜斗儿	銅斗兒
铜梁县	銅梁縣
铜雀台	銅雀臺
铝制品	鋁製品
铝合金	鋁合金
铰链叶	鉸鏈葉
铲土机	鏟土機
铲运机	鏟運機
铲运车	鏟運車
铲雪车	鏟雪車
银丝卷	銀絲捲
银发族	銀髮族
银合欢	銀合歡
银河系	銀河系
银纤维	銀纖維
银行团	銀行團
铸币厂	鑄幣廠
铸造出	鑄造出
铺出去	鋪出去
铺出来	鋪出來
铺地板	鋪地板
铺面房	鋪面房
链传动	鏈傳動
链反应	鏈反應
链气士	鍊氣士
链球菌	鏈球菌
链路层	鏈路層
链金术	鍊金術
链钳子	鏈鉗子
链霉素	鏈黴素
销回去	銷回去
销回来	銷回來
锅烟子	鍋煙子
锆合金	鋯合金
锋面雨	鋒面雨
错不了	錯不了
错别字	錯別字
锚链孔	錨鏈孔
锡克拜	錫克拜
锡克教	錫克教
锡克族	錫克族
锡当河	錫當河
锥虫病	錐蟲病
锦回文	錦迴文
锦熏笼	錦熏籠
锦胡同	錦衚衕
锯木厂	鋸木廠
锹形虫	鍬形蟲
锺万梅	鍾萬梅
锺重发	鍾重發
锻炼出	鍛煉出
镁合金	鎂合金
镇定药	鎮定藥
镇痛药	鎮痛藥
镇荣里	鎮榮里
镇静药	鎮靜藥
镍合金	鎳合金
镜面呢	鏡面呢
长丰县	長豐縣
长出来	長出來
长历史	長歷史
长头布	長頭布
长寿烟	長壽煙
长寿面	長壽麵
长干巷	長干巷
长干曲	長干曲
长征军	長征軍
长板凳	長板凳
长生药	長生藥
长谷川	長谷川
长须鲸	長鬚鯨
门吊儿	門弔兒
门里人	門裏人
门里大	門裏大
门面杯	門面杯
门面话	門面話
闫怀礼	閆懷禮
闭卷考	閉卷考
闯出去	闖出去
闯出来	闖出來
闲下来	閒下來
闲不住	閒不住
闲工夫	閒工夫
闲扯淡	閒扯淡
闲淘气	閒淘氣
闲理会	閒理會
闲盘儿	閒盤兒
闲磕牙	閒磕牙
闲篇儿	閒篇兒
闲聊天	閒聊天
闲聒七	閒聒七
间叶干	間葉幹
间奏曲	間奏曲
间深里	間深裏
闵子里	閔子裏
闵采尔	閔採爾
闹出去	鬧出去
闹出来	鬧出來
闹别扭	鬧彆扭
闹哄哄	鬧哄哄
闹拧了	鬧擰了
闹饥荒	鬧饑荒
闻风后	聞風後
阅兵台	閱兵臺
阅卷组	閱卷組
阎云浚	閻雲浚
阔叶林	闊葉林
阔叶树	闊葉樹
防制法	防制法
防御力	防禦力
防御性	防禦性
防御战	防禦戰
防御术	防禦術
防御率	防禦率
防御网	防禦網
防护团	防護團
防水布	防水布
防水表	防水錶
防滑链	防滑鏈
防火布	防火布
防疫针	防疫針
防身术	防身術
防雨布	防雨布
阳历史	陽歷史
阳历年	陽曆年
阳春面	陽春麵
阳曲县	陽曲縣
阳极板	陽極板
阳极泥	陽極泥
阳电极	陽電極
阳谷县	陽谷縣
阴丹布	陰丹布
阴历史	陰歷史
阴历年	陰曆年
阴暗处	陰暗處
阴暗面	陰暗面
阴极管	陰極管
阴沈沈	陰沈沈
阴阳历	陰陽曆
阵发性	陣發性
阵线党	陣綫黨
阵面上	陣面上
阿仙药	阿仙藥
阿信曲	阿信曲
阿修罗	阿修羅
阿克伦	阿克倫
阿克拉	阿克拉
阿克苏	阿克蘇
阿克达	阿克達
阿克陶	阿克陶
阿利托	阿利托
阿叶德	阿葉德
阿合奇	阿合奇
阿呆瓜	阿呆瓜
阿布加	阿布加
阿布尔	阿布爾
阿布瑞	阿布瑞
阿布贾	阿布賈
阿布达	阿布達
阿托品	阿托品
阿拉克	阿拉克
阿胡斯	阿胡斯
阿苏山	阿蘇山
阿里山	阿里山
阿里曼	阿里曼
阿里郎	阿里郎
附致语	附致語
附面层	附面層
陆丰市	陸豐市
陆云浩	陸雲浩
陆克文	陸克文
陆均松	陸均松
陆征祥	陸徵祥
陆龟蒙	陸龜蒙
陈万松	陳萬松
陈万立	陳萬立
陈世杰	陳世杰
陈义丰	陳義豐
陈云林	陳雲林
陈云程	陳雲程
陈俊杰	陳俊傑
陈克帆	陳克帆
陈列台	陳列臺
陈同海	陳同海
陈后主	陳後主
陈尹杰	陳尹杰
陈布雷	陳布雷
陈希同	陳希同
陈幸妤	陳幸妤
陈幸嫚	陳倖嫚
陈建志	陳建志
陈志伟	陳志偉
陈志勇	陳志勇
陈志声	陳志聲
陈志强	陳志強
陈志忠	陳志忠
陈志明	陳志明
陈志玮	陳志瑋
陈志维	陳志維
陈志诚	陳志誠
陈志豪	陳志豪
陈志远	陳志遠
陈志鸿	陳志鴻
陈情表	陳情表
陈木胜	陳木勝
陈永丰	陳永豐
陈汉升	陳漢昇
陈瀛钟	陳瀛鐘
陈秋婷	陳秋婷
陈秋扬	陳秋揚
陈秋火	陳秋火
陈胜在	陳勝在
陈胜宏	陳勝宏
陈胜福	陳勝福
陈致中	陳致中
陈致远	陳致遠
陈荣杰	陳榮傑
陈郁秀	陳郁秀
陈隆志	陳隆志
陈面谟	陳面謨
降升调	降升調
降压药	降壓藥
降回到	降回到
降回去	降回去
降回来	降回來
限制住	限制住
限制器	限制器
限制式	限制式
限制性	限制性
限制是	限制是
限制类	限制類
限制级	限制級
限制词	限制詞
限制酶	限制酶
除不尽	除不盡
除臭药	除臭藥
除虫剂	除蟲劑
除虫菊	除蟲菊
陪同到	陪同到
陪审制	陪審制
陪审团	陪審團
陶朱公	陶朱公
陶板屋	陶板屋
陶菲克	陶菲克
隆准许	隆准許
隆回县	隆回縣
随想曲	隨想曲
隐修士	隱修士
隐修院	隱修院
隐睪症	隱睪症
隐翅虫	隱翅蟲
隐身术	隱身術
隔出来	隔出來
隔断板	隔斷板
隔热板	隔熱板
隔舱板	隔艙板
隔音板	隔音板
隧道症	隧道症
隶属于	隸屬於
难住了	難住了
难容于	難容於
难控制	難控制
雁荡山	雁蕩山
雄斗斗	雄斗斗
雅克萨	雅克薩
集合令	集合令
集合体	集合體
集合到	集合到
集合号	集合號
集合式	集合式
集合点	集合點
集合论	集合論
集团军	集團軍
集团案	集團案
集团股	集團股
集游法	集遊法
集电极	集電極
集训团	集訓團
雕具座	鵰具座
雕刻出	雕刻出
雕刻刀	雕刻刀
雕刻匠	雕刻匠
雕刻品	雕刻品
雕刻家	雕刻家
雕刻师	雕刻師
雕刻术	雕刻術
雕刻画	雕刻畫
雕塑品	雕塑品
雕塑家	雕塑家
雕翎扇	鵰翎扇
雕胡米	雕胡米
雕虫篆	雕蟲篆
雕饰品	雕飾品
雨层云	雨層雲
雨花台	雨花臺
雪茄烟	雪茄煙
雪里红	雪裏紅
雪里蕻	雪裏蕻
零件厂	零件廠
零余子	零餘子
零周期	零週期
零售价	零售價
零多只	零多隻
零天后	零天後
零曲率	零曲率
零系数	零係數
雷克南	雷克南
雷克斯	雷克斯
雷蒙德	雷蒙德
雷雨云	雷雨雲
雷马克	雷馬克
雾台乡	霧臺鄉
雾蒙蒙	霧濛濛
需求面	需求面
震荡性	震盪性
霉干菜	黴乾菜
霍克松	霍克松
霍布斯	霍布斯
霍布森	霍布森
露出去	露出去
露出来	露出來
霸占住	霸佔住
青云志	青雲志
青云谱	青雲譜
青年党	青年黨
青年团	青年團
青瓦台	青瓦臺
青石板	青石板
青苹果	青蘋果
青霉素	青黴素
静荡荡	靜蕩蕩
静配合	靜配合
非党员	非黨員
非合并	非合併
非同步	非同步
非吸烟	非吸菸
非层岩	非層巖
非师范	非師範
非标准	非標準
非种子	非種子
非致命	非致命
非规范	非規範
靠前面	靠前面
靠后面	靠後面
靠外面	靠外面
靠水面	靠水面
靠里面	靠裏面
面临到	面臨到
面人儿	麵人兒
面包住	面包住
面包刀	麵包刀
面包办	面包辦
面包厢	面包廂
面包含	面包含
面包围	面包圍
面包容	面包容
面包屑	麵包屑
面包师	麵包師
面包庇	面包庇
面包店	麵包店
面包心	麵包心
面包房	麵包房
面包扎	面包紮
面包抄	面包抄
面包括	面包括
面包揽	面包攬
面包树	麵包樹
面包涵	面包涵
面包渣	麵包渣
面包片	麵包片
面包皮	麵包皮
面包管	面包管
面包粉	麵包粉
面包罗	面包羅
面包花	麵包花
面包藏	面包藏
面包装	面包裝
面包车	麵包車
面团团	面團團
面坯儿	麵坯兒
面子上	面子上
面子药	麵子藥
面子话	面子話
面对面	面對面
面摊子	麵攤子
面条儿	麵條兒
面条目	麵條目
面板厂	面板廠
面板股	面板股
面條目	面條目
面点师	麵點師
面点王	麵點王
面疙瘩	麵疙瘩
面皮厚	面皮厚
面皮薄	面皮薄
面码儿	麵碼兒
面积分	面積分
面粉袋	麵粉袋
面试会	面試會
面试官	面試官
面面观	面面觀
面食类	麵食類
革制品	革製品
革命党	革命黨
靴后跟	靴後跟
靶台上	靶臺上
鞭毛虫	鞭毛蟲
韩升洙	韓昇洙
韩国制	韓國製
韩复矩	韓復榘
韩宗志	韓宗志
韩巴里	韓巴里
韩幸霖	韓幸霖
韩彩英	韓彩英
韩立克	韓立克
韩蒙德	韓蒙德
音乐台	音樂臺
音乐团	音樂團
音乐系	音樂系
韶山冲	韶山沖
顶回去	頂回去
顶回来	頂回來
顶夸克	頂夸克
顶梁柱	頂樑柱
顶针儿	頂針兒
顶门针	頂門針
项别骓	項別騅
项目表	項目表
顺时针	順時針
顺时钟	順時鐘
顺朱儿	順硃兒
顺钟向	順鐘向
顺风后	順風後
须不是	須不是
须发展	須發展
须发文	須發文
须发表	須發表
须后水	須後水
须弥山	須彌山
须弥座	須彌座
须根据	須根據
须菩堤	須菩堤
须陀洹	須陀洹
顾不了	顧不了
顾正秋	顧正秋
顾问团	顧問團
顾面子	顧面子
顾颜面	顧顏面
颁奖台	頒獎台
预想出	預想出
预料出	預料出
预测出	預測出
预算表	預算表
预防针	預防針
颅顶叶	顱頂葉
领出去	領出去
领出来	領出來
领回去	領回去
领回来	領回來
领域里	領域裏
领带针	領帶針
领悟出	領悟出
领略出	領略出
领表格	領表格
领袖欲	領袖慾
题名录	題名錄
题材面	題材面
颜志麟	顏志麟
颜面角	顏面角
颜面骨	顏面骨
颠儿面	顛兒面
颠复性	顛覆性
风云车	風雲車
风入松	風入松
风向器	風向器
风向标	風向標
风向球	風向球
风向袋	風向袋
风向针	風向針
风土志	風土誌
风干机	風乾機
风水术	風水術
风浪板	風浪板
风湿症	風濕症
风物志	風物誌
风胡子	風胡子
风速表	風速表
风里言	風裏言
风里语	風裏語
飞出去	飛出去
飞出来	飛出來
飞回去	飛回去
飞回来	飛回來
飞烟传	飛煙傳
飞蚊症	飛蚊症
飞行云	飛行雲
飞行钟	飛行鐘
飞车党	飛車黨
食品厂	食品廠
食心虫	食心蟲
食物柜	食物櫃
食物链	食物鏈
食虫目	食蟲目
食虫虻	食蟲虻
食货志	食貨志
饥饿感	飢餓感
饭后钟	飯後鐘
饼干店	餅乾店
饼干盒	餅乾盒
饿死了	餓死了
馄饨面	餛飩麵
首部曲	首部曲
首都杯	首都盃
首长制	首長制
香港游	香港遊
香烟头	香菸頭
香烟盒	香菸盒
香菜叶	香菜葉
香蜡店	香蠟店
香蜡铺	香蠟鋪
馬占山	馬占山
马克思	馬克思
马克数	馬克數
马克斯	馬克斯
马克杯	馬克杯
马克沁	馬克沁
马克笔	馬克筆
马利布	馬利布
马占山	馬占山
马后炮	馬後炮
马后砲	馬後砲
马头娘	馬頭娘
马尔谷	馬爾谷
马尾松	馬尾松
马布瑞	馬布瑞
马德里	馬德里
马志英	馬志英
马戏团	馬戲團
马扎尔	馬扎爾
马拉松	馬拉松
马普托	馬普托
马术赛	馬術賽
马朱罗	馬朱羅
马杰明	馬傑明
马致远	馬致遠
马苏德	馬蘇德
马赛克	馬賽克
马赛曲	馬賽曲
马蹄表	馬蹄表
马里克	馬里克
马里兰	馬里蘭
马里奇	馬里奇
马里奥	馬里奧
马里布	馬里布
马里斯	馬里斯
马鬣松	馬鬣松
驭兽术	馭獸術
驱虫剂	驅蟲劑
驱逐出	驅逐出
驳回去	駁回去
驳回来	駁回來
驳面子	駁面子
驻扎地	駐紮地
驾回去	駕回去
驾回来	駕回來
验尸官	驗屍官
骑兵团	騎兵團
骑出去	騎出去
骑出来	騎出來
骑回去	騎回去
骑回来	騎回來
骑士团	騎士團
骗不了	騙不了
骗人布	騙人布
骗出去	騙出去
骗出来	騙出來
骗回去	騙回去
骗回来	騙回來
骨子里	骨子裏
骨岩岩	骨巖巖
骨灰坛	骨灰罈
高个儿	高個兒
高个子	高個子
高丽参	高麗參
高价位	高價位
高价股	高價股
高台县	高臺縣
高周波	高周波
高学历	高學歷
高层云	高層雲
高山症	高山症
高干扰	高干擾
高干预	高干預
高度表	高度表
高志尚	高志尚
高志纲	高志綱
高志航	高志航
高志鹏	高志鵬
高性价	高性價
高才生	高才生
高技术	高技術
高政升	高政昇
高柏松	高柏松
高标准	高標準
高梁川	高梁川
高梁市	高梁市
高梁米	高梁米
高梁酒	高梁酒
高水准	高水準
高清愿	高清愿
高球杯	高球杯
高积云	高積雲
高纤维	高纖維
高脚杯	高腳杯
高良姜	高良薑
高英杰	高英傑
高跳台	高跳臺
高郁淨	高郁淨
髹饰录	髹飾錄
鬼胡油	鬼胡油
鬼胡由	鬼胡由
鬼谷子	鬼谷子
鬼针草	鬼針草
魁人党	魁人黨
魁北克	魁北克
魏台复	魏台復
魏幸雄	魏幸雄
魏明谷	魏明谷
魏郁奇	魏郁奇
魔合罗	魔合羅
魔术家	魔術家
魔术师	魔術師
魔术棒	魔術棒
魔术秀	魔術秀
魔术蛇	魔術蛇
魔术贴	魔術貼
魔术队	魔術隊
魔赛克	魔賽克
鱼台县	魚臺縣
鱼尾板	魚尾板
鱼鳞松	魚鱗松
鲁克斯	魯克斯
鲁适维	魯適維
鲜谷王	鮮穀王
鳝鱼面	鱔魚麵
鸟松乡	鳥松鄉
鸟虫书	鳥蟲書
鸡丝面	雞絲麵
鸡腿面	雞腿麵
鸡蛋面	鶏蛋麵
鸣榔板	鳴榔板
鸦片烟	鴉片煙
鹍鸡曲	鵾雞曲
鹦鹉杯	鸚鵡杯
鹰星云	鷹星雲
鹿谷乡	鹿谷鄉
麟游县	麟遊縣
麦个子	麥個子
麦克斯	麥克斯
麦克林	麥克林
麦克白	麥克白
麦克维	麥克維
麦克贝	麥克貝
麦克连	麥克連
麦克风	麥克風
麦卡托	麥卡托
麦布莱	麥布萊
麦当乐	麥當樂
麦当劳	麥當勞
麦当娜	麥當娜
麦托姆	麥托姆
麦格里	麥格里
麦特克	麥特克
麦科里	麥科裏
麻叶皮	麻葉皮
麻布袋	麻布袋
麻栗坡	麻栗坡
麻油厂	麻油廠
麻酱面	麻醬麵
麻醉药	麻醉藥
麻醉针	麻醉針
黃鈺筑	黃鈺筑
黃长发	黃長發
黄上丰	黃上豐
黄世杰	黃世傑
黄东梁	黃東樑
黄仁杰	黃仁傑
黄仕杰	黃仕傑
黄俊杰	黃俊杰
黄克强	黃克強
黄凤秋	黃鳳秋
黄同纸	黃同紙
黄嘉千	黃嘉千
黄天荡	黃天蕩
黄山谷	黃山谷
黄岩区	黃岩區
黄岩岛	黃岩島
黄志中	黃志中
黄志伟	黃志偉
黄志勇	黃志勇
黄志强	黃志強
黄志成	黃志成
黄志玮	黃志瑋
黄志芳	黃志芳
黄志雄	黃志雄
黄志鹏	黃志鵬
黄志龙	黃志龍
黄旭升	黃旭昇
黄明志	黃明志
黄曲霉	黃麴黴
黄有才	黃有才
黄梁梦	黃梁夢
黄珮筑	黃珮筑
黄秋庆	黃秋慶
黄秋燕	黃秋燕
黄秋生	黃秋生
黄秋葵	黃秋葵
黄种人	黃種人
黄育杰	黃育杰
黄英杰	黃英傑
黄表纸	黃表紙
黄运杰	黃運傑
黄适卓	黃適卓
黄道周	黃道周
黄郁涵	黃郁涵
黄郁茹	黃郁茹
黄金台	黃金臺
黄金周	黃金周
黄金表	黃金錶
黄钰筑	黃鈺筑
黎曼面	黎曼面
黏合剂	黏合劑
黏合力	黏合力
黏合成	黏合成
黑云母	黑雲母
黑亮发	黑亮髮
黑加仑	黑加侖
黑发人	黑髮人
黑头虫	黑頭蟲
黑尿症	黑尿症
黑手党	黑手黨
黑暗期	黑暗期
黑暗面	黑暗面
黑曜岩	黑曜岩
黑杰克	黑傑克
黑板报	黑板報
黑板擦	黑板擦
黑板树	黑板樹
黑沈沈	黑沈沈
黑种人	黑種人
黑穗病	黑穗病
黑胡椒	黑胡椒
黑色系	黑色系
黑豹党	黑豹黨
黑醋栗	黑醋栗
黑里俏	黑裏俏
黑面包	黑麵包
默克尔	默克爾
默多克	默多克
黛粉叶	黛粉葉
鼎折足	鼎折足
鼎泰丰	鼎泰豐
鼓出来	鼓出來
鼓子曲	鼓子曲
鼠得克	鼠得克
鼠曲草	鼠麴草
鼠面人	鼠面人
鼻出血	鼻出血
鼻梁儿	鼻樑兒
鼻梁骨	鼻樑骨
鼻烟壶	鼻菸壺
鼻烟盒	鼻菸盒
齐克果	齊克果
齐克隆	齊克隆
齐发式	齊發式
齐梁体	齊梁體
龙利叶	龍利葉
龙卷风	龍捲風
龙发堂	龍發堂
龙岩市	龍巖市
龙岩村	龍巖村
龙嵩叶	龍嵩葉
龙游县	龍遊縣
龙眼干	龍眼乾
龙胜县	龍勝縣
龙虎斗	龍虎鬥
龙虾面	龍蝦麵
龙里县	龍裏縣
龙门吊	龍門吊
龙须友	龍鬚友
龙须沟	龍鬚溝
龙须茶	龍鬚茶
龙须草	龍鬚草
龙须菜	龍鬚菜
龙须面	龍鬚麵
龚照胜	龔照勝