一万一千	一萬一千
一万七千	一萬七千
一万三千	一萬三千
一万两千	一萬兩千
一万九千	一萬九千
一万二千	一萬二千
一万五千	一萬五千
一万八千	一萬八千
一万六千	一萬六千
一万四千	一萬四千
一不注意	一不注意
一丝不挂	一絲不掛
一个劲儿	一個勁兒
一个子儿	一個子兒
一个样儿	一個樣兒
一个鼻孔	一個鼻孔
一中一台	一中一臺
一举千里	一舉千里
一了心愿	一了心願
一了百了	一了百了
一了百当	一了百當
一争两丑	一爭兩醜
一代豪杰	一代豪傑
一以当十	一以當十
一体两面	一體兩面
一佛出世	一佛出世
一偿宿愿	一償宿願
一元复始	一元復始
一党专制	一黨專制
一党独大	一黨獨大
一冲一撞	一衝一撞
一冲性子	一沖性子
一决胜负	一決勝負
一出祁山	一出祁山
一分收获	一分收穫
一别多年	一別多年
一刻千金	一刻千金
一前一后	一前一後
一力承当	一力承當
一千两百	一千兩百
一千多万	一千多萬
一千多亿	一千多億
一千零一	一千零一
一千零三	一千零三
一千零二	一千零二
一厘一毫	一釐一毫
一厢情愿	一廂情願
一去不回	一去不回
一去不复	一去不復
一发不可	一發不可
一发之差	一髮之差
一发之间	一髮之間
一发千钧	一髮千鈞
一口价儿	一口價兒
一叶扁舟	一葉扁舟
一叶知秋	一葉知秋
一号木杆	一號木桿
一哄而上	一哄而上
一哄而散	一鬨而散
一哄而起	一哄而起
一哄而集	一哄而集
一团和气	一團和氣
一团漆黑	一團漆黑
一国两制	一國兩制
一地胡拿	一地胡拿
一坛死水	一壇死水
一塌糊涂	一塌糊塗
一壸千金	一壺千金
一夜致富	一夜致富
一大郎当	一大郎當
一天星斗	一天星斗
一夫当关	一夫當關
一孔出气	一孔出氣
一字一板	一字一板
一字千金	一字千金
一寸秋波	一寸秋波
一展长才	一展長才
一干二净	一乾二淨
一干二淨	一乾二淨
一干家中	一干家中
一干弟兄	一干弟兄
一干弟子	一干弟子
一干而尽	一乾而盡
一干部下	一干部下
一并处理	一併處理
一开出来	一開出來
一心向上	一心向上
一念三千	一念三千
一折一磨	一折一磨
一折两段	一折兩段
一折八扣	一折八扣
一拍即合	一拍即合
一挂之下	一掛之下
一掷千金	一擲千金
一掷百万	一擲百萬
一摇一摆	一搖一擺
一摇三摆	一搖三擺
一斗再斗	一鬥再鬥
一无所获	一無所獲
一日万机	一日萬機
一日三秋	一日三秋
一日千里	一日千里
一早起了	一早起了
一时糊涂	一時糊塗
一曲千金	一曲千金
一曲阳关	一曲陽關
一本万利	一本萬利
一杆进洞	一桿進洞
一板一眼	一板一眼
一板三眼	一板三眼
一树百获	一樹百穫
一死了之	一死了之
一毫一发	一毫一髮
一池秋水	一池秋水
一波三折	一波三折
一泻千里	一瀉千里
一派胡言	一派胡言
一流人才	一流人才
一片狼借	一片狼藉
一物一制	一物一制
一物克一	一物剋一
一百多万	一百多萬
一百廿万	一百廿萬
一目了然	一目瞭然
一相情愿	一相情願
一瞻丰采	一瞻丰采
一碧万顷	一碧萬頃
一禾九穗	一禾九穗
一穗三秀	一穗三秀
一笑了之	一笑了之
一笑千金	一笑千金
一答一合	一答一合
一箭之仇	一箭之仇
一箭双雕	一箭雙鵰
一网打尽	一網打盡
一至于此	一至於此
一致百虑	一致百慮
一般等价	一般等價
一落千丈	一落千丈
一表人才	一表人才
一表人材	一表人材
一表人物	一表人物
一表非俗	一表非俗
一表非凡	一表非凡
一见钟情	一見鍾情
一视同仁	一視同仁
一触即发	一觸即發
一言不发	一言不發
一言不合	一言不合
一言千金	一言千金
一言既出	一言既出
一言难尽	一言難盡
一语不发	一語不發
一诺千金	一諾千金
一败涂地	一敗塗地
一走了之	一走了之
一蹴可几	一蹴可幾
一轨同风	一軌同風
一辞莫赞	一辭莫贊
一逞兽欲	一逞獸慾
一针见血	一針見血
一雨成秋	一雨成秋
一面之交	一面之交
一面之缘	一面之緣
一面之识	一面之識
一面之词	一面之詞
一面之辞	一面之辭
一面之雅	一面之雅
一面如旧	一面如舊
一飞冲天	一飛衝天
一食万钱	一食萬錢
一饭千金	一飯千金
一饮而尽	一飲而盡
一马当先	一馬當先
一麾出守	一麾出守
一鼓一板	一鼓一板
丁一确二	丁一確二
丁丁冬冬	丁丁冬冬
丁丁当当	丁丁當當
丁丁炒面	丁丁炒面
丁固生松	丁固生松
丁娘十索	丁娘十索
丁铃当啷	丁鈴噹啷
丁零当啷	丁零當啷
七万三千	七萬三千
七万五千	七萬五千
七万八千	七萬八千
七万六千	七萬六千
七万四千	七萬四千
七个八个	七個八個
七了八当	七了八當
七八下里	七八下裏
七出祁山	七出祁山
七十七万	七十七萬
七十五万	七十五萬
七千两百	七千兩百
七台河市	七臺河市
七国集团	七國集團
七娘妈亭	七娘媽亭
七孔生烟	七孔生煙
七彩缤纷	七彩繽紛
七情六欲	七情六慾
七折八扣	七折八扣
七政四余	七政四餘
七星瓢虫	七星瓢蟲
七步之才	七步之才
七步奇才	七步奇才
七百多万	七百多萬
七窍冒烟	七竅冒煙
七窍生烟	七竅生煙
七里河区	七里河區
万万不可	萬萬不可
万万千千	萬萬千千
万丈光芒	萬丈光芒
万丈深渊	萬丈深淵
万丈竿头	萬丈竿頭
万丈红尘	萬丈紅塵
万不及一	萬不及一
万不可失	萬不可失
万不失一	萬不失一
万不得已	萬不得已
万世一时	萬世一時
万世师表	萬世師表
万乘之国	萬乘之國
万乘之尊	萬乘之尊
万事亨通	萬事亨通
万事具备	萬事具備
万事大吉	萬事大吉
万事如意	萬事如意
万事皆休	萬事皆休
万事皆备	萬事皆備
万事达卡	萬事達卡
万人之敌	萬人之敵
万人之敵	萬人之敵
万人空巷	萬人空巷
万代一时	萬代一時
万代千秋	萬代千秋
万众一心	萬眾一心
万众欢腾	萬眾歡騰
万众瞩目	萬眾矚目
万儿八千	萬兒八千
万全之策	萬全之策
万全之计	萬全之計
万兽之王	萬獸之王
万分之一	萬分之一
万分感激	萬分感激
万分痛苦	萬分痛苦
万别千差	萬別千差
万剐千刀	萬剮千刀
万劫不复	萬劫不復
万博宣伟	萬博宣偉
万县地区	萬縣地區
万古不灭	萬古不滅
万古千秋	萬古千秋
万古流芳	萬古流芳
万古留芳	萬古留芳
万古长新	萬古長新
万古长春	萬古長春
万古长青	萬古長青
万国公报	萬國公報
万国公法	萬國公法
万国邮联	萬國郵聯
万国音标	萬國音標
万境归空	萬境歸空
万壑争流	萬壑爭流
万夫不当	萬夫不當
万夫莫当	萬夫莫當
万夫莫敌	萬夫莫敵
万头攒动	萬頭攢動
万头窜动	萬頭竄動
万姓统谱	萬姓統譜
万宇在线	萬宇在綫
万家灯火	萬家燈火
万家生佛	萬家生佛
万寿千秋	萬壽千秋
万寿无疆	萬壽無疆
万山特区	萬山特區
万岁千秋	萬歲千秋
万年历表	萬年曆錶
万念俱灰	萬念俱灰
万恶之源	萬惡之源
万恶之首	萬惡之首
万恶滔天	萬惡滔天
万户千门	萬戶千門
万斛泉源	萬斛泉源
万无一失	萬無一失
万无失一	萬無失一
万有引力	萬有引力
万柏林区	萬柏林區
万死一生	萬死一生
万死不辞	萬死不辭
万水千山	萬水千山
万法唯识	萬法唯識
万点大关	萬點大關
万物之灵	萬物之靈
万用字元	萬用字元
万用手冊	萬用手冊
万用电表	萬用電表
万目睽睽	萬目睽睽
万种风情	萬種風情
万签插架	萬籤插架
万箭攒心	萬箭攢心
万箭穿心	萬箭穿心
万箭穿身	萬箭穿身
万籁俱寂	萬籟俱寂
万籁无声	萬籟無聲
万籤插架	萬籤插架
万米长跑	萬米長跑
万紫千红	萬紫千紅
万红千紫	萬紅千紫
万绪千头	萬緒千頭
万绪千端	萬緒千端
万绿丛中	萬綠叢中
万缕千丝	萬縷千絲
万能工专	萬能工專
万能曲尺	萬能曲尺
万能梗犬	萬能梗犬
万能选手	萬能選手
万能钥匙	萬能鑰匙
万般皆下	萬般皆下
万花争艳	萬花爭豔
万苦千辛	萬苦千辛
万虑俱清	萬慮俱清
万语千言	萬語千言
万象包罗	萬象包羅
万象更新	萬象更新
万象森罗	萬象森羅
万贯家产	萬貫家產
万贯家私	萬貫家私
万贯家财	萬貫家財
万载千秋	萬載千秋
万里之望	萬里之望
万里同风	萬里同風
万里封侯	萬里封侯
万里无云	萬里無雲
万里晴空	萬里晴空
万里江山	萬里江山
万里迢迢	萬里迢迢
万里追踪	萬里追蹤
万里长城	萬里長城
万里长征	萬里長征
万里长江	萬里長江
万里长空	萬里長空
万里鹏程	萬里鵬程
万里鹏翼	萬里鵬翼
万金不换	萬金不換
万金之躯	萬金之軀
万钧之力	萬鈞之力
万顷琉璃	萬頃琉璃
万顷碧波	萬頃碧波
万马千军	萬馬千軍
万马奔腾	萬馬奔騰
万马皆瘖	萬馬皆瘖
万马齐喑	萬馬齊喑
万马齐瘖	萬馬齊瘖
丈八灯台	丈八燈臺
三万一千	三萬一千
三万七千	三萬七千
三万三千	三萬三千
三万两千	三萬兩千
三万二千	三萬二千
三万五千	三萬五千
三万八千	三萬八千
三万六千	三萬六千
三万四千	三萬四千
三三八万	三三八萬
三个世界	三個世界
三个代表	三個代表
三代同堂	三代同堂
三元合金	三元合金
三冬两夏	三冬兩夏
三出祁山	三出祁山
三化螟虫	三化螟蟲
三十一万	三十一萬
三十七万	三十七萬
三十三万	三十三萬
三十二万	三十二萬
三十五万	三十五萬
三十八万	三十八萬
三十六万	三十六萬
三十几年	三十幾年
三十四万	三十四萬
三十多万	三十多萬
三千世界	三千世界
三千两百	三千兩百
三千多万	三千多萬
三千弟子	三千弟子
三千珠履	三千珠履
三卤甲烷	三鹵甲烷
三台联播	三臺聯播
三叶星云	三葉星雲
三号木杆	三號木桿
三呼万岁	三呼萬歲
三回两转	三回兩轉
三回九曲	三回九曲
三回九转	三回九轉
三回五次	三回五次
三回五转	三回五轉
三坛大戒	三壇大戒
三复斯言	三復斯言
三复白圭	三復白圭
三大发明	三大發明
三大差别	三大差別
三头两面	三頭兩面
三娘教子	三孃教子
三对六面	三對六面
三征七辟	三徵七辟
三思而后	三思而後
三战两胜	三戰兩勝
三才图会	三才圖會
三振出局	三振出局
三星集团	三星集團
三极真空	三極真空
三次曲线	三次曲綫
三江并流	三江並流
三浴三熏	三浴三熏
三熏三沐	三熏三沐
三瓦两舍	三瓦兩舍
三瓦四舍	三瓦四舍
三生有幸	三生有幸
三番四复	三番四復
三百千千	三百千千
三百多万	三百多萬
三百馀万	三百餘萬
三统历史	三統歷史
三角关系	三角關係
三角套汇	三角套匯
三部合唱	三部合唱
三门干部	三門幹部
三面亚当	三面亞當
三面夏娃	三面夏娃
三面红旗	三面紅旗
三马同槽	三馬同槽
三鹿集团	三鹿集團
上上个月	上上個月
上下交困	上下交困
上下同心	上下同心
上个星期	上個星期
上中下游	上中下游
上了岁数	上了歲數
上了年纪	上了年紀
上党梆子	上黨梆子
上冲下洗	上沖下洗
上升趋势	上升趨勢
上台演唱	上臺演唱
上台演奏	上臺演奏
上台演讲	上臺演講
上合组织	上合組織
上吊自杀	上吊自殺
上层建筑	上層建築
上梁不正	上樑不正
上海师范	上海師範
上游工业	上游工業
上野树里	上野樹里
下下个月	下下個月
下不了台	下不了臺
下不来台	下不來臺
下个星期	下個星期
下有苏杭	下有蘇杭
下游工业	下游工業
下笔千言	下筆千言
下里巴人	下里巴人
下面请看	下面請看
下风方向	下風方向
不一致字	不一致字
不上台盘	不上臺盤
不中于款	不中於款
不丰不杀	不豐不殺
不为牛后	不爲牛後
不了之局	不了之局
不了了之	不了了之
不了了当	不了了當
不侮暗室	不侮暗室
不修小节	不修小節
不修帷薄	不修帷薄
不修边幅	不修邊幅
不假外出	不假外出
不克自制	不克自制
不再出版	不再出版
不准翻印	不准翻印
不减当年	不減當年
不出所料	不出所料
不分胜负	不分勝負
不分胜败	不分勝敗
不前不后	不前不後
不加修饰	不加修飾
不加区别	不加區別
不加自制	不加自制
不劳无获	不勞無獲
不劳而获	不勞而獲
不升反降	不升反降
不卜可知	不卜可知
不占凶吉	不占凶吉
不占吉凶	不占吉凶
不变价格	不變價格
不可同日	不可同日
不可向迩	不可向邇
不可战胜	不可戰勝
不可挽回	不可挽回
不可救药	不可救藥
不可胜书	不可勝書
不可胜原	不可勝原
不可胜数	不可勝數
不可胜纪	不可勝紀
不可胜言	不可勝言
不可胜计	不可勝計
不可胜记	不可勝記
不合体统	不合體統
不合时宜	不合時宜
不合标准	不合標準
不合规定	不合規定
不合逻辑	不合邏輯
不同以往	不同以往
不同凡响	不同凡響
不同印本	不同印本
不同日月	不同日月
不告而别	不告而別
不堪回首	不堪回首
不复存在	不復存在
不多几日	不多幾日
不大合时	不大合時
不大精采	不大精采
不好干涉	不好干涉
不好干預	不好干預
不好干预	不好干預
不嫌母丑	不嫌母醜
不学亡术	不學亡術
不学无术	不學無術
不安于位	不安於位
不安于室	不安於室
不完全叶	不完全葉
不寒而栗	不寒而慄
不对腔板	不對腔板
不尽相同	不盡相同
不尽道理	不盡道理
不差毫厘	不差毫釐
不差毫发	不差毫髮
不干不净	不乾不淨
不干不淨	不乾不淨
不干性油	不乾性油
不干着急	不乾着急
不幸中之	不幸中之
不幸之事	不幸之事
不幸之幸	不幸之幸
不幸受害	不幸受害
不幸的是	不幸的是
不当不对	不當不對
不当不正	不當不正
不当人子	不當人子
不当党产	不當黨產
不当得利	不當得利
不当稳便	不當穩便
不当耍处	不當耍處
不形于色	不形於色
不徇颜面	不徇顏面
不得台盘	不得臺盤
不念旧恶	不念舊惡
不恶而严	不惡而嚴
不情不愿	不情不願
不惮强御	不憚強禦
不战而胜	不戰而勝
不折不扣	不折不扣
不敢出声	不敢出聲
不敢出气	不敢出氣
不敢后人	不敢後人
不时之须	不時之須
不明就里	不明就裏
不是个儿	不是個兒
不是了处	不是了處
不是别人	不是別人
不极不反	不極不反
不染纤尘	不染纖塵
不欺暗室	不欺暗室
不止于此	不止於此
不毒不发	不毒不發
不求收获	不求收獲
不治之症	不治之症
不测风云	不測風雲
不消几日	不消幾日
不甘后人	不甘後人
不甚了了	不甚了了
不甚合意	不甚合意
不畏强御	不畏強禦
不畏彊御	不畏彊禦
不留情面	不留情面
不知凡几	不知凡幾
不知去向	不知去向
不知就里	不知就裏
不知所云	不知所云
不确定性	不確定性
不确定感	不確定感
不管闲事	不管閒事
不约而合	不約而合
不约而同	不約而同
不绝于耳	不絕於耳
不肯干休	不肯干休
不胜之态	不勝之態
不胜其扰	不勝其擾
不胜其烦	不勝其煩
不胜其苦	不勝其苦
不胜唏嘘	不勝唏噓
不胜感喟	不勝感喟
不胜感激	不勝感激
不胜枚举	不勝枚舉
不胜负荷	不勝負荷
不胜酒力	不勝酒力
不能出口	不能出口
不能尽数	不能盡數
不能胜数	不能勝數
不能自制	不能自制
不舍昼夜	不捨晝夜
不良于行	不良於行
不良倾向	不良傾向
不良适应	不良適應
不药而愈	不藥而癒
不药而癒	不藥而癒
不落人后	不落人後
不见世面	不見世面
不见识面	不見識面
不解之仇	不解之仇
不让须眉	不讓鬚眉
不讲情面	不講情面
不识局面	不識局面
不谈别的	不談別的
不谋而合	不謀而合
不谋而同	不謀而同
不负所托	不負所托
不赞一词	不讚一詞
不赞一辞	不讚一辭
不足为据	不足爲據
不足之症	不足之症
不足回旋	不足回旋
不足挂齿	不足掛齒
不足采信	不足採信
不辞而别	不辭而別
不远万里	不遠萬里
不远千里	不遠千里
不连续面	不連續面
不通吊庆	不通弔慶
不遗余力	不遺餘力
不避彊御	不避彊禦
不锈钢板	不鏽鋼板
不降反升	不降反升
不顾前后	不顧前後
不顾后果	不顧後果
不顾曲直	不顧曲直
不顾闲野	不顧閒野
不食周粟	不食周粟
不食干腊	不食乾腊
不食烟火	不食煙火
不龟手药	不龜手藥
与他一斗	與他一鬥
与众不同	與眾不同
与国同休	與國同休
与她一斗	與她一鬥
与子同袍	與子同袍
与日同辉	與日同輝
与此同时	與此同時
与民同乐	與民同樂
与民同忧	與民同憂
丑声四溢	醜聲四溢
丑声远播	醜聲遠播
丑头怪脸	醜頭怪臉
丑女效颦	醜女效顰
丑态毕露	醜態畢露
丑态百出	醜態百出
丑类恶物	醜類惡物
专业人才	專業人才
专修科目	專修科目
专利药品	專利藥品
专制主义	專制主義
专制制度	專制制度
专制政体	專制政體
专制政府	專制政府
专制政治	專制政治
专制起来	專制起來
专勤制度	專勤制度
专家系统	專家系統
专家评价	專家評價
专心一志	專心一志
专心致志	專心致志
专柜小姐	專櫃小姐
专欲难成	專欲難成
专美于前	專美於前
专门人才	專門人才
专门术语	專門術語
世彩堂帖	世綵堂帖
世所周知	世所周知
世界大同	世界大同
世界杯室	世界盃室
世界杯赛	世界盃賽
世界纪录	世界紀錄
世界范围	世界範圍
世纪钟表	世紀鐘錶
丙种射线	丙種射綫
业余大学	業餘大學
业余教育	業餘教育
业务范围	業務範圍
业界标准	業界標準
业精于勤	業精於勤
业荒于嬉	業荒於嬉
汇业银行	匯業銀行
业馀电台	業餘電臺
东冲西突	東衝西突
东周时代	東周時代
东周时期	東周時期
东奔西向	東奔西向
东山之志	東山之志
东山里站	東山里站
东征西怨	東征西怨
东征西讨	東征西討
东扬西荡	東揚西蕩
东折西绕	東折西繞
东挨西撞	東挨西撞
东挪西借	東挪西借
东摇西摆	東搖西擺
东方发白	東方發白
东方汇理	東方匯理
东欧集团	東歐集團
东海捞针	東海撈針
东涂西抹	東塗西抹
东窗事发	東窗事發
东荡西除	東蕩西除
东讨西征	東討西征
东谷拉瓦	東谷拉瓦
东邻西舍	東鄰西舍
东量西折	東量西折
东飘西荡	東飄西蕩
丝发之功	絲髮之功
丝恩发怨	絲恩髮怨
丝来线去	絲來綫去
丢在脑后	丟在腦後
两万一千	兩萬一千
两万七千	兩萬七千
两万三千	兩萬三千
两万两千	兩萬兩千
两万九千	兩萬九千
两万五千	兩萬五千
两万八千	兩萬八千
两万六千	兩萬六千
两万四千	兩萬四千
两个中国	兩個中國
两人同心	兩人同心
两千七百	兩千七百
两千三百	兩千三百
两千两百	兩千兩百
两千五百	兩千五百
两千八百	兩千八百
两千六百	兩千六百
两千四百	兩千四百
两千多万	兩千多萬
两厢情愿	兩廂情願
两叶掩目	兩葉掩目
两合公司	兩合公司
两国关系	兩國關係
两天晒网	兩天曬網
两头三面	兩頭三面
两头白面	兩頭白麵
两岸关系	兩岸關係
两性关系	兩性關係
两情两愿	兩情兩願
两极分化	兩極分化
两极观点	兩極觀點
两百多万	兩百多萬
两相情愿	兩相情願
两眼发直	兩眼發直
两腿发软	兩腿發軟
两虎共斗	兩虎共鬥
两虎相斗	兩虎相鬥
两面三刀	兩面三刀
两面二舌	兩面二舌
两面作战	兩面作戰
两面夹攻	兩面夾攻
两面手法	兩面手法
两面讨好	兩面討好
两面转圜	兩面轉圜
两面顾全	兩面顧全
两鼠斗穴	兩鼠鬥穴
严丝合缝	嚴絲合縫
严了眼儿	嚴了眼兒
严于律己	嚴於律己
严加防范	嚴加防範
严禁吸烟	嚴禁吸菸
严禁烟火	嚴禁煙火
严重后果	嚴重後果
丧失殆尽	喪失殆盡
丧尽天良	喪盡天良
丧荡游魂	喪蕩游魂
个个称羡	個個稱羨
个中三昧	箇中三昧
个中原因	箇中原因
个中奥妙	箇中奧妙
个中奥秘	箇中奧秘
个中好手	箇中好手
个中强手	箇中強手
个中消息	箇中消息
个中滋味	箇中滋味
个中玄机	箇中玄機
个中理由	箇中理由
个中讯息	箇中訊息
个中资讯	箇中資訊
个中道理	箇中道理
个中高手	箇中高手
个人主义	個人主義
个人伤害	個人傷害
个人储蓄	個人儲蓄
个人利益	個人利益
个人单季	個人單季
个人卫生	個人衛生
个人外交	個人外交
个人崇拜	個人崇拜
个人得失	個人得失
个人所得	個人所得
个人护理	個人護理
个人拨接	個人撥接
个人本位	個人本位
个人消费	個人消費
个人用户	個人用戶
个人电脑	個人電腦
个人网站	個人網站
个人资料	個人資料
个人隐私	個人隱私
个人首页	個人首頁
个体发育	個體發育
个体所有	個體所有
个体手工	個體手工
个体经济	個體經濟
个别差异	個別差異
个别情况	個別情況
个别指导	個別指導
个别教学	個別教學
个别测验	個別測驗
个别现象	個別現象
个别生产	個別生產
个别谈话	個別談話
个别辅导	個別輔導
个性难改	個性難改
个案分析	個案分析
个案研究	個案研究
个案纪录	個案紀錄
中书舍人	中書舍人
中介社团	中介社團
中低价位	中低價位
中俄关系	中俄關系
中千世界	中千世界
中华台北	中華臺北
中原板荡	中原板蕩
中台医专	中臺醫專
中台圣帕	中颱聖帕
中台禅寺	中臺禪寺
中国制造	中國製造
中国医药	中國醫藥
中国历史	中國歷史
中国当局	中國當局
中型钟表	中型鐘錶
中型钟面	中型鐘面
中央党部	中央黨部
中央汇金	中央匯金
中子俘获	中子俘獲
中度台风	中度颱風
中心汇率	中心匯率
中懑之症	中懣之症
中控面板	中控面板
中日关系	中日關係
中枢系统	中樞系統
中比关系	中比關係
中注模样	中注模樣
中秋佳节	中秋佳節
中秋月饼	中秋月餅
中程计划	中程計劃
中筋面粉	中筋麵粉
中美发表	中美發表
中药偏方	中藥偏方
中西合并	中西合併
中西合璧	中西合璧
中谷有蓷	中谷有蓷
中转柜台	中轉櫃檯
中远集团	中遠集團
中间纤维	中間纖維
丰上锐下	豐上銳下
丰亨豫大	豐亨豫大
丰俭由人	豐儉由人
丰功伟业	豐功偉業
丰功伟绩	豐功偉績
丰功厚利	豐功厚利
丰功大业	豐功大業
丰功懋烈	豐功懋烈
丰功盛烈	豐功盛烈
丰取刻与	豐取刻與
丰城剑气	豐城劍氣
丰城贯斗	豐城貫斗
丰姿冶丽	丰姿冶麗
丰姿绰约	丰姿綽約
丰容靓饰	豐容靚飾
丰富多彩	豐富多彩
丰川悦司	豐川悅司
丰年稔岁	豐年稔歲
丰标不凡	丰標不凡
丰神俊美	丰神俊美
丰神异彩	豐神異彩
丰神绰约	丰神綽約
丰神飘洒	丰神飄灑
丰臣秀吉	豐臣秀吉
丰衣足食	豐衣足食
丰饶丰足	豐饒豐足
临别依依	臨別依依
临别赠言	臨別贈言
临危致命	臨危致命
临去秋波	臨去秋波
临床特征	臨牀特徵
临机制变	臨機制變
临机制胜	臨機制勝
临江折轴	臨江折軸
临沂师范	臨沂師範
临潼斗宝	臨潼鬥寶
丹徒布衣	丹徒布衣
为人师表	爲人師表
为恶不悛	爲惡不悛
为所欲为	爲所欲爲
主修科目	主修科目
主干家庭	主幹家庭
主干网络	主幹網絡
主干网路	主幹網路
主法向量	主法向量
主要树种	主要樹種
主钟曲线	主鐘曲綫
举不胜举	舉不勝舉
举例发凡	舉例發凡
举手可采	舉手可采
举手表决	舉手表決
举措失当	舉措失當
举杯畅饮	舉杯暢飲
举止闲冶	舉止閒冶
举目千里	舉目千里
举荐征辟	舉薦征辟
久仰山斗	久仰山斗
久别相逢	久別相逢
久别重逢	久別重逢
久违颜范	久違顏範
义义合合	義義合合
义同生死	義同生死
义大利杯	義大利杯
义大利面	義大利麵
义形于色	義形於色
义气干霄	義氣干霄
义薄云天	義薄雲天
之八九只	之八九只
乌东察克	烏東察克
乌东査克	烏東査克
乌云密布	烏雲密佈
乌云蔽日	烏雲蔽日
乌克丽丽	烏克麗麗
乌克兰人	烏克蘭人
乌克兰籍	烏克蘭籍
乌克兰队	烏克蘭隊
乌兰察布	烏蘭察布
乌兰巴托	烏蘭巴托
乌兹别克	烏茲別克
乌合之众	烏合之眾
乌合之卒	烏合之卒
乌孜别克	烏孜別克
乌洛托品	烏洛托品
乌滋别克	烏滋別克
乌烟瘴气	烏煙瘴氣
乌苏里江	烏蘇里江
乐不可极	樂不可極
乐于助人	樂於助人
乐府杂录	樂府雜錄
乐极则悲	樂極則悲
乐极忘形	樂極忘形
乐极悲来	樂極悲來
乐极悲生	樂極悲生
乐极生悲	樂極生悲
乐祸幸灾	樂禍幸災
乐颠了馅	樂顛了餡
乒乓球台	乒乓球檯
乔做胡为	喬做胡爲
乔戈里峰	喬戈里峰
乔松之寿	喬松之壽
乔格里峰	喬格里峰
乘凶完配	乘凶完配
乘奔御风	乘奔御風
乘胜追击	乘勝追擊
乘胜逐北	乘勝逐北
乘鹤驾云	乘鶴駕雲
乙种射线	乙種射綫
乙种粒子	乙種粒子
九万九千	九萬九千
九万二千	九萬二千
九万五千	九萬五千
九万六千	九萬六千
九世之仇	九世之仇
九出祁山	九出祁山
九十五万	九十五萬
九千多万	九千多萬
九合一匡	九合一匡
九吊六的	九吊六的
九宵云外	九宵雲外
九折优待	九折優待
九炼成钢	九煉成鋼
九章算术	九章算術
九霄云外	九霄雲外
九龙表行	九龍表行
乞留恶滥	乞留惡濫
乞留曲律	乞留曲律
也不尽然	也不盡然
也斗了胆	也斗了膽
习非胜是	習非勝是
乡党尚齿	鄉黨尚齒
乡土艺术	鄉土藝術
乡曲之誉	鄉曲之譽
乡民代表	鄉民代表
乡里小人	鄉里小人
乡镇代表	鄉鎮代表
乡间别墅	鄉間別墅
书不尽言	書不盡言
书刊杂志	書刊雜誌
书报杂志	書報雜誌
书面报告	書面報告
书面许可	書面許可
书面资料	書面資料
买臣复水	買臣覆水
买进对冲	買進對沖
乱世凶年	亂世凶年
乱了手脚	亂了手腳
乱作一团	亂作一團
乱成一团	亂成一團
乱极则平	亂極則平
乱棒胡敲	亂棒胡敲
乱首垢面	亂首垢面
乳液聚合	乳液聚合
乳臭未干	乳臭未乾
乳药求死	乳藥求死
了却此生	了卻此生
了如指掌	瞭如指掌
了当不得	了當不得
了无挂碍	了無掛礙
了无新意	了無新意
了无牵挂	了無牽掛
了无生机	了無生機
了无生趣	了無生趣
了无痕迹	了無痕蹟
了无罣碍	了無罣礙
了无长进	了無長進
了此残生	了此殘生
了然不惑	了然不惑
了然于心	瞭然於心
了若指掌	瞭若指掌
了解情况	了解情況
了身达命	了身達命
争先发言	爭先發言
争先恐后	爭先恐後
争奇斗妍	爭奇鬥妍
争奇斗异	爭奇鬥異
争奇斗艳	爭奇鬥豔
争妍斗奇	爭妍鬥奇
争妍斗胜	爭妍鬥勝
争妍斗艳	爭妍鬥豔
争强好胜	爭強好勝
争强斗胜	爭強鬥勝
争强显胜	爭強顯勝
争强赌胜	爭強賭勝
争斗不休	爭鬥不休
争相罗致	爭相羅致
争红斗紫	爭紅鬥紫
争胜要强	爭勝要強
事与愿违	事與願違
事出不意	事出不意
事出不测	事出不測
事出有因	事出有因
事前事后	事前事後
事发地点	事發地點
事后聪明	事後聰明
事态发展	事態發展
事情可干	事情可幹
事情好干	事情好幹
事情干脆	事情干脆
事成之后	事成之後
事有斗巧	事有鬥巧
事都干脆	事都干脆
二万七千	二萬七千
二万三千	二萬三千
二万九千	二萬九千
二万二千	二萬二千
二万五千	二萬五千
二万六千	二萬六千
二万四千	二萬四千
二不棱登	二不棱登
二人同心	二人同心
二出祁山	二出祁山
二十一万	二十一萬
二十七万	二十七萬
二十三万	二十三萬
二十二万	二十二萬
二十五万	二十五萬
二十八万	二十八萬
二十六万	二十六萬
二十几万	二十幾萬
二十几年	二十幾年
二十四万	二十四萬
二十多万	二十多萬
二十面体	二十面體
二十馀万	二十餘萬
二千多万	二千多萬
二堂舍子	二堂舍子
二拉八当	二拉八當
二次曲线	二次曲綫
二次曲面	二次曲面
二流人才	二流人才
二百多万	二百多萬
二缶钟惑	二缶鐘惑
二虎相斗	二虎相鬥
二表姊夫	二表姊夫
二进位制	二進位制
二进制码	二進制碼
二部合唱	二部合唱
二门不出	二門不出
于事无济	於事無濟
于事无补	於事無補
于今犹烈	於今猶烈
于余曲折	于餘曲折
于呼哀哉	於呼哀哉
于家为国	於家爲國
于尔里克	于爾里克
于心不安	於心不安
于心不忍	於心不忍
于心何忍	於心何忍
于心无愧	於心無愧
于斯塔德	于斯塔德
于斯达尔	于斯達爾
于斯達爾	于斯達爾
于民润国	於民潤國
于法无据	於法無據
于爾里克	于爾里克
于飞之乐	于飛之樂
于馀曲折	于餘曲折
亏本出售	虧本出售
云中白鹤	雲中白鶴
云仙杂记	雲仙雜記
云兴霞蔚	雲興霞蔚
云冈石佛	雲岡石佛
云冈石窟	雲岡石窟
云出无心	雲出無心
云南回变	雲南回變
云南白药	雲南白藥
云南起义	雲南起義
云南黄馨	雲南黃馨
云合雾集	雲合霧集
云天高谊	雲天高誼
云屯雨集	雲屯雨集
云山雾罩	雲山霧罩
云开见日	雲開見日
云形定规	雲形定規
云情雨意	雲情雨意
云收雨散	雲收雨散
云收雾散	雲收霧散
云散风流	雲散風流
云林工专	雲林工專
云梦大泽	雲夢大澤
云水道人	雲水道人
云泥之别	雲泥之別
云泥异路	雲泥異路
云消雨散	雲消雨散
云消雾散	雲消霧散
云淡风轻	雲淡風輕
云游四方	雲遊四方
云烟过眼	雲煙過眼
云程发轫	雲程發軔
云窗雾槛	雲窗霧檻
云笈七签	雲笈七籤
云笈七籤	雲笈七籤
云翻雨复	雲翻雨覆
云英未嫁	雲英未嫁
云蒸霞蔚	雲蒸霞蔚
云行雨施	雲行雨施
云谲波诡	雲譎波詭
云贵高原	雲貴高原
云起龙骧	雲起龍驤
云车风马	雲車風馬
云门舞集	雲門舞集
云阶月地	雲階月地
云雨之欢	雲雨之歡
云雨巫山	雲雨巫山
云雨高唐	雲雨高唐
云雾径迹	雲霧徑蹟
云霄飞车	雲霄飛車
云霓之望	雲霓之望
云麾勋章	雲麾勛章
云麾勳章	雲麾勳章
云龙风虎	雲龍風虎
互不干涉	互不干涉
互别苗头	互別苗頭
互动关系	互動關係
互助合作	互助合作
互有胜负	互有勝負
互相联系	互相聯繫
互致问候	互致問候
互蒙其利	互蒙其利
五七干校	五七幹校
五万三千	五萬三千
五万两千	五萬兩千
五万五千	五萬五千
五万八千	五萬八千
五世同堂	五世同堂
五代同堂	五代同堂
五倍子虫	五倍子蟲
五出祁山	五出祁山
五十五万	五十五萬
五十六万	五十六萬
五十多万	五十多萬
五千多万	五千多萬
五年计划	五年計劃
五彩夺目	五彩奪目
五彩宾纷	五彩賓紛
五彩缤纷	五彩繽紛
五斗折腰	五斗折腰
五斗米道	五斗米道
五斗解酲	五斗解酲
五浊恶世	五濁惡世
五百多万	五百多萬
五育并重	五育並重
五胡之乱	五胡之亂
五胡乱华	五胡亂華
五脏俱全	五臟俱全
五脏六腑	五臟六腑
五色祥云	五色祥雲
五行并下	五行並下
五行生克	五行生剋
五谷不分	五穀不分
五谷不升	五穀不升
五谷丰收	五穀豐收
五谷丰登	五穀豐登
五谷丰稔	五穀豐稔
五谷杂粮	五穀雜糧
五里雾中	五里霧中
五马分尸	五馬分屍
井干摧败	井榦摧敗
井田制度	井田制度
亚东关系	亞東關係
亚历山大	亞歷山大
亚当斯密	亞當斯密
亚洲周刊	亞洲周刊
亚洲杯女	亞洲杯女
亚洲杯室	亞洲杯室
亚里斯提	亞里斯提
亚雷克斯	亞雷克斯
亡国灭种	亡國滅種
交口称赞	交口稱讚
交响乐团	交響樂團
交差了事	交差了事
交战团体	交戰團體
交换价值	交換價值
交换技术	交換技術
交游广阔	交遊廣闊
交通号志	交通號誌
交通标志	交通標誌
交通管制	交通管制
亦庄亦谐	亦莊亦諧
产业后备	產業後備
产卵洄游	產卵洄游
产后检査	產後檢査
产品组合	產品組合
产地价格	產地價格
产学合作	產學合作
产销合一	產銷合一
产销合同	產銷合同
亨利克森	亨利克森
亭台楼榭	亭臺樓榭
亭台楼阁	亭臺樓閣
亲历其境	親歷其境
亲子关系	親子關係
亲子鉴定	親子鑑定
亲密关系	親密關係
亲属关系	親屬關係
亲戚关系	親戚關係
亲极反疏	親極反疏
亲痛仇快	親痛仇快
亲笔签名	親筆簽名
亲缘关系	親緣關係
亲自出马	親自出馬
亲自挂帅	親自掛帥
亲身经历	親身經歷
亹亹不卷	亹亹不卷
人中豪杰	人中豪傑
人云亦云	人云亦云
人众胜天	人眾勝天
人体彩绘	人體彩繪
人前人后	人前人後
人力回天	人力回天
人千人万	人千人萬
人口分布	人口分布
人各有志	人各有志
人同此心	人同此心
人困马乏	人困馬乏
人如其面	人如其面
人定胜天	人定勝天
人寿年丰	人壽年豐
人尽其才	人盡其才
人尽可夫	人盡可夫
人尽皆知	人盡皆知
人工冬眠	人工冬眠
人工心脏	人工心臟
人工阅卷	人工閱卷
人心不同	人心不同
人心向背	人心向背
人心如面	人心如面
人心所向	人心所向
人心涣漓	人心渙漓
人性本恶	人性本惡
人才出众	人才出眾
人才外流	人才外流
人才流失	人才流失
人才济济	人才濟濟
人才辈出	人才輩出
人才难得	人才難得
人无千日	人無千日
人机介面	人機介面
人机界面	人機界面
人权斗士	人權鬥士
人杰地灵	人傑地靈
人欲横流	人欲橫流
人民代表	人民代表
人民团体	人民團體
人民意志	人民意志
人流手术	人流手術
人浮于事	人浮於事
人浮于食	人浮於食
人海战术	人海戰術
人烟凑集	人煙湊集
人烟浩穰	人煙浩穰
人烟稀少	人煙稀少
人烟稠密	人煙稠密
人烟辐辏	人煙輻輳
人生价值	人生價值
人生舞台	人生舞臺
人神同愤	人神同憤
人种差别	人種差別
人穷志短	人窮志短
人肉搜索	人肉搜索
人赃俱获	人贓俱獲
人造纤维	人造纖維
人间烟火	人間煙火
人际关系	人際關係
人面兽心	人面獸心
人面桃花	人面桃花
人面狮身	人面獅身
人饥己饥	人飢己飢
亿万富翁	億萬富翁
亿万富豪	億萬富豪
亿万斯年	億萬斯年
什锦炒面	什錦炒麵
仁人志士	仁人志士
仁心仁术	仁心仁術
仁至义尽	仁至義盡
仅作参考	僅作參考
仅供参考	僅供參考
仆仆风尘	僕僕風塵
仆僮成羣	僕僮成羣
仆固怀恩	僕固懷恩
仆虽罢驽	僕雖罷駑
仇外心理	仇外心理
仇恨罪行	仇恨罪行
介于两难	介於兩難
介绍出来	介紹出來
从上向下	從上向下
从下向上	從下向上
从今以后	從今以後
从外向內	從外向內
从宽发落	從寬發落
从属关系	從屬關係
从心所欲	從心所欲
从此以后	從此以後
从此往后	從此往後
从轻发落	從輕發落
从里到外	從裏到外
从里向外	從裏向外
仑琴射线	侖琴射綫
仓皇出逃	倉皇出逃
他不干渴	他不乾渴
仙女星系	仙女星系
代数几何	代數幾何
代数曲线	代數曲綫
代数曲面	代數曲面
代表人物	代表人物
代表大会	代表大會
令人发指	令人髮指
令人注目	令人注目
令出如山	令出如山
令出必行	令出必行
令出惟行	令出惟行
以一当十	以一當十
以一持万	以一持萬
以一知万	以一知萬
以一驭万	以一馭萬
以人为鉴	以人爲鑑
以价制量	以價制量
以众克寡	以眾克寡
以免借口	以免藉口
以冰致蝇	以冰致蠅
以功复过	以功覆過
以升量石	以升量石
以华制华	以華制華
以古为鉴	以古爲鑑
以售其奸	以售其奸
以多胜少	以多勝少
以夷制夷	以夷制夷
以少克众	以少克眾
以少胜多	以少勝多
以弱制强	以弱制強
以弱胜强	以弱勝強
以往鉴来	以往鑑來
以意逆志	以意逆志
以智取胜	以智取勝
以暴制暴	以暴制暴
以柔克刚	以柔克剛
以柔制刚	以柔制剛
以泪洗面	以淚洗面
以点带面	以點帶面
以药养医	以藥養醫
以莛叩钟	以莛叩鐘
以莛撞钟	以莛撞鐘
以蜡代薪	以蠟代薪
以观后效	以觀後效
以貍致鼠	以貍致鼠
以防万一	以防萬一
以静制动	以靜制動
仪态万千	儀態萬千
仪态万方	儀態萬方
仪表出众	儀表出眾
仪表堂堂	儀表堂堂
仰之弥高	仰之彌高
仰给于人	仰給於人
价值冲突	價值衝突
价值判断	價值判斷
价值增殖	價值增殖
价值尺度	價值尺度
价值工程	價值工程
价值形式	價值形式
价值指标	價值指標
价值标准	價值標準
价值观念	價值觀念
价值规律	價值規律
价值连城	價值連城
价值逻辑	價值邏輯
价廉物美	價廉物美
价格冻结	價格凍結
价格标签	價格標籤
价格范围	價格範圍
任人摆布	任人擺佈
任何表演	任何表演
任何表示	任何表示
任何表达	任何表達
任何表達	任何表達
任何钟表	任何鐘錶
任由摆布	任由擺佈
任笔沈诗	任筆沈詩
任重致远	任重致遠
企业集团	企業集團
伊于湖底	伊于湖底
伊于胡底	伊于胡底
伊塞克湖	伊塞克湖
伊布拉欣	伊布拉欣
伊拉克人	伊拉克人
伊拉克籍	伊拉克籍
伊拉克队	伊拉克隊
伊斯兰党	伊斯蘭黨
伊斯兰历	伊斯蘭曆
伊於胡底	伊于胡底
伊犁纵谷	伊犁縱谷
伊莱克斯	伊萊克斯
伊里格瑞	伊裏格瑞
伍员鞭尸	伍員鞭屍
伍德合金	伍德合金
伏尸流血	伏屍流血
伏尸遍野	伏屍遍野
伐异党同	伐異黨同
伐罪吊民	伐罪弔民
休戚与共	休戚與共
休戚相关	休戚相關
休杰克曼	休傑克曼
休闲活动	休閒活動
众口同声	眾口同聲
众口熏天	眾口熏天
众志成城	眾志成城
众所周知	眾所周知
优先发展	優先發展
优哉游哉	優哉遊哉
优惠价格	優惠價格
优游不迫	優遊不迫
优游自在	優遊自在
优游自得	優遊自得
优胜劣败	優勝劣敗
伙同一气	夥同一氣
会上签署	會上簽署
会上签订	會上簽訂
会合周期	會合周期
会签制度	會簽制度
会计分录	會計分錄
会计制度	會計制度
会计报表	會計報表
会计标准	會計標準
会议记录	會議記錄
会逢其适	會逢其適
传出神经	傳出神經
传动系统	傳動系統
传播出去	傳播出去
传播学系	傳播學系
传杯弄盏	傳杯弄盞
传杯换盏	傳杯換盞
传杯送盏	傳杯送盞
传热系数	傳熱係數
传真发送	傳真發送
传统医药	傳統醫藥
传输技术	傳輸技術
传输控制	傳輸控制
传达出来	傳達出來
传递出去	傳遞出去
传闻证据	傳聞證據
传颂千古	傳頌千古
伤亡枕借	傷亡枕藉
伤口发炎	傷口發炎
伤寒杆菌	傷寒桿菌
伤心欲绝	傷心欲絕
伤心致死	傷心致死
伤痕累累	傷痕累累
伦理规范	倫理規範
伯克制度	伯克制度
伯里克利	伯里克利
伯雍种玉	伯雍種玉
伸出援手	伸出援手
伸展出去	伸展出去
似松实紧	似鬆實緊
佃租制度	佃租制度
但愿如此	但願如此
但求如愿	但求如願
位极人臣	位極人臣
低价买进	低價買進
低价卖出	低價賣出
低价高报	低價高報
低卡路里	低卡路里
低合金钢	低合金鋼
低回不已	低迴不已
低筋面粉	低筋麵粉
住宅凶方	住宅兇方
佐饔得尝	佐饔得嘗
体坛人士	體壇人士
体物写志	體物寫志
体育锻炼	體育鍛煉
体胀系数	體脹係數
体面起来	體面起來
何以克当	何以克當
何必当初	何必當初
何济于事	何濟於事
何至于此	何至於此
何足挂齿	何足掛齒
余勇可贾	餘勇可賈
余响绕梁	餘響繞梁
余子碌碌	餘子碌碌
余情未了	餘情未了
余数定理	餘數定理
余波荡漾	餘波盪漾
余留事务	餘留事務
余音绕梁	餘音繞梁
佛兰克林	佛蘭克林
佛前佛后	佛前佛後
佛尼亚克	佛尼亞克
佛罗棱萨	佛羅棱薩
佛罗里达	佛羅里達
佛蒙特州	佛蒙特州
佛里特曼	佛里特曼
作业平台	作業平臺
作业系统	作業系統
作出让步	作出讓步
作奸犯科	作奸犯科
作好准备	作好準備
作恶多端	作惡多端
作育英才	作育英才
作舍道旁	作舍道旁
作舍道边	作舍道邊
你夸我逞	你誇我逞
你干一杯	你乾一杯
你干那杯	你乾那杯
你斗了胆	你斗了膽
你是为了	你是爲了
佣中佼佼	傭中佼佼
佣金收益	佣金收益
佣金费用	佣金費用
佩脱拉克	佩脫拉克
佳人才子	佳人才子
使心作幸	使心作倖
使用价值	使用價值
使用借贷	使用借貸
使用范围	使用範圍
侔德复载	侔德覆載
供大于求	供大於求
供暖系统	供暖系統
供水系统	供水系統
供油系统	供油系統
供电系统	供電系統
供过于求	供過於求
供销合作	供銷合作
依从关系	依從關係
依依不舍	依依不捨
依依难舍	依依難捨
依头缕当	依頭縷當
依存关系	依存關係
依法炮制	依法炮製
侠气干云	俠氣干雲
侥天之幸	僥天之悻
侥幸取胜	僥倖取勝
侥幸获胜	僥倖獲勝
侦讯笔录	偵訊筆錄
侨选代表	僑選代表
侵蚀基准	侵蝕基準
俄罗斯党	俄羅斯黨
俊眼修眉	俊眼修眉
俏丽短发	俏麗短髮
保丽龙板	保麗龍板
保护状制	保護狀制
保护范围	保護範圍
保持克制	保持克制
保持联系	保持聯繫
保甲制度	保甲制度
保留价格	保留價格
保留征收	保留徵收
保留曲线	保留曲綫
保税工厂	保稅工廠
保结制度	保結制度
保证价格	保證價格
保险范围	保險範圍
保障范围	保障範圍
信义计划	信義計劃
信口开合	信口開合
信口胡说	信口胡說
信号系统	信號系統
信嘴胡说	信嘴胡說
信息技术	信息技術
信息系统	信息系統
信托公司	信託公司
信托贸易	信托貿易
信步闲游	信步閒遊
信用合作	信用合作
信笔涂鸦	信筆塗鴉
信而有征	信而有徵
信马游缰	信馬游繮
俭确之教	儉确之教
修业年限	修業年限
修业期满	修業期滿
修五脏庙	修五臟廟
修修补补	修修補補
修心养性	修心養性
修文偃武	修文偃武
修旧利废	修舊利廢
修桥舖路	修橋舖路
修桥补路	修橋補路
修正主义	修正主義
修母画荻	修母畫荻
修炼成仙	修煉成仙
修理起来	修理起來
修筑公路	修築公路
修筑工事	修築工事
修筑工程	修築工程
修筑道路	修築道路
修置产室	修置產室
修订历史	修訂歷史
修谨以俟	修謹以俟
修身养性	修身養性
修身齐家	修身齊家
修饰边幅	修飾邊幅
俯首就范	俯首就範
俱收并蓄	俱收並蓄
俾资挹注	俾資挹注
倍日并行	倍日並行
倒了架子	倒了架子
倒八字须	倒八字鬚
倒前倒后	倒前倒後
倒吊蜡烛	倒吊蠟燭
倒屣奔出	倒屣奔出
倒悬挨命	倒懸捱命
倒扣针儿	倒扣針兒
倒持干戈	倒持干戈
倒挂金钩	倒掛金鉤
倒竖虎须	倒豎虎鬚
倒绷孩儿	倒繃孩兒
倒置干戈	倒置干戈
倒载干戈	倒載干戈
倚儿不当	倚兒不當
倚多为胜	倚多爲勝
倚马千言	倚馬千言
借交报仇	借交報仇
借债度日	借債度日
借刀杀人	借刀殺人
借剑杀人	借劍殺人
借古喻今	借古喻今
借古讽今	借古諷今
借听于聋	借聽於聾
借客报仇	借客報仇
借宿一夜	借宿一夜
借宿一晚	借宿一晚
借尸还魂	借屍還魂
借手除敌	借手除敵
借故推辞	藉故推辭
借方差额	借方差額
借来借去	借來借去
借此机会	藉此機會
借水推船	借水推船
借水行舟	借水行舟
借看一下	借看一下
借端生事	藉端生事
借箸代筹	藉箸代籌
借箸代谋	借箸代謀
借腹生子	借腹生子
借花献佛	借花獻佛
借茶活捉	借茶活捉
借草枕块	藉草枕塊
借贷无门	借貸無門
借贷资本	借貸資本
借资挹注	借資挹注
借过一下	借過一下
借酒浇愁	借酒澆愁
借酒装疯	借酒裝瘋
借题发挥	借題發揮
借风使船	借風使船
倡条冶叶	倡條冶葉
倦鸟余花	倦鳥餘花
债台高筑	債臺高築
值回票价	值回票價
值得一干	值得一幹
值得庆幸	值得慶幸
值得注意	值得注意
值得称赞	值得稱讚
倾复重器	傾覆重器
倾家尽产	傾家盡產
倾家荡产	傾家蕩產
倾巢出动	傾巢出動
倾巢而出	傾巢而出
倾箱倒柜	傾箱倒櫃
倾耳注目	傾耳注目
倾诉衷曲	傾訴衷曲
偃武修文	偃武修文
偃蹇困穷	偃蹇困窮
假力于人	假力於人
假意周旋	假意周旋
偎干就湿	偎乾就濕
偏极光镜	偏極光鏡
做出事来	做出事來
做出好戏	做齣好戲
做好做恶	做好做惡
做张做致	做張做致
停云慢步	停雲慢步
停云落月	停雲落月
停停当当	停停當當
停板制度	停板制度
偶发事件	偶發事件
偷合取容	偷合取容
偷合苟容	偷合苟容
偷尝禁果	偷嚐禁果
偷期暗会	偷期暗會
偷梁换柱	偷樑換柱
偷鸡吊狗	偷雞吊狗
偿得夙愿	償得夙願
傅粉施朱	傅粉施朱
傅说版筑	傅說版築
傍个影儿	傍個影兒
傢伙座儿	傢伙座兒
储备干部	儲備幹部
储训人才	儲訓人才
储训干部	儲訓幹部
傲世轻才	傲世輕才
傲睨万物	傲睨萬物
傲霜斗雪	傲霜鬥雪
傻大个儿	傻大個兒
傻里傻气	傻里傻氣
僮手指千	僮手指千
僵尸网络	僵屍網絡
僵持不下	僵持不下
僵李代桃	僵李代桃
儒略历史	儒略歷史
元恶大奸	元惡大奸
元恶大憝	元惡大憝
充斥市面	充斥市面
充类至尽	充類至盡
充饥止渴	充飢止渴
充饥画饼	充飢畫餅
先义后利	先義後利
先了一步	先了一步
先人后己	先人後己
先公后私	先公後私
先发制人	先發制人
先发投手	先發投手
先后倒置	先後倒置
先后顺序	先後順序
先声后实	先聲後實
先守后攻	先守後攻
先干为敬	先乾爲敬
先忧后乐	先憂後樂
先意承志	先意承志
先攻后守	先攻後守
先斩后奏	先斬後奏
先斩后闻	先斬後聞
先期录音	先期錄音
先来后上	先來後上
先来后下	先來後下
先来后到	先來後到
先盛后衰	先盛後衰
先礼后兵	先禮後兵
先缺后空	先缺後空
先花后果	先花後果
先苦后甘	先苦後甘
先行后闻	先行後聞
先赢后输	先贏後輸
先进先出	先進先出
先进后出	先進後出
先难后获	先難後獲
先驱新党	先驅新黨
光二极管	光二極管
光光荡荡	光光蕩蕩
光前绝后	光前絕後
光前耀后	光前耀後
光前裕后	光前裕後
光发送器	光發送器
光可鉴人	光可鑑人
光合作用	光合作用
光合细菌	光合細菌
光圈范围	光圈範圍
光复南路	光復南路
光复国土	光復國土
光复国小	光復國小
光复旧京	光復舊京
光复旧物	光復舊物
光学录音	光學錄音
光学系统	光學系統
光导纤维	光導纖維
光彩夺目	光彩奪目
光彩耀眼	光彩耀眼
光彩起来	光彩起來
光杆司令	光桿司令
光焰万丈	光焰萬丈
光电二极	光電二極
光碟杂志	光碟雜誌
光纤接口	光纖接口
光纤电缆	光纖電纜
光纤衰减	光纖衰減
光纤通信	光纖通信
光纤通讯	光纖通訊
光纤飞弹	光纖飛彈
光能合成	光能合成
光芒万丈	光芒萬丈
光辉典范	光輝典範
克丝钳子	克絲鉗子
克什克腾	克什克騰
克什米尔	克什米爾
克仑特罗	克侖特羅
克伦威尔	克倫威爾
克俭克勤	克儉克勤
克兰达尔	克蘭達爾
克利夫兰	克利夫蘭
克利斯提	克利斯提
克利福洛	克利福洛
克制不了	剋制不了
克制不住	剋制不住
克劳修斯	克勞修斯
克劳福德	克勞福德
克劳芙特	克勞芙特
克勒拉省	克勒拉省
克勤克俭	克勤克儉
克基拉岛	克基拉島
克孜勒苏	克孜勒蘇
克尽厥职	克盡厥職
克尽夫道	克盡夫道
克尽妇道	克盡婦道
克尽己职	克盡己職
克己主义	克己主義
克己复礼	克己復禮
克己奉公	克己奉公
克希荷夫	克希荷夫
克当一面	克當一面
克拉夫特	克拉夫特
克拉玛依	克拉瑪依
克拉科夫	克拉科夫
克敌制胜	克敵制勝
克敦孝行	克敦孝行
克服不了	克服不了
克服困难	克服困難
克朗代克	克朗代克
克来汀症	克來汀症
克林斯曼	克林斯曼
克林霉素	克林黴素
克瑞斯波	克瑞斯波
克绍箕裘	克紹箕裘
克绳祖武	克繩祖武
克罗地亚	克羅地亞
克罗恩科	克羅恩科
克罗诺斯	克羅諾斯
克苦耐劳	克苦耐勞
克莉丝汀	克莉絲汀
克莉兰柯	克莉蘭柯
克莉芭丝	克莉芭絲
克莱斯勒	克萊斯勒
克莱査克	克萊査克
克莱蒙特	克萊蒙特
克莱门斯	克萊門斯
克萨斯州	克薩斯州
克里夫兰	克里夫蘭
克里契科	克里契科
克里姆林	克里姆林
克里斯托	克里斯托
克里斯普	克里斯普
克里斯汀	克里斯汀
克里普斯	克里普斯
克里特克	克里特克
克里特岛	克里特島
克里米亚	克里米亞
克里蒙梭	克里蒙梭
克里门特	克里門特
克隆技术	克隆技術
克隆斯台	克隆斯臺
克隆氏病	克隆氏病
克难运动	克難運動
克雅氏症	克雅氏症
克雷姆凯	克雷姆凱
克雷尼尔	克雷尼爾
克雷斯吉	克雷斯吉
克雷门斯	克雷門斯
克顺克卑	克順克卑
克鲁伦河	克魯倫河
克鲁克斯	克魯克斯
克鲁斯州	克魯斯州
克麦洛伏	克麥洛伏
免疫系统	免疫系統
免试升学	免試升學
兔尽狗烹	兔盡狗烹
党內人士	黨內人士
党內初选	黨內初選
党內斗争	黨內鬥爭
党同伐异	黨同伐異
党员大会	黨員大會
党国元老	黨國元老
党外人士	黨外人士
党委书记	黨委書記
党政机关	黨政機關
党派集会	黨派集會
党的基本	黨的基本
党纪国法	黨紀國法
党锢之祸	黨錮之禍
入不支出	入不支出
入不敷出	入不敷出
入主出奴	入主出奴
入伍须知	入伍須知
入境签证	入境簽證
入室升堂	入室升堂
內外交困	內外交困
內外姻党	內外姻黨
內外并重	內外並重
內布拉斯	內布拉斯
內掌柜的	內掌櫃的
內科手术	內科手術
內部联系	內部聯繫
全体同仁	全體同仁
全党全军	全黨全軍
全党同志	全黨同志
全军复没	全軍覆沒
全军复灭	全軍覆滅
全国同胞	全國同胞
全国纪录	全國紀錄
全国范围	全國範圍
全场一致	全場一致
全所同仁	全所同仁
全无准备	全無準備
全权代表	全權代表
全校同学	全校同學
全然不同	全然不同
全班同学	全班同學
全球范围	全球範圍
全盘托出	全盤托出
全神灌注	全神灌注
全神贯注	全神貫注
全程参加	全程參加
全线出击	全綫出擊
全胜记录	全勝記錄
全面包围	全面包圍
全面包裹	全面包裹
全面发展	全面發展
全面实施	全面實施
全面战争	全面戰爭
全面禁止	全面禁止
全面规划	全面規劃
全面进行	全面進行
八万一千	八萬一千
八出祁山	八出祁山
八十五万	八十五萬
八十种好	八十種好
八千子弟	八千子弟
八大胡同	八大胡同
八字方针	八字方針
八字胡须	八字鬍鬚
八小时制	八小時制
八斗之才	八斗之才
八斗陈思	八斗陳思
八旗制度	八旗制度
八步周行	八步周行
八珍咸粥	八珍鹹粥
八百多万	八百多萬
八面受敌	八面受敵
八面圆通	八面圓通
八面威风	八面威風
八面玲珑	八面玲瓏
八面见光	八面見光
公之于众	公之於眾
公众参与	公眾參與
公共关系	公共關係
公共团体	公共團體
公共支出	公共支出
公制单位	公制單位
公同共有	公同共有
公听并观	公聽並觀
公告价格	公告價格
公告地价	公告地價
公孙大娘	公孫大娘
公定价格	公定價格
公布于众	公佈於眾
公布出来	公佈出來
公平合理	公平合理
公广集团	公廣集團
公开出来	公開出來
公开场合	公開場合
公才公望	公才公望
公报私仇	公報私仇
公方代表	公方代表
公民表决	公民表決
公然表示	公然表示
公用征收	公用徵收
公用限制	公用限制
公益彩券	公益彩券
公私两尽	公私兩盡
公私合营	公私合營
公羊春秋	公羊春秋
公诸于世	公諸於世
公诸同好	公諸同好
公门修行	公門修行
六万五千	六萬五千
六万八千	六萬八千
六出奇计	六出奇計
六出祁山	六出祁山
六十一万	六十一萬
六十三万	六十三萬
六十五万	六十五萬
六十八万	六十八萬
六十四万	六十四萬
六十多万	六十多萬
六十种曲	六十種曲
六千两百	六千兩百
六千多万	六千多萬
六合八法	六合八法
六合拳谱	六合拳譜
六度万行	六度萬行
六才子书	六才子書
六百多万	六百多萬
六祖坛经	六祖壇經
六通四辟	六通四辟
六道轮回	六道輪迴
兰台令史	蘭臺令史
兰台公子	蘭臺公子
兰台石室	蘭臺石室
兰摧玉折	蘭摧玉折
兰摧蕙折	蘭摧蕙折
兰艾同烬	蘭艾同燼
兰艾同焚	蘭艾同焚
共产党人	共產黨人
共产党员	共產黨員
共产集团	共產集團
共享计划	共享計劃
共发射极	共發射極
共同代理	共同代理
共同代表	共同代表
共同企业	共同企業
共同保证	共同保證
共同利益	共同利益
共同努力	共同努力
共同基金	共同基金
共同市场	共同市場
共同感觉	共同感覺
共同正犯	共同正犯
共同海损	共同海損
共同科目	共同科目
共同筛选	共同篩選
共同管道	共同管道
共同纲领	共同綱領
共同经营	共同經營
共同继承	共同繼承
共同诉讼	共同訴訟
共同财产	共同財產
共同趋向	共同趨向
共同运销	共同運銷
共和党人	共和黨人
共和党籍	共和黨籍
共和历史	共和歷史
共审制度	共審制度
共御外侮	共禦外侮
共挽鹿车	共挽鹿車
共轭复数	共軛複數
共通意志	共通意志
关了钉儿	關了釘兒
关山万里	關山萬里
关税同盟	關稅同盟
关系企业	關係企業
关系命题	關係命題
关系密切	關係密切
关系融洽	關係融洽
关系运算	關係運算
兴云作雨	興雲作雨
兴云作雾	興雲作霧
兴云吐雾	興雲吐霧
兴云布雨	興雲布雨
兴云致雨	興雲致雨
兴会淋漓	興會淋漓
兴复不浅	興復不淺
兴尽悲来	興盡悲來
兴尽意阑	興盡意闌
兴旺发达	興旺發達
兴致勃勃	興致勃勃
兴致勃发	興致勃發
兴致盎然	興致盎然
兴致索然	興致索然
兴隆台区	興隆臺區
兴高彩烈	興高彩烈
兴高采烈	興高采烈
兵出无名	兵出無名
兵尽器竭	兵盡器竭
兵尽矢穷	兵盡矢窮
兵工厂队	兵工廠隊
兵疲马困	兵疲馬困
其从如云	其從如雲
其他支出	其他支出
其八九只	其八九只
其势凶凶	其勢兇兇
其次辟地	其次辟地
具体计划	具體計劃
典型示范	典型示範
典章制度	典章制度
典范长存	典範長存
养兵千日	養兵千日
养军千日	養軍千日
养性修真	養性修真
养颜有术	養顏有術
兼容并包	兼容並包
兼容并蓄	兼容並蓄
兼收并蓄	兼收並蓄
兼筹并顾	兼籌並顧
兽心人面	獸心人面
兽性大发	獸性大發
内在几何	內在幾何
内忧外困	內憂外困
内松外紧	內鬆外緊
内紧外松	內緊外鬆
内细胞团	內細胞團
内部斗争	內部鬥爭
内面包的	內面包的
冉冉上升	冉冉上升
再借不难	再借不難
再干一杯	再乾一杯
再斗一斗	再鬥一鬥
再来一个	再來一個
再生制动	再生制動
再生纤维	再生纖維
再造手术	再造手術
再长爹娘	再長爹孃
冒儿咕冬	冒兒咕冬
冒烟突火	冒煙突火
冒镝当锋	冒鏑當鋒
军事管制	軍事管制
军团杆菌	軍團桿菌
军团菌病	軍團菌病
军政当局	軍政當局
军民合作	軍民合作
军阀割据	軍閥割據
军队克制	軍隊剋制
农业合作	農業合作
农业技术	農業技術
农历新年	農曆新年
农地重划	農地重劃
农奴制度	農奴制度
农家品种	農家品種
农民历史	農民歷史
农民团体	農民團體
冠世之才	冠世之才
冠盖云集	冠蓋雲集
冠盖如云	冠蓋如雲
冬令救济	冬令救濟
冬令进补	冬令進補
冬季世界	冬季世界
冬季作物	冬季作物
冬季运动	冬季運動
冬扇夏炉	冬扇夏爐
冬日可爱	冬日可愛
冬暖夏凉	冬暖夏涼
冬温夏凊	冬溫夏凊
冬烘先生	冬烘先生
冬虫夏草	冬蟲夏草
冯虚御风	馮虛御風
冰上表演	冰上表演
冰前刮雪	冰前颳雪
冰壶秋月	冰壺秋月
冰壸秋月	冰壺秋月
冰雪皇后	冰雪皇后
冲冠发怒	衝冠髮怒
冲决堤防	沖決堤防
冲出重围	衝出重圍
冲击韧性	衝擊韌性
冲劲十足	衝勁十足
冲口而出	衝口而出
冲口而发	衝口而發
冲在最前	衝在最前
冲坚陷阵	衝堅陷陣
冲天之怒	沖天之怒
冲州撞府	衝州撞府
冲昏头脑	衝昏頭腦
冲来冲去	衝來衝去
冲波激浪	衝波激浪
冲波逆折	衝波逆折
冲洗照片	沖洗照片
冲积平原	沖積平原
冲绳群岛	沖繩羣島
冲虚真人	沖虛真人
冲虚真经	沖虛真經
冲锋陷阵	衝鋒陷陣
冲霄汉外	沖霄漢外
决策千里	決策千里
决策当局	決策當局
决胜千里	決勝千里
冶叶倡条	冶葉倡條
冷心冷面	冷心冷面
冷战以后	冷戰以後
冷淡关系	冷淡關係
冷轧钢板	冷軋鋼板
冷面冷心	冷面冷心
净心修身	凈心修身
准不准他	准不准他
准不准你	准不准你
准不准备	準不準備
准不准她	准不准她
准不准它	准不准它
准不准我	准不准我
准不准确	準不準確
准不准许	准不准許
准不准谁	准不准誰
准备充分	準備充分
准备准备	準備準備
准备好了	準備好了
准备好的	準備好的
准备活动	準備活動
准备金率	準備金率
准时出席	準時出席
准时到达	準時到達
准确无误	準確無誤
准错不了	準錯不了
凉了半截	涼了半截
凌云健笔	凌雲健筆
凌云壮志	凌雲壯志
减价出售	減價出售
减价时间	減價時間
凑不出来	湊不出來
凑四合六	湊四合六
几为所害	幾爲所害
几乎完全	幾乎完全
几乎没有	幾乎沒有
几何光学	幾何光學
几何原本	幾何原本
几何图形	幾何圖形
几何图案	幾何圖案
几何拓扑	幾何拓撲
几何级数	幾何級數
几內亚湾	幾內亞灣
几内亚湾	幾內亞灣
几净窗明	几淨窗明
几几乎乎	幾幾乎乎
几分之几	幾分之幾
几分收获	幾分收穫
几可乱真	幾可亂真
几家欢乐	幾家歡樂
几年几班	幾年幾班
几度春风	幾度春風
几斤几两	幾斤幾兩
几案之才	几案之才
几次三番	幾次三番
凡此种种	凡此種種
凤凰于蜚	鳳凰于蜚
凤凰于飞	鳳凰于飛
凤去台空	鳳去臺空
凤皇于蜚	鳳皇于蜚
凭媒说合	憑媒說合
凭空出现	憑空出現
凭虚御风	憑虛御風
凯迪拉克	凱迪拉克
凶凶恶恶	兇兇惡惡
凶凶狠狠	兇兇狠狠
凶多吉少	凶多吉少
凶年饥岁	凶年饑歲
凶相毕露	兇相畢露
凶神恶煞	凶神惡煞
凶神附体	凶神附體
凶终隙末	凶終隙末
凸多面体	凸多面體
凸显出来	凸顯出來
凸板印刷	凸板印刷
凸面部分	凸面部分
凹凸有致	凹凸有致
出一回神	出一回神
出丑扬疾	出醜揚疾
出丑狼借	出醜狼藉
出乎寻常	出乎尋常
出乎意外	出乎意外
出乎意料	出乎意料
出乎预料	出乎預料
出乖弄丑	出乖弄醜
出乖露丑	出乖露醜
出人头地	出人頭地
出人意外	出人意外
出人意料	出人意料
出人意表	出人意表
出伦之才	出倫之才
出入将相	出入將相
出入平安	出入平安
出入相随	出入相隨
出其不备	出其不備
出其不意	出其不意
出其东门	出其東門
出出进进	出出進進
出卖灵魂	出賣靈魂
出厂价格	出廠價格
出双入对	出雙入對
出口产品	出口產品
出口伤人	出口傷人
出口入耳	出口入耳
出口商品	出口商品
出口导向	出口導向
出口成章	出口成章
出口调查	出口調査
出口贸易	出口貿易
出售一空	出售一空
出土文物	出土文物
出埃及记	出埃及記
出境检查	出境檢査
出境签证	出境簽證
出头之日	出頭之日
出头日子	出頭日子
出头露角	出頭露角
出头露面	出頭露面
出奇不意	出奇不意
出奇制胜	出奇制勝
出将入相	出將入相
出尔反尔	出爾反爾
出师不利	出師不利
出庭作证	出庭作證
出庭应讯	出庭應訊
出手得卢	出手得盧
出有入无	出有入無
出此下策	出此下策
出死入生	出死入生
出水伙计	出水夥計
出水芙蓉	出水芙蓉
出没不定	出沒不定
出没无常	出沒無常
出海打鱼	出海打魚
出海捕鱼	出海捕魚
出港大厅	出港大廳
出版业务	出版業務
出版品奖	出版品獎
出版地缺	出版地缺
出版日期	出版日期
出版期缺	出版期缺
出版自由	出版自由
出现意外	出現意外
出生入死	出生入死
出生地点	出生地點
出生日期	出生日期
出生缺陷	出生缺陷
出生证明	出生證明
出示证件	出示證件
出神入化	出神入化
出租汽车	出租汽車
出类拔羣	出類拔羣
出类拔萃	出類拔萃
出类超羣	出類超羣
出纳系统	出納系統
出羣拔萃	出羣拔萃
出自娘胎	出自孃胎
出自肺腑	出自肺腑
出臭子儿	出臭子兒
出芽生殖	出芽生殖
出血筒子	出血筒子
出言不逊	出言不遜
出言成章	出言成章
出言无状	出言無狀
出言有序	出言有序
出警入跸	出警入蹕
出谋划策	出謀劃策
出谋献策	出謀獻策
出谷迁乔	出谷遷喬
出轨行为	出軌行爲
出钱出力	出錢出力
出错信息	出錯信息
出门在外	出門在外
出阁之喜	出閣之喜
出陈布新	出陳布新
出马上场	出馬上場
出马上阵	出馬上陣
出鬼入神	出鬼入神
击钟陈鼎	擊鐘陳鼎
击钟鼎食	擊鐘鼎食
凿凿有据	鑿鑿有據
凿壁悬梁	鑿壁懸梁
刀割针扎	刀割針扎
刀耕火种	刀耕火種
分一杯羹	分一杯羹
分久必合	分久必合
分分合合	分分合合
分别部居	分別部居
分厘毫丝	分釐毫絲
分天之仇	分天之仇
分工合作	分工合作
分工整合	分工整合
分布学习	分布學習
分布控制	分佈控制
分布范围	分布範圍
分形几何	分形幾何
分形同气	分形同氣
分我杯羹	分我杯羹
分散注意	分散注意
分数挂帅	分數掛帥
分时系统	分時系統
分权制衡	分權制衡
分析出来	分析出來
分泌系统	分泌系統
分离出来	分離出來
分类目录	分類目錄
分行布白	分行布白
分身乏术	分身乏術
分辨出来	分辨出來
分辨善恶	分辨善惡
分进合击	分進合擊
分门别类	分門別類
切合实际	切合實際
切合需要	切合需要
切向速度	切向速度
切骨之仇	切骨之仇
划一不二	劃一不二
划下道来	劃下道來
划了一会	划了一會
划到江心	划到江心
划单人艇	划單人艇
划圆防守	劃圓防守
划地为王	劃地爲王
划地自限	劃地自限
划拨帐号	劃撥帳號
划来划去	劃來劃去
划清界线	劃清界綫
划清界限	劃清界限
划线支票	劃綫支票
刖足适屦	刖足適屨
刖趾适屦	刖趾適屨
列克星顿	列克星頓
列别杰夫	列別傑夫
列印出来	列印出來
列席代表	列席代表
刚才一载	剛纔一載
刚板硬正	剛板硬正
刚柔并济	剛柔並濟
创价学会	創價學會
创造出来	創造出來
初出茅庐	初出茅廬
初发芙蓉	初發芙蓉
初唐四杰	初唐四傑
初次见面	初次見面
初级关系	初級關係
初级团体	初級團體
初露才华	初露才華
判然不合	判然不合
判若云泥	判若雲泥
利古里亚	利古里亞
利多于弊	利多於弊
利多出尽	利多出盡
利字当头	利字當頭
利害关系	利害關係
利害冲突	利害衝突
利弊参半	利弊參半
利息支出	利息支出
利析秋毫	利析秋毫
利欲熏心	利慾薰心
利欲薰心	利慾薰心
利比里亚	利比里亞
利用价值	利用價值
利用系数	利用係數
利益团体	利益團體
利益集团	利益集團
利空出尽	利空出盡
利纳克斯	利納克斯
利默里克	利默里克
别作一眼	別作一眼
别具一格	別具一格
别具匠心	別具匠心
别具只眼	別具隻眼
别具慧眼	別具慧眼
别具炉锤	別具爐錘
别具肺肠	別具肺腸
别出心裁	別出心裁
别出新裁	別出新裁
别出机杼	別出機杼
别创新格	別創新格
别别扭扭	彆彆扭扭
别后寒温	別後寒溫
别太客气	別太客氣
别宫祭江	別宮祭江
别开生面	別開生面
别开蹊径	別開蹊徑
别情依依	別情依依
别无他法	別無他法
别无他物	別無他物
别无他用	別無他用
别无分号	別無分號
别无选择	別無選擇
别无长物	別無長物
别有天地	別有天地
别有居心	別有居心
别有所指	別有所指
别有洞天	別有洞天
别有用心	別有用心
别有用意	別有用意
别有肺肠	別有肺腸
别有韵味	別有韻味
别有风味	別有風味
别来无恙	別來無恙
别树一帜	別樹一幟
别树一旗	別樹一旗
别树一格	別樹一格
别生枝节	別生枝節
别致有趣	別致有趣
别裁伪体	別裁僞體
别识别见	別識別見
别辟蹊径	別闢蹊徑
别辟门户	別闢門戶
别风淮雨	別風淮雨
别鹤孤鸾	別鶴孤鸞
别鹤离鸾	別鶴離鸞
刬恶除奸	剗惡除奸
刮刮匝匝	刮刮匝匝
刮刮杂杂	刮刮雜雜
刮刮而谈	刮刮而談
刮垢磨光	刮垢磨光
刮搭板儿	刮搭板兒
刮来刮去	刮來刮去
刮目相待	刮目相待
刮目相看	刮目相看
刮肠洗胃	刮腸洗胃
刮骨去毒	刮骨去毒
刮骨疗毒	刮骨療毒
到岸价格	到岸價格
到此一游	到此一遊
到达签证	到達簽證
制作出来	製作出來
制动因子	制動因子
制动火箭	制動火箭
制动踏板	制動踏板
制压射击	制壓射擊
制定出来	制定出來
制宪会议	制憲會議
制敌机先	制敵機先
制服警察	制服警察
制礼作乐	制禮作樂
制约刺激	制約刺激
制约反应	制約反應
制胜之道	制勝之道
制药企业	製藥企業
制衡作用	制衡作用
制造业者	製造業者
制造出来	製造出來
制造厂商	製造廠商
制造费用	製造費用
制限选举	制限選舉
制陶工人	製陶工人
制革工厂	製革工廠
制鞋工人	製鞋工人
刷新纪录	刷新紀錄
刺杀出局	刺殺出局
刺股悬梁	刺股懸梁
刺骨悬梁	刺骨懸梁
刻划入微	刻劃入微
刻板印象	刻板印象
刻足适屦	刻足適屨
剂量当量	劑量當量
剃发为尼	剃髮爲尼
剃发留辫	剃髮留辮
削发为僧	削髮爲僧
削发为尼	削髮爲尼
削发披缁	削髮披緇
削足适履	削足適履
削趾适屦	削趾適屨
前亲晚后	前親晚後
前人种树	前人種樹
前仆后继	前仆後繼
前仆后起	前仆後起
前仰后合	前仰後合
前俯后仰	前俯後仰
前倨后卑	前倨後卑
前倨后恭	前倨後恭
前出后空	前出後空
前前后后	前前後後
前功尽废	前功盡廢
前功尽弃	前功盡棄
前功尽灭	前功盡滅
前合后仰	前合後仰
前合后偃	前合後偃
前后夹攻	前後夾攻
前后左右	前後左右
前后相悖	前後相悖
前后相随	前後相隨
前后矛盾	前後矛盾
前后脚儿	前後腳兒
前呼后应	前呼後應
前呼后拥	前呼後擁
前因后果	前因後果
前婚后嫁	前婚後嫁
前家后继	前家後繼
前思后想	前思後想
前扑后继	前撲後繼
前挽后推	前挽後推
前推后拥	前推後擁
前歌后舞	前歌後舞
前短后长	前短後長
前程万里	前程萬里
前缘未了	前緣未了
前街后巷	前街後巷
前赴后继	前赴後繼
前车之复	前車之覆
前车之鉴	前車之鑑
前车可鉴	前車可鑑
前途未卜	前途未卜
前遮后拥	前遮後擁
前长后短	前長後短
剑合珠还	劍合珠還
剖腹手术	剖腹手術
剥极必复	剝極必復
剧力万钧	劇力萬鈞
剩余价值	剩餘價值
剩余定理	剩餘定理
剩余辐射	剩餘輻射
剩馀价值	剩餘價值
剪发披缁	剪髮披緇
剪彩仪式	剪彩儀式
剪恶除奸	剪惡除奸
副总干事	副總幹事
副法向量	副法向量
割舍不下	割捨不下
劈地价来	劈地價來
劈尸万段	劈屍萬段
劈里啪啦	劈里啪啦
力不从愿	力不從願
力不同科	力不同科
力不胜任	力不勝任
力不自胜	力不自勝
力争上游	力爭上游
力困筋乏	力困筋乏
力尽神危	力盡神危
力尽筋疲	力盡筋疲
力尽筋舒	力盡筋舒
力拼众敌	力拼眾敵
力挽狂澜	力挽狂瀾
力敌万人	力敵萬人
力敌万夫	力敵萬夫
力求克制	力求剋制
力薄才疏	力薄才疏
劝善惩恶	勸善懲惡
劝善戒恶	勸善戒惡
劝善黜恶	勸善黜惡
功同良相	功同良相
功同赏异	功同賞異
功大于过	功大於過
功流万世	功流萬世
功率恶化	功率惡化
功率输出	功率輸出
功能团体	功能團體
功过参半	功過參半
加利波里	加利波里
加密后的	加密後的
加工出口	加工出口
加巴里雅	加巴里雅
加强控制	加強控制
加强管制	加強管制
加拉干达	加拉干達
加挂车厢	加掛車廂
加氢精制	加氫精制
加荣耀于	加榮耀於
加速踏板	加速踏板
加里曼丹	加裏曼丹
加里波的	加里波的
加里波第	加里波第
加里肋亚	加里肋亞
劣缺搊搜	劣缺搊搜
动力系统	動力系統
动向不明	動向不明
动如参商	動如參商
动态范围	動態範圍
动物纤维	動物纖維
动物育种	動物育種
动画艺术	動畫藝術
动荡不安	動盪不安
动荡不定	動盪不定
劫后余生	劫後餘生
劫后馀烬	劫後餘燼
劫后馀生	劫後餘生
劬劳顾复	劬勞顧復
劲度系数	勁度係數
劲骨丰肌	勁骨豐肌
劳力士表	勞力士錶
劳务出口	勞務出口
劳动合同	勞動合同
劳动模范	勞動模範
劳工团体	勞工團體
劳资关系	勞資關係
劳资合作	勞資合作
劳逸结合	勞逸結合
劳雇关系	勞雇關係
势不可当	勢不可當
势不并立	勢不並立
势力并行	勢力並行
势力范围	勢力範圍
势合形离	勢合形離
势同水火	勢同水火
势穷力极	勢窮力極
勇于认错	勇於認錯
勒克莱尔	勒克萊爾
勒里勒得	勒里勒得
勤俭朴实	勤儉樸實
勤俭朴素	勤儉樸素
勤劳致富	勤勞致富
勾心斗角	勾心鬥角
勾魂荡魄	勾魂蕩魄
勿施于人	勿施於人
勿药有喜	勿藥有喜
勿药而愈	勿藥而愈
勿里洞岛	勿里洞島
包价旅游	包價旅遊
包揽闲事	包攬閒事
包罗万象	包羅萬象
包衣种子	包衣種子
包裹表决	包裹表決
包髻团衫	包髻團衫
匏有苦叶	匏有苦葉
化出化入	化出化入
化合反应	化合反應
化学合成	化學合成
化学工厂	化學工廠
化学弹药	化學彈藥
化学当量	化學當量
化学纤维	化學纖維
化暗为明	化暗爲明
北京周报	北京週報
北回归线	北迴歸綫
北回铁路	北迴鐵路
北斗七星	北斗七星
北极冻原	北極凍原
北极地区	北極地區
北辕适楚	北轅適楚
北面称臣	北面稱臣
匡济之才	匡濟之才
匣里龙吟	匣裏龍吟
匪徒集团	匪徒集團
匹马只轮	匹馬隻輪
区域范围	區域範圍
区段征收	區段徵收
医卜星相	醫卜星相
医宗金鉴	醫宗金鑑
医药分业	醫藥分業
医药分离	醫藥分離
医药商店	醫藥商店
医药罔效	醫藥罔效
十一万馀	十一萬餘
十万八千	十萬八千
十万火急	十萬火急
十万火速	十萬火速
十二万分	十二萬分
十二面体	十二面體
十八姑娘	十八姑娘
十六进制	十六進制
十冬腊月	十冬臘月
十几个月	十幾個月
十几二十	十幾二十
十出祁山	十出祁山
十国春秋	十國春秋
十恶不赦	十惡不赦
十方地面	十方地面
十荡十决	十蕩十決
十进位制	十進位制
十进算术	十進算術
十郎八当	十郎八當
十里洋场	十里洋場
十里长亭	十里長亭
十面埋伏	十面埋伏
十鼠同穴	十鼠同穴
千万买邻	千萬買鄰
千万千万	千萬千萬
千万富翁	千萬富翁
千丝万缕	千絲萬縷
千乘万骑	千乘萬騎
千了百当	千了百當
千人所指	千人所指
千仇万恨	千仇萬恨
千仓万箱	千倉萬箱
千依万顺	千依萬順
千依百顺	千依百順
千兵万马	千兵萬馬
千军万马	千軍萬馬
千刀万剁	千刀萬剁
千刀万剐	千刀萬剮
千刁万恶	千刁萬惡
千分之一	千分之一
千分之三	千分之三
千分之二	千分之二
千千万万	千千萬萬
千变万化	千變萬化
千变万状	千變萬狀
千变万轸	千變萬軫
千古传诵	千古傳誦
千古未闻	千古未聞
千古流传	千古流傳
千古独步	千古獨步
千古绝唱	千古絕唱
千古罪人	千古罪人
千古遗恨	千古遺恨
千只足够	千只足夠
千叮万嘱	千叮萬囑
千呼万唤	千呼萬喚
千咒万骂	千咒萬罵
千唤万唤	千喚萬喚
千回百折	千迴百折
千回百转	千迴百轉
千夫所指	千夫所指
千头万绪	千頭萬緒
千头橘奴	千頭橘奴
千头百绪	千頭百緒
千奇百怪	千奇百怪
千妥万妥	千妥萬妥
千妥万当	千妥萬當
千姿百态	千姿百態
千娇百媚	千嬌百媚
千娇百态	千嬌百態
千孔百疮	千孔百瘡
千家万户	千家萬戶
千山万壑	千山萬壑
千山万水	千山萬水
千山山脉	千山山脈
千岁一时	千歲一時
千岐万辙	千岐萬轍
千岛列岛	千島列島
千岛羣岛	千島羣島
千岛群岛	千島羣島
千岩万壑	千巖萬壑
千岩万谷	千巖萬谷
千岩竞秀	千巖競秀
千差万别	千差萬別
千年万载	千年萬載
千年怪兽	千年怪獸
千态万状	千態萬狀
千思万想	千思萬想
千恩万谢	千恩萬謝
千愁万恨	千愁萬恨
千愁万绪	千愁萬緒
千愁万虑	千愁萬慮
千挑万选	千挑萬選
千挑百选	千挑百選
千推万阻	千推萬阻
千支万派	千支萬派
千斤重担	千斤重擔
千方万计	千方萬計
千方百计	千方百計
千村万落	千村萬落
千条万端	千條萬端
千条万绪	千條萬緒
千欢万喜	千歡萬喜
千状万态	千狀萬態
千状万端	千狀萬端
千瓦小时	千瓦小時
千生万死	千生萬死
千疮百孔	千瘡百孔
千百成羣	千百成羣
千真万真	千真萬真
千真万确	千真萬確
千碱基对	千鹼基對
千秋万世	千秋萬世
千秋万代	千秋萬代
千秋万古	千秋萬古
千秋万岁	千秋萬歲
千秋佳城	千秋佳城
千秋大业	千秋大業
千端万绪	千端萬緒
千篇一律	千篇一律
千红万紫	千紅萬紫
千经万卷	千經萬卷
千绪万端	千緒萬端
千般万样	千般萬樣
千虑一失	千慮一失
千虑一得	千慮一得
千言万语	千言萬語
千足港条	千足港條
千载一会	千載一會
千载一合	千載一合
千载一时	千載一時
千载一逢	千載一逢
千载一遇	千載一遇
千载扬名	千載揚名
千载独步	千載獨步
千载难逢	千載難逢
千辛万苦	千辛萬苦
千辛百苦	千辛百苦
千里一曲	千里一曲
千里之外	千里之外
千里之行	千里之行
千里命驾	千里命駕
千里犹面	千里猶面
千里移檄	千里移檄
千里迢迢	千里迢迢
千里迢遥	千里迢遙
千里鹅毛	千里鵝毛
千金一刻	千金一刻
千金一掷	千金一擲
千金一笑	千金一笑
千金一诺	千金一諾
千金之子	千金之子
千金之家	千金之家
千金买笑	千金買笑
千金买骨	千金買骨
千金小姐	千金小姐
千金市骨	千金市骨
千金敝帚	千金敝帚
千金要方	千金要方
千金难买	千金難買
千钧一发	千鈞一髮
千钧重负	千鈞重負
千锤百炼	千錘百煉
千门万户	千門萬戶
千难万险	千難萬險
千难万难	千難萬難
千页羣岛	千頁羣島
千鬼百怪	千鬼百怪
升势受阻	升勢受阻
升华作用	昇華作用
升堂入室	升堂入室
升堂拜母	升堂拜母
升学主义	升學主義
升学压力	升學壓力
升学考试	升學考試
升官发财	升官發財
升幂级数	升冪級數
升斗之禄	升斗之祿
升斗小民	升斗小民
升旗仪式	升旗儀式
升旗典礼	升旗典禮
升来升去	升來升去
升班考试	升班考試
升等考试	升等考試
升级换代	升級換代
升迁制度	升遷制度
升迁管道	升遷管道
升降记号	升降記號
升高自下	升高自下
半个世纪	半個世紀
半价优待	半價優待
半价倍息	半價倍息
半导体厂	半導體廠
半径范围	半徑範圍
半排出期	半排出期
半涂而罢	半塗而罷
半老徐娘	半老徐娘
半路出家	半路出家
半面之交	半面之交
半面之旧	半面之舊
华东师范	華東師範
华润万家	華潤萬家
华特里德	華特里德
华表鹤归	華表鶴歸
华阳国志	華陽國志
协力同心	協力同心
协同作战	協同作戰
协同作用	協同作用
协同动作	協同動作
协议范本	協議範本
协议规范	協議規範
卑梁之衅	卑梁之釁
卓尔出羣	卓爾出羣
单位价格	單位價格
单位信托	單位信托
单位向量	單位向量
单位面积	單位面積
单向天线	單向天綫
单向电流	單向電流
单向行驶	單向行駛
单向通车	單向通車
单夫只妇	單夫隻婦
单张汇票	單張匯票
单打独斗	單打獨鬥
单方制剂	單方製劑
单模光纤	單模光纖
单法货制	單法貨制
卖不出去	賣不出去
卖个破绽	賣個破綻
卖俏营奸	賣俏營奸
卖俏行奸	賣俏行奸
卖俏迎奸	賣俏迎奸
卖卜测字	賣卜測字
卖红萝卜	賣紅蘿蔔
卖膏药的	賣膏藥的
南京钟表	南京鐘錶
南台工专	南臺工專
南回公路	南迴公路
南回归线	南迴歸綫
南回铁路	南迴鐵路
南屏晚钟	南屏晚鐘
南山并寿	南山並壽
南山有台	南山有臺
南征北伐	南征北伐
南征北战	南征北戰
南征北讨	南征北討
南方周末	南方周末
南极仙翁	南極仙翁
南极呈祥	南極呈祥
南极地区	南極地區
南极大陆	南極大陸
南极星沉	南極星沉
南极星辉	南極星輝
南极腾辉	南極騰輝
南洋模范	南洋模範
南特杰克	南特傑克
南箕北斗	南箕北斗
南面为王	南面爲王
南面百城	南面百城
南面称伯	南面稱伯
南面称孤	南面稱孤
南面称王	南面稱王
博克达山	博克達山
博古图录	博古圖錄
博学多才	博學多才
博采众长	博採眾長
博闻彊志	博聞彊志
卜夜卜昼	卜夜卜晝
卜昼卜夜	卜晝卜夜
占为己有	佔爲己有
占人便宜	佔人便宜
占尽便宜	佔盡便宜
占风使帆	占風使帆
占高枝儿	佔高枝兒
卡尔加里	卡爾加里
卡尔扎伊	卡尔扎伊
卡布其诺	卡布其諾
卡布列拉	卡布列拉
卡布奇诺	卡布奇諾
卡布瑞拉	卡布瑞拉
卡布雷拉	卡布雷拉
卡普里亚蒂	卡佩雅蒂
卡片目录	卡片目錄
卡特里娜	卡特里娜
卡芬雅克	卡芬雅克
卡迪拉克	卡迪拉克
卡里扎德	卡里紮德
卢比西克	盧比西克
卤莽灭裂	鹵莽滅裂
卧薪尝胆	臥薪嚐膽
卫星云图	衛星雲圖
卫生标准	衛生標準
卯尽全力	卯盡全力
卯足了劲	卯足了勁
卯酉参辰	卯酉參辰
印制电路	印製電路
印堂发黑	印堂發黑
印度法系	印度法系
印欧语系	印歐語系
印累绶若	印累綬若
印鉴鉴定	印鑑鑑定
危于累卵	危於累卵
危亡之秋	危亡之秋
危害评价	危害評價
即兴发挥	即興發揮
即兴表演	即興表演
即期汇票	即期匯票
卵与石斗	卵與石鬥
卷入漩涡	捲入漩渦
卷吸作用	捲吸作用
卷土重来	捲土重來
卷帙浩繁	卷帙浩繁
卷旗息鼓	卷旗息鼓
卷来卷去	捲來捲去
卷款潜逃	捲款潛逃
卷款逃走	捲款逃走
卷浪翻波	捲浪翻波
卷烟画片	捲煙畫片
卷甲重来	捲甲重來
卷繖花序	卷繖花序
卷舌元音	捲舌元音
卷舌韵母	捲舌韻母
历久不衰	歷久不衰
历久常新	歷久常新
历久弥坚	歷久彌堅
历久弥新	歷久彌新
历代先皇	歷代先皇
历代志上	歷代志上
历代志下	歷代志下
历代祖先	歷代祖先
历劫归来	歷劫歸來
历历可数	歷歷可數
历历可纪	歷歷可紀
历历可考	歷歷可考
历历可见	歷歷可見
历历可辨	歷歷可辨
历历在目	歷歷在目
历历如绘	歷歷如繪
历历落落	歷歷落落
历史久远	歷史久遠
历史事件	歷史事件
历史人物	歷史人物
历史名词	歷史名詞
历史学家	歷史學家
历史学者	歷史學者
历史小说	歷史小說
历史年表	歷史年表
历史悠久	歷史悠久
历史意义	歷史意義
历史文学	歷史文學
历史新高	歷史新高
历史时代	歷史時代
历史时期	歷史時期
历史沿革	歷史沿革
历史潮流	歷史潮流
历史版本	歷史版本
历史线图	歷史綫圖
历史背景	歷史背景
历史观点	歷史觀點
历史语词	歷史語詞
历史遗产	歷史遺產
历史遗迹	歷史遺蹟
历史重演	歷史重演
历夏经秋	歷夏經秋
历尽沧桑	歷盡滄桑
历尽艰辛	歷盡艱辛
历尽艰险	歷盡艱險
历尽艰难	歷盡艱難
历日旷久	歷日曠久
历有年所	歷有年所
历朝历代	歷朝歷代
历来如此	歷來如此
历物之意	歷物之意
历练之才	歷練之才
历练老成	歷練老成
历经沧桑	歷經滄桑
历经波折	歷經波折
历险归来	歷險歸來
压克力板	壓克力板
压力团体	壓力團體
压缩饼干	壓縮餅乾
厝薪于火	厝薪於火
原始艺术	原始藝術
原始记录	原始記錄
原料价格	原料價格
原野游侠	原野遊俠
去台人员	去臺人員
去向不明	去向不明
去恶从善	去惡從善
去暗投明	去暗投明
去杀胜残	去殺勝殘
参与人员	參與人員
参众两院	參眾兩院
参前落后	參前落後
参差不齐	參差不齊
参差错落	參差錯落
参知政事	參知政事
参考书目	參考書目
参考价值	參考價值
参考参考	參考參考
参考座标	參考座標
参考手冊	參考手冊
参考文献	參考文獻
参考材料	參考材料
参考消息	參考消息
参考特藏	參考特藏
参考资料	參考資料
参见互照	參見互照
参观参观	參觀參觀
参观团体	參觀團體
参谋总部	參謀總部
参谋总长	參謀總長
参辰卯酉	參辰卯酉
参辰日月	參辰日月
参量空间	參量空間
又干又硬	又乾又硬
又弱一个	又弱一個
又当别论	又當別論
又摇又摆	又搖又擺
又饥又渴	又飢又渴
及早准备	及早準備
友好代表	友好代表
友好关系	友好關係
友谊万岁	友誼萬歲
双台子区	雙臺子區
双向交通	雙向交通
双向沟通	雙向溝通
双周期性	雙週期性
双手万能	雙手萬能
双手赞成	雙手贊成
双方同意	雙方同意
双曲余割	雙曲餘割
双曲余弦	雙曲餘弦
双曲拱桥	雙曲拱橋
双曲正弦	雙曲正弦
双柑斗酒	雙柑斗酒
双进双出	雙進雙出
双重标准	雙重標準
双链核酸	雙鏈核酸
双面娇娃	雙面嬌娃
反反复复	反反覆覆
反向而行	反向而行
反坦克炮	反坦克炮
反复不一	反覆不一
反复不定	反覆不定
反复不常	反覆不常
反复思维	反覆思維
反复思量	反覆思量
反复无常	反覆無常
反导系统	反導系統
反射星云	反射星雲
反录病毒	反錄病毒
反托拉斯	反托拉斯
反掌折枝	反掌折枝
反攻复国	反攻復國
反映出来	反映出來
反清复明	反清復明
反烟运动	反煙運動
反目成仇	反目成仇
反经合义	反經合義
反袁斗争	反袁鬥爭
反败为胜	反敗爲勝
反阴复阴	反陰復陰
反面人物	反面人物
反面教员	反面教員
反面教材	反面教材
反面无情	反面無情
反面角色	反面角色
反颜相向	反顏相向
发上冲冠	髮上衝冠
发上指冠	髮上指冠
发乱钗横	髮亂釵橫
发人深省	發人深省
发人深醒	發人深省
发人省思	發人省思
发光可鉴	髮光可鑑
发光强度	發光強度
发光颜料	發光顏料
发凡举例	發凡舉例
发出指示	發出指示
发号出令	發號出令
发号布令	發號布令
发号施令	發號施令
发喊连天	發喊連天
发嘎嘎声	發嘎嘎聲
发声器官	發聲器官
发奋图强	發奮圖強
发奋有为	發奮有爲
发奸摘隐	發奸摘隱
发奸擿伏	發奸擿伏
发如飞蓬	髮如飛蓬
发威动怒	發威動怒
发富发贵	發富發貴
发射控制	發射控制
发射星云	發射星雲
发屋求狸	發屋求狸
发展下去	發展下去
发展中国	發展中國
发展出来	發展出來
发展心理	發展心理
发展潜力	發展潛力
发展生产	發展生產
发展起来	發展起來
发展趋势	發展趨勢
发展速度	發展速度
发已霜白	髮已霜白
发引千钧	髮引千鈞
发情周期	發情周期
发愤努力	發憤努力
发愤向上	發憤向上
发愤图强	發憤圖強
发愤忘食	發憤忘食
发扬光大	發揚光大
发扬踔厉	發揚踔厲
发扬蹈厉	發揚蹈厲
发指眦裂	髮指眥裂
发挥不了	發揮不了
发挥作用	發揮作用
发挥出来	發揮出來
发挥所长	發揮所長
发挽双髻	髮挽雙髻
发掘出来	發掘出來
发擿奸伏	發擿奸伏
发政施仁	發政施仁
发明创造	發明創造
发来发去	發來發去
发泄出来	發泄出來
发泡成形	發泡成形
发现学习	發現學習
发生关系	發生關係
发电机组	發電機組
发短心长	髮短心長
发硎新试	發硎新試
发神经病	發神經病
发科打诨	發科打諢
发策决科	發策決科
发聋振聩	發聾振聵
发育不良	發育不良
发育条件	發育條件
发脱口齿	發脫口齒
发自內心	發自內心
发自肺腑	發自肺腑
发蒙振落	發蒙振落
发行首日	發行首日
发表出来	發表出來
发表声明	發表聲明
发表意见	發表意見
发表演讲	發表演講
发言中肯	發言中肯
发言人卡	發言人卡
发言人室	發言人室
发言发语	發言發語
发言遣辞	發言遣辭
发财致富	發財致富
发起烧来	發起燒來
发踊冲冠	髮踊沖冠
发踪指示	發蹤指示
发达国家	發達國家
发达地区	發達地區
发达起来	發達起來
发迹变泰	發蹟變泰
发送功率	發送功率
发酵乳酸	發酵乳酸
发酵出来	發酵出來
发酵饲料	發酵飼料
发采扬明	發采揚明
发隐擿伏	發隱擿伏
发音器官	發音器官
发音方法	發音方法
发音部位	發音部位
发音障碍	發音障礙
发风骂坐	發風罵坐
取之不尽	取之不盡
取信于人	取信於人
取值范围	取值範圍
取得一致	取得一致
取得胜利	取得勝利
取舍不定	取捨不定
取舍之间	取捨之間
取舍难定	取捨難定
受人之托	受人之託
受制于人	受制於人
受命于天	受命于天
受尽压迫	受盡壓迫
受尽折磨	受盡折磨
受用不尽	受用不盡
受骗上当	受騙上當
变了又变	變了又變
变动汇率	變動匯率
变化万端	變化萬端
变化范围	變化範圍
变尽方法	變盡方法
变异系数	變異係數
变征之声	變徵之聲
变征之音	變徵之音
变性手术	變性手術
变性气团	變性氣團
变相加价	變相加價
叙述出来	敘述出來
口出不逊	口出不遜
口出恶言	口出惡言
口出秽言	口出穢言
口干舌燥	口乾舌燥
口才辨给	口才辨給
口燥唇干	口燥脣乾
口燥脣干	口燥脣乾
口腹之欲	口腹之慾
口血未干	口血未乾
口述出来	口述出來
口述历史	口述歷史
古典艺术	古典藝術
古杰拉尔	古傑拉爾
古里古怪	古里古怪
句践复国	句踐復國
另一回事	另一回事
另一方面	另一方面
另开生面	另開生面
另当别论	另當別論
另谋出路	另謀出路
另谋发展	另謀發展
另起烟爨	另起煙爨
另辟新径	另闢新徑
另辟蹊径	另闢蹊徑
只不过是	只不過是
只争旦夕	只爭旦夕
只借不还	只借不還
只声不出	隻聲不出
只多不少	只多不少
只字不提	隻字不提
只字片纸	隻字片紙
只字片言	隻字片言
只字片语	隻字片語
只守不攻	只守不攻
只影全无	隻影全無
只手单拳	隻手單拳
只手擎天	隻手擎天
只手空拳	隻手空拳
只手遮天	隻手遮天
只是为了	只是爲了
只欠东风	只欠東風
只求无过	只求無過
只求自保	只求自保
只眼独具	隻眼獨具
只租不买	只租不買
只租不卖	只租不賣
只见树木	只見樹木
只言片字	隻言片字
只言片语	隻言片語
只许成功	只許成功
只说不做	只說不做
只赢不输	只贏不輸
只身一人	隻身一人
只身上已	只身上已
只身上无	只身上無
只身上有	只身上有
只身上没	只身上沒
只身上的	只身上的
只身孤影	隻身孤影
只轮不反	隻輪不反
只轮不返	隻輪不返
只送不卖	只送不賣
只鸡斗酒	只雞斗酒
只鸡絮酒	隻雞絮酒
叮人战术	叮人戰術
叮叮当当	叮叮噹噹
叮当作响	叮噹作響
可了不得	可了不得
可以克制	可以剋制
可供参考	可供參考
可可托海	可可托海
可少不了	可少不了
可展曲面	可展曲面
可紧可松	可緊可鬆
可结合性	可結合性
台东县长	臺東縣長
台东大学	臺東大學
台中一中	臺中一中
台中县市	臺中縣市
台中商专	臺中商專
台中市人	臺中市人
台中市文	臺中市文
台中师范	臺中師範
台中港路	臺中港路
台中盆地	臺中盆地
台儿庄区	臺兒莊區
台凤公司	臺鳳公司
台前台后	臺前臺後
台北体专	臺北體專
台北体院	臺北體院
台北县长	臺北縣長
台北商专	臺北商專
台北地院	臺北地院
台北大学	臺北大學
台北工专	臺北工專
台北市市	臺北市市
台北市立	臺北市立
台北市长	臺北市長
台北市队	臺北市隊
台北师院	臺北師院
台北护专	臺北護專
台北捷运	臺北捷運
台北盆地	臺北盆地
台十一线	臺十一綫
台十七线	臺十七綫
台南县市	臺南縣市
台南大学	臺南大學
台南孔庙	臺南孔廟
台南家专	臺南家專
台南府市	臺南府市
台大医院	臺大醫院
台大学生	臺大學生
台客呛辣	臺客嗆辣
台州地区	台州地區
台拉维夫	臺拉維夫
台水澎运	臺水澎運
台汽客运	臺汽客運
台海两岸	臺海兩岸
台港澳侨	臺港澳僑
台湾光复	臺灣光復
台湾凤蝶	臺灣鳳蝶
台湾国语	臺灣國語
台湾土狗	臺灣土狗
台湾地区	臺灣地區
台湾大学	臺灣大學
台湾杜鹃	臺灣杜鵑
台湾海峡	臺灣海峽
台湾电力	臺灣電力
台湾省立	臺灣省立
台湾粉蝶	臺灣粉蝶
台湾精品	臺灣精品
台湾经验	臺灣經驗
台湾蓝鹊	臺灣藍鵲
台湾铝业	臺灣鋁業
台湾银行	臺灣銀行
台湾青年	臺灣青年
台澎金马	臺澎金馬
台独运动	臺獨運動
台电公司	臺電公司
台糖公司	臺糖公司
台维斯杯	臺維斯杯
台菜餐厅	臺菜餐廳
台视公司	臺視公司
台阁生风	臺閣生風
台风稳健	臺風穩健
台风警报	颱風警報
叱吒风云	叱吒風雲
叱咤乐坛	叱咤樂壇
叱咤樂壇	叱咤樂壇
叱咤风云	叱吒風雲
叱嗟风云	叱嗟風雲
史勒德克	史勒德克
史坦尼克	史坦尼克
史托苏儿	史托蘇兒
史査克队	史査克隊
史派克李	史派克李
史派克特	史派克特
叶公好龙	葉公好龍
叶口蝠科	葉口蝠科
叶块繁殖	葉塊繁殖
叶尔羌河	葉爾羌河
叶尼基河	葉尼基河
叶尼塞河	葉尼塞河
叶斯沛森	葉斯沛森
叶状植物	葉狀植物
叶落归根	葉落歸根
叶落归秋	葉落歸秋
叶落知秋	葉落知秋
叶落粪本	葉落糞本
叶赤铁路	葉赤鐵路
叶轮机械	葉輪機械
叶面对称	葉面對稱
叶面施肥	葉面施肥
号寒啼饥	號寒啼飢
司法制度	司法制度
吁咈都俞	吁咈都俞
吃不出来	吃不出來
吃了秤砣	吃了秤砣
吃亏上当	吃虧上當
吃合家欢	吃合家歡
吃后悔药	吃後悔藥
吃回头草	吃回頭草
吃尽当光	吃盡當光
吃得出来	吃得出來
吃挂络儿	吃掛絡兒
吃板刀面	吃板刀麵
吃里扒外	吃裏扒外
吃里爬外	吃裏爬外
吃饭傢伙	吃飯傢伙
吃饭家伙	吃飯家伙
各不相同	各不相同
各个击破	各個擊破
各从其志	各從其志
各向异性	各向異性
各如其面	各如其面
各尽其用	各盡其用
各尽所能	各盡所能
各有千秋	各有千秋
各有胜负	各有勝負
各种各样	各種各樣
各种颜色	各種顏色
各级党委	各級黨委
各行其志	各行其志
各谋出路	各謀出路
各辟蹊径	各闢蹊徑
合不拢嘴	合不攏嘴
合久必分	合久必分
合义复词	合義複詞
合乎逻辑	合乎邏輯
合于时宜	合于時宜
合众为一	合眾爲一
合众银行	合眾銀行
合作主义	合作主義
合作伙伴	合作伙伴
合作农场	合作農場
合作协议	合作協議
合作商店	合作商店
合作无懈	合作無懈
合作无间	合作無間
合作金库	合作金庫
合则两利	合則兩利
合口元音	合口元音
合同各方	合同各方
合同文字	合同文字
合嘴合舌	合嘴合舌
合在一起	合在一起
合契若神	合契若神
合家大小	合家大小
合当有事	合當有事
合影留念	合影留念
合心合意	合心合意
合情合理	合情合理
合成乐器	合成樂器
合成代谢	合成代謝
合成作用	合成作用
合成染料	合成染料
合成树脂	合成樹脂
合成橡胶	合成橡膠
合成洗涤	合成洗滌
合成石油	合成石油
合成纤维	合成纖維
合成色素	合成色素
合成语境	合成語境
合成语音	合成語音
合法斗争	合法鬥爭
合浦珠还	合浦珠還
合浦还珠	合浦還珠
合照留念	合照留念
合理合情	合理合情
合理密植	合理密植
合理布局	合理布局
合理错误	合理錯誤
合璧连珠	合璧連珠
合瓣花冠	合瓣花冠
合眼摸象	合眼摸象
合纵连横	合縱連橫
合而为一	合而爲一
合菜戴帽	合菜戴帽
合该有事	合該有事
合辙押韵	合轍押韻
合金元素	合金元素
合零为整	合零爲整
吉凶庆吊	吉凶慶弔
吉凶悔吝	吉凶悔吝
吉凶未卜	吉凶未卜
吉卜赛人	吉卜賽人
吉尔库克	吉爾庫克
吉尼普里	吉尼普里
吉普斯夸	吉普斯夸
吉田松阴	吉田松陰
吉诺布里	吉諾布里
吉里巴斯	吉里巴斯
吊丧问疾	弔喪問疾
吊儿郎当	吊兒郎當
吊古寻幽	弔古尋幽
吊子曰儿	吊子曰兒
吊拷絣把	吊拷絣把
吊拷绷扒	吊拷繃扒
吊放声纳	吊放聲納
吊来吊去	吊來吊去
吊死问孤	弔死問孤
吊死问疾	弔死問疾
吊民伐罪	弔民伐罪
吊者大悦	弔者大悅
吊脚儿事	弔腳兒事
吊腰撒跨	弔腰撒跨
吊誉沽名	吊譽沽名
吊诡矜奇	弔詭矜奇
吊贺迎送	弔賀迎送
吊销执照	吊銷執照
同不同意	同不同意
同业公会	同業公會
同业拆借	同業拆借
同中有异	同中有異
同义反复	同義反復
同乡亲故	同鄉親故
同仇敌忾	同仇敵愾
同休共戚	同休共戚
同传耳麦	同傳耳麥
同侪压力	同儕壓力
同侪团体	同儕團體
同侪审查	同儕審査
同侪扶持	同儕扶持
同侪检视	同儕檢視
同侪谘商	同儕諮商
同出一源	同出一源
同出一脉	同出一脈
同出同进	同出同進
同功一体	同功一體
同化作用	同化作用
同卵双生	同卵雙生
同吃同住	同吃同住
同名之累	同名之累
同名同姓	同名同姓
同命鸳鸯	同命鴛鴦
同型配子	同型配子
同声一哭	同聲一哭
同声之谊	同聲之誼
同声传译	同聲傳譯
同声异俗	同聲異俗
同声相应	同聲相應
同声翻译	同聲翻譯
同姓同名	同姓同名
同宗同气	同宗同氣
同室操戈	同室操戈
同居各爨	同居各爨
同州梆子	同州梆子
同工同酬	同工同酬
同工异曲	同工異曲
同工异调	同工異調
同年同月	同年同月
同年而语	同年而語
同床异梦	同牀異夢
同归于尽	同歸於盡
同归殊途	同歸殊途
同德同心	同德同心
同心僇力	同心僇力
同心协力	同心協力
同心合力	同心合力
同心合意	同心合意
同心同德	同心同德
同心并力	同心並力
同心戮力	同心戮力
同心断金	同心斷金
同志合道	同志合道
同志天地	同志天地
同志酒吧	同志酒吧
同忧相救	同憂相救
同性恋者	同性戀者
同性相斥	同性相斥
同恶相助	同惡相助
同恶相救	同惡相救
同恶相求	同惡相求
同恶相济	同惡相濟
同房兄弟	同房兄弟
同手同脚	同手同腳
同文同种	同文同種
同文算指	同文算指
同文韵统	同文韻統
同旁內角	同旁內角
同日而言	同日而言
同日而语	同日而語
同月同日	同月同日
同期录音	同期錄音
同条共贯	同條共貫
同来同往	同來同往
同枕共眠	同枕共眠
同欢同赏	同歡同賞
同步传输	同步傳輸
同步卫星	同步衛星
同步录音	同步錄音
同步电动	同步電動
同步进行	同步進行
同母异父	同母異父
同气之光	同氣之光
同气之情	同氣之情
同气相求	同氣相求
同气连枝	同氣連枝
同流合汙	同流合汙
同流合污	同流合汙
同济大学	同濟大學
同温同压	同溫同壓
同父异母	同父異母
同牀各梦	同牀各夢
同牀异梦	同牀異夢
同班同学	同班同學
同理可证	同理可證
同甘共苦	同甘共苦
同甘同苦	同甘同苦
同生共死	同生共死
同病相怜	同病相憐
同盟条约	同盟條約
同盟罢工	同盟罷工
同窗夜语	同窗夜語
同窗契友	同窗契友
同符合契	同符合契
同等学力	同等學力
同等学历	同等學歷
同类产品	同類產品
同类意识	同類意識
同类相吸	同類相吸
同类相呼	同類相呼
同类相残	同類相殘
同类相求	同類相求
同类相聚	同類相聚
同类相食	同類相食
同素异形	同素異形
同素异性	同素異性
同级评审	同級評審
同缘同相	同緣同相
同胞兄妹	同胞兄妹
同胞兄弟	同胞兄弟
同胞共乳	同胞共乳
同胞双生	同胞雙生
同舟之谊	同舟之誼
同舟共济	同舟共濟
同舟而济	同舟而濟
同船济水	同船濟水
同行同业	同行同業
同行相忌	同行相忌
同衾共枕	同衾共枕
同袍同泽	同袍同澤
同见同知	同見同知
同起同坐	同起同坐
同轨同文	同軌同文
同轴圆弧	同軸圓弧
同轴电缆	同軸電纜
同进同出	同進同出
同配生殖	同配生殖
同门异户	同門異戶
名不当实	名不當實
名义价值	名義價值
名垂后世	名垂後世
名垂罔极	名垂罔極
名复金瓯	名覆金甌
名山胜境	名山勝境
名录服务	名錄服務
名望体面	名望體面
名称标签	名稱標籤
名胜古迹	名勝古蹟
名重识暗	名重識暗
名门之后	名門之後
名闻于世	名聞於世
后不为例	後不爲例
后事之师	後事之師
后人乘凉	後人乘涼
后代子孙	後代子孫
后仰前合	後仰前合
后会可期	後會可期
后会无期	後會無期
后会有期	後會有期
后会难期	後會難期
后信号灯	後信號燈
后先辉映	後先輝映
后力不继	後力不繼
后加成分	後加成分
后勤人员	後勤人員
后发先至	後發先至
后发制人	後發制人
后台老板	後臺老闆
后合前仰	後合前仰
后备军人	後備軍人
后天免疫	後天免疫
后实先声	後實先聲
后巷前街	後巷前街
后恭前倨	後恭前倨
后悔不及	後悔不及
后悔不来	後悔不來
后悔不迭	後悔不迭
后悔何及	後悔何及
后悔无及	後悔無及
后悔药儿	後悔藥兒
后悔莫及	後悔莫及
后患无穷	後患無窮
后手不上	後手不上
后手不接	後手不接
后拥前呼	後擁前呼
后拥前推	後擁前推
后拥前遮	後擁前遮
后拥前驱	後擁前驅
后无来者	後無來者
后来之秀	後來之秀
后来居上	後來居上
后果前因	後果前因
后果堪忧	後果堪憂
后果堪虞	後果堪虞
后梁太祖	後梁太祖
后生动物	後生動物
后生可畏	後生可畏
后生小子	後生小子
后生小辈	後生小輩
后生晚学	後生晚學
后知后觉	後知後覺
后继乏人	後繼乏人
后继乏力	後繼乏力
后继无人	後繼無人
后继无力	後繼無力
后继有人	後繼有人
后羿射日	后羿射日
后翻筋斗	后翻筋斗
后西游记	後西遊記
后赤壁赋	後赤壁賦
后起之秀	後起之秀
后车之戒	後車之戒
后车之鉴	後車之鑑
后辈小子	後輩小子
后进先出	後進先出
后送医院	後送醫院
后院起火	後院起火
后顾之忧	後顧之憂
后顾之患	後顧之患
后顾之虑	後顧之慮
后顾之虞	後顧之虞
吐司面包	吐司麵包
吐哺捉发	吐哺捉髮
吐哺握发	吐哺握髮
向前看齐	向前看齊
向前翻腾	向前翻騰
向右看齐	向右看齊
向右转走	向右轉走
向后翻腾	向後翻騰
向后转走	向後轉走
向壁虚构	向壁虛構
向壁虚造	向壁虛造
向声背实	向聲背實
向导公司	嚮導公司
向左看齐	向左看齊
向左转走	向左轉走
向巴平措	向巴平措
向平之愿	向平之願
向心花序	向心花序
向来都是	向來都是
向流星雨	向流星雨
向火乞儿	向火乞兒
向里面冲	向裏面衝
向量代数	向量代數
向量分析	向量分析
向量图形	向量圖形
向阳大道	向陽大道
向隅独泣	向隅獨泣
向隅而泣	向隅而泣
吓了一跳	嚇了一跳
吓出病来	嚇出病來
吓得发抖	嚇得發抖
吕氏春秋	呂氏春秋
君主专制	君主專制
君子于役	君子于役
吞了下去	吞了下去
吞云吐雾	吞雲吐霧
吞刀刮肠	吞刀刮腸
吟游诗人	吟遊詩人
否极必泰	否極必泰
否极泰来	否極泰來
否极生泰	否極生泰
含商咀征	含商咀徵
含宫咀征	含宮咀徵
含烟笼雾	含煙籠霧
含苞欲放	含苞欲放
含齿戴发	含齒戴髮
听不出来	聽不出來
听候发落	聽候發落
听得出来	聽得出來
听觉范围	聽覺範圍
听证制度	聽證制度
启动技术	啓動技術
启蒙哲学	啓蒙哲學
启蒙时代	啓蒙時代
启蒙运动	啓蒙運動
吴下阿蒙	吳下阿蒙
吴越同舟	吳越同舟
吴越春秋	吳越春秋
吸引不了	吸引不了
吸得干干	吸得乾乾
吸油烟机	吸油煙機
吹气胜兰	吹氣勝蘭
吹风胡哨	吹風胡哨
呆串了皮	呆串了皮
呆了一呆	呆了一呆
呆呆傻傻	呆呆傻傻
呆呆挣挣	呆呆掙掙
呆呆笨笨	呆呆笨笨
呆里呆气	呆裏呆氣
呆里撒奸	呆裏撒奸
呈现出来	呈現出來
呈逆价差	呈逆價差
周三径一	周三徑一
周休二日	週休二日
周全方便	周全方便
周公吐哺	周公吐哺
周口地区	周口地區
周召共和	周召共和
周围环境	周圍環境
周年纪念	週年紀念
周年视差	周年視差
周急继乏	周急繼乏
周情孔思	周情孔思
周旋到底	周旋到底
周期函数	周期函數
周期彗星	周期彗星
周末愉快	週末愉快
周末效应	週末效應
周梁淑怡	周梁淑怡
周游世界	周遊世界
周游列国	周遊列國
周程张朱	周程張朱
周章狼狈	周章狼狽
周而不比	周而不比
周而复始	周而復始
周转不灵	周轉不靈
周边设备	周邊設備
周遭事物	週遭事物
周郎顾曲	周郎顧曲
周髀算经	周髀算經
呱嗒板儿	呱嗒板兒
味同嚼蜡	味同嚼蠟
味胜易牙	味勝易牙
呼之欲出	呼之欲出
呼吸困难	呼吸困難
呼吸系统	呼吸系統
呼图克图	呼圖克圖
命世之才	命世之才
命中注定	命中註定
命名系统	命名系統
命运注定	命運註定
命题范围	命題範圍
和光同尘	和光同塵
和合二仙	和合二仙
和气致祥	和氣致祥
和盘托出	和盤托出
和而不同	和而不同
和谐一致	和諧一致
和风拂面	和風拂面
咏雪之才	詠雪之才
咖啡色系	咖啡色系
咫尺万里	咫尺萬里
咫尺千里	咫尺千里
咬了一口	咬了一口
咬合不正	咬合不正
咬合调整	咬合調整
咬姜呷醋	咬薑呷醋
咬字不准	咬字不準
咬舌自尽	咬舌自盡
咸丝丝儿	鹹絲絲兒
咸五登三	咸五登三
咸嘴淡舌	鹹嘴淡舌
咸宁地区	咸寧地區
咸津津儿	鹹津津兒
咸淡适中	鹹淡適中
咸镜北道	咸鏡北道
咸镜南道	鹹鏡南道
咸阳地区	咸陽地區
咸鱼翻身	鹹魚翻身
哀兵必胜	哀兵必勝
哀哀欲绝	哀哀欲絕
品种改良	品種改良
品花宝鉴	品花寶鑑
品貌出众	品貌出眾
品质管制	品質管制
哄传一时	哄傳一時
哄动一时	哄動一時
哄吓骗诈	哄嚇騙詐
哄哄翕翕	哄哄翕翕
哄堂大笑	鬨堂大笑
哄抬物价	哄擡物價
哄来哄去	哄來哄去
哄然大笑	鬨然大笑
哈克莉洛	哈克莉洛
哈塞布苏	哈塞布蘇
哈巴谷书	哈巴谷書
哈布斯堡	哈布斯堡
哈萨克人	哈薩克人
哈萨克文	哈薩克文
哈萨克族	哈薩克族
哈萨克语	哈薩克語
哈里伯顿	哈里伯頓
哈里发塔	哈里發塔
哈里斯堡	哈里斯堡
哈里札德	哈里札德
哈里路亚	哈里路亞
响彻云汉	響徹雲漢
响彻云际	響徹雲際
响彻云霄	響徹雲霄
响遏行云	響遏行雲
响马党羽	響馬黨羽
哑子托梦	啞子托夢
哥伦布市	哥倫布市
哥伦布纪	哥倫布紀
哪里哪里	哪里哪里
哭个痛快	哭個痛快
哭成一团	哭成一團
哲学范畴	哲學範疇
唇燥舌干	脣燥舌乾
售后服务	售後服務
售货合约	售貨合約
唯意志论	唯意志論
唱对台戏	唱對臺戲
唱片目录	唱片目錄
唾面自干	唾面自乾
商业发票	商業發票
商业计划	商業計劃
商务代表	商務代表
商品价值	商品價值
商品价格	商品價格
商品目录	商品目錄
商品输出	商品輸出
商科集团	商科集團
啧啧称赞	嘖嘖稱讚
啧啧赞叹	嘖嘖讚歎
啼饥号寒	啼飢號寒
喀布尔河	喀布爾河
喂了一声	喂了一聲
善于词令	善於詞令
善于辞令	善於辭令
善后事宜	善後事宜
善后借款	善後借款
善善恶恶	善善惡惡
善恶不分	善惡不分
善意回应	善意回應
善才童子	善才童子
善罢干休	善罷干休
善财难舍	善財難捨
喉头发干	喉頭發乾
喉干舌燥	喉乾舌燥
喑恶叱咤	喑惡叱吒
喜不自胜	喜不自勝
喜出望外	喜出望外
喜形于色	喜形於色
喜忧参半	喜憂參半
喜极而泣	喜極而泣
喜欢钟表	喜歡鐘錶
喝风呵烟	喝風呵煙
喝风疴烟	喝風痾煙
喷云吐雾	噴雲吐霧
喷云嗳雾	噴雲噯霧
喷气发动	噴氣發動
喷薄欲出	噴薄欲出
嗜血杆菌	嗜血桿菌
嘀嗒的表	嘀嗒的錶
嘀里嘟噜	嘀裏嘟嚕
嘉义师范	嘉義師範
嘉南药专	嘉南藥專
嘉布瑞尔	嘉布瑞爾
嘉柏隆里	嘉柏隆里
嘘下台去	噓下臺去
嘘下台来	噓下臺來
噙齿戴发	噙齒戴髮
噜噜苏苏	嚕嚕囌囌
噪音控制	噪音控制
噪音管制	噪音管制
嚼舌自尽	嚼舌自盡
囉囉苏苏	囉囉囌囌
囊橐丰盈	囊橐豐盈
囊温郎当	囊溫郎當
囚首丧面	囚首喪面
囚首垢面	囚首垢面
四万一千	四萬一千
四万七千	四萬七千
四万三千	四萬三千
四万两千	四萬兩千
四万五千	四萬五千
四万八千	四萬八千
四万六千	四萬六千
四万四千	四萬四千
四世同堂	四世同堂
四个坚持	四個堅持
四代同堂	四代同堂
四停八当	四停八當
四六面体	四六面體
四出征收	四出徵收
四出祁山	四出祁山
四分历史	四分歷史
四十一万	四十一萬
四十五万	四十五萬
四十四万	四十四萬
四十多万	四十多萬
四千两百	四千兩百
四千多万	四千多萬
四大发明	四大發明
四大须生	四大鬚生
四弘誓愿	四弘誓願
四方八面	四方八面
四方台区	四方臺區
四海升平	四海昇平
四海皆准	四海皆准
四百多万	四百多萬
四舍五入	四捨五入
四舍六入	四捨六入
四邻八舍	四鄰八舍
四部合唱	四部合唱
四面八方	四面八方
四面受困	四面受困
四面受敌	四面受敵
四面楚歌	四面楚歌
四面玲珑	四面玲瓏
四面见光	四面見光
回信地址	回信地址
回光返照	迴光返照
回味无穷	回味無窮
回嗔作喜	回嗔作喜
回回鼻子	回回鼻子
回声定位	回聲定位
回声探测	迴聲探測
回复青春	回復青春
回天之力	回天之力
回天乏术	回天乏術
回头一看	回頭一看
回头掣脑	回頭掣腦
回头是岸	回頭是岸
回头车子	回頭車子
回家路上	回家路上
回家途中	回家途中
回山倒海	回山倒海
回归中国	回歸中國
回心转意	回心轉意
回想起来	回想起來
回折格子	回折格子
回收价值	回收價值
回教世界	回教世界
回教信徒	回教信徒
回教圣战	回教聖戰
回教帝国	回教帝國
回文织锦	迴文織錦
回旋余地	回旋餘地
回旋加速	回旋加速
回春作用	回春作用
回清倒影	迴清倒影
回炉复帐	回爐復帳
回环转折	迴環轉折
回生乏术	回生乏術
回生起死	回生起死
回眸一笑	回眸一笑
回禄之灾	回祿之災
回答出来	回答出來
回肠九回	回腸九回
回肠九转	迴腸九轉
回肠伤气	迴腸傷氣
回肠寸断	迴腸寸斷
回肠荡气	迴腸蕩氣
回航途中	回航途中
回船转舵	回船轉舵
回转半径	回轉半徑
回转寿司	回轉壽司
回避学习	迴避學習
回邮信封	回郵信封
回阳荡气	迴陽蕩氣
回顾历史	回顧歷史
回顾过去	回顧過去
回馈作用	回饋作用
回馈控制	回饋控制
回黄倒皂	回黃倒皂
回黄转绿	回黃轉綠
因事制宜	因事制宜
因地制宜	因地制宜
因奸成孕	因姦成孕
因时制宜	因時制宜
因果关系	因果關係
因缘巧合	因緣巧合
团体冠军	團體冠軍
团体协约	團體協約
团体意识	團體意識
团体治疗	團體治療
团体活动	團體活動
团体行动	團體行動
团体规范	團體規範
团体辅导	團體輔導
团团围住	團團圍住
团头团脸	團頭團臉
团头聚面	團頭聚面
团沙羣岛	團沙羣島
团结一心	團結一心
团结一致	團結一致
团结工会	團結工會
团队精神	團隊精神
困倦起来	困倦起來
困兽之斗	困獸之鬥
困兽犹斗	困獸猶鬥
困处泥涂	困處泥塗
困心衡虑	困心衡慮
困惑不解	困惑不解
困知勉行	困知勉行
困难在于	困難在於
困难重重	困難重重
固定汇率	固定匯率
国之桢干	國之楨榦
国共两党	國共兩黨
国共合作	國共合作
国困民艰	國困民艱
国土规划	國土規劃
国外汇兑	國外匯兌
国大代表	國大代表
国家制度	國家制度
国家标准	國家標準
国家栋梁	國家棟梁
国家规范	國家規範
国建计划	國建計劃
国戚皇亲	國戚皇親
国民党员	國民黨員
国民党版	國民黨版
国民党籍	國民黨籍
国穷民困	國窮民困
国防体制	國防體制
国际公制	國際公制
国际关系	國際關係
国际准备	國際準備
国际合作	國際合作
国际学舍	國際學舍
国际标准	國際標準
国际水准	國際水準
国际漫游	國際漫遊
国际舞台	國際舞臺
国际贷借	國際貸借
图书目录	圖書目錄
图书馆周	圖書館週
图亚克拜	圖亞克拜
图形界面	圖形界面
图文并茂	圖文並茂
图木舒克	圖木舒克
图表说明	圖表說明
图财致命	圖財致命
图资系统	圖資系統
图里亚夫	圖里亞夫
囿于一时	囿於一時
囿于成见	囿於成見
圆周运动	圓周運動
圆形面包	圓形麵包
圆锥曲线	圓錐曲綫
圆面大耳	圓面大耳
土中曲蟮	土中曲蟮
土司面包	土司麵包
土地征收	土地徵收
土地重划	土地重劃
土壤冲蚀	土壤沖蝕
土托鱼羹	土托魚羹
土法炼钢	土法煉鋼
土洋并举	土洋並舉
土洋结合	土洋結合
土里土气	土裏土氣
圣修伯里	聖修伯里
圣克鲁斯	聖克魯斯
圣哈辛托	聖哈辛托
圣帕台风	聖帕颱風
圣帕强台	聖帕強颱
圣帕袭台	聖帕襲臺
圣杰门队	聖傑門隊
圣诞百合	聖誕百合
在台协会	在臺協會
在家出家	在家出家
在此之后	在此之後
在线冲值	在綫沖值
在线升级	在綫升級
在线回复	在綫回復
在线游戏	在綫游戲
在职干部	在職幹部
在职进修	在職進修
在范围内	在範圍內
地下修文	地下修文
地下害虫	地下害蟲
地下工厂	地下工廠
地下开采	地下開採
地下水面	地下水面
地下电台	地下電臺
地下签赌	地下簽賭
地下通汇	地下通匯
地丑德齐	地醜德齊
地价公告	地價公告
地区冲突	地區衝突
地区差价	地區差價
地塞米松	地塞米松
地复天翻	地覆天翻
地大物丰	地大物豐
地尽其利	地盡其利
地方戏曲	地方戲曲
地方色彩	地方色彩
地板运动	地板運動
地灵人杰	地靈人傑
地牛发威	地牛發威
地缘关系	地緣關係
地质年表	地質年表
地质编录	地質編錄
地面控制	地面控制
地面气压	地面氣壓
地面温度	地面溫度
地面灌溉	地面灌溉
地面部队	地面部隊
地面零点	地面零點
场面阔绰	場面闊綽
均权制度	均權制度
均田制度	均田制度
坎塔布连	坎塔布連
坏了性命	壞了性命
坐冷板凳	坐冷板凳
坐台小姐	坐檯小姐
坐困愁城	坐困愁城
坐薪尝胆	坐薪嘗膽
坐领干薪	坐領乾薪
坚白同异	堅白同異
坚臥烟霞	堅臥煙霞
坛坛罐罐	罈罈罐罐
坛坫周旋	壇坫週旋
坛女儿红	罈女兒紅
坛烧刀子	罈燒刀子
坛燒刀子	罈燒刀子
坦坦荡荡	坦坦蕩蕩
垂了下去	垂了下去
垂了下来	垂了下來
垂于将来	垂於將來
垂帘听政	垂簾聽政
垂死挣扎	垂死掙扎
垂涎欲滴	垂涎欲滴
垂直搜索	垂直搜索
垂范百世	垂範百世
垂裕后昆	垂裕後昆
垂馨千祀	垂馨千祀
垃圾回收	垃圾回收
垄断价格	壟斷價格
垄断资产	壟斷資產
垄断集团	壟斷集團
型别转换	型別轉換
埃及历史	埃及歷史
埃及艳后	埃及豔后
埃夫伯里	埃夫伯里
埃布罗河	埃布羅河
埃德蒙顿	埃德蒙頓
埃格尔松	埃格爾松
埋头寻表	埋頭尋錶
埋头寻钟	埋頭尋鐘
埋头苦干	埋頭苦幹
埋杆竖柱	埋杆豎柱
埋没人才	埋沒人才
城市规划	城市規劃
域名抢注	域名搶注
域名注册	域名註冊
培养出来	培養出來
培美曲塞	培美曲塞
培育出来	培育出來
基克维特	基克維特
基因修改	基因修改
基因技术	基因技術
基因表达	基因表達
基尔库克	基爾庫克
基性岩石	基性岩石
基本词汇	基本詞彙
基里兰柯	基里蘭柯
基里巴斯	基里巴斯
堂分姑娘	堂分姑娘
堆案盈几	堆案盈几
堕云雾中	墮雲霧中
堤拉米苏	隄拉米蘇
堪为表率	堪爲表率
堪当重任	堪當重任
堪称典范	堪稱典範
塔吉克人	塔吉克人
塔吉克族	塔吉克族
塔娜苏冈	塔娜蘇岡
塔娜苏甘	塔娜蘇甘
塔罗维克	塔羅維克
塔里木河	塔里木河
塞尔提克	塞爾提克
塞尔蒂克	塞爾蒂克
塞耳盗钟	塞耳盜鐘
塞韦里诺	塞韋裏諾
填字游戏	填字遊戲
墙面而立	牆面而立
增量参数	增量參數
墨沈未干	墨瀋未乾
墨索里尼	墨索里尼
墨迹未干	墨蹟未乾
壁立千仞	壁立千仞
士别三日	士別三日
士别多日	士別多日
壮室之秋	壯室之秋
壮志凌云	壯志凌雲
壮志凌霄	壯志凌霄
壮志未酬	壯志未酬
声价不凡	聲價不凡
声价十倍	聲價十倍
声名狼借	聲名狼藉
声如洪钟	聲如洪鐘
声彻云霄	聲徹雲霄
声情并茂	聲情並茂
声类系统	聲類系統
壸口瀑布	壺口瀑布
壸里干坤	壺裏乾坤
壹败涂地	壹敗塗地
处女表演	處女表演
备尝忧患	備嘗憂患
备尝艰苦	備嘗艱苦
备尝艰辛	備嘗艱辛
备尝辛苦	備嘗辛苦
备抵折旧	備抵折舊
复仇雪耻	復仇雪恥
复仞年如	複仞年如
复以百万	複以百萬
复健中心	復健中心
复健医学	復健醫學
复兴中学	復興中學
复兴剧校	復興劇校
复兴北路	復興北路
复兴南路	復興南路
复兴基地	復興基地
复兴工商	復興工商
复兴广播	復興廣播
复兴时代	復興時代
复兴高中	復興高中
复军杀将	覆軍殺將
复利计算	複利計算
复制下来	複製下來
复去翻来	覆去翻來
复变函数	複變函數
复合企业	複合企業
复合传动	複合傳動
复合元音	複合元音
复合包装	複合包裝
复合命题	複合命題
复合增长	複合增長
复合摄影	複合攝影
复合材料	複合材料
复合样式	複合樣式
复合概念	複合概念
复合母音	複合母音
复合肥料	複合肥料
复合装甲	複合裝甲
复合量词	複合量詞
复合金属	複合金屬
复合韵母	複合韻母
复员军人	複員軍人
复地翻天	覆地翻天
复子明辟	復子明辟
复宗灭祀	覆宗滅祀
复宗绝嗣	覆宗絕嗣
复宗绝祀	覆宗絕祀
复巢倾卵	覆巢傾卵
复巢毁卵	覆巢毀卵
复巢破卵	覆巢破卵
复庇之恩	覆庇之恩
复康巴士	復康巴士
复建中心	復建中心
复式关税	複式關稅
复式教学	複式教學
复式路面	複式路面
复数平面	複數平面
复数形式	複數形式
复旦大学	復旦大學
复旧如新	復舊如新
复杂劳动	複雜勞動
复杂生产	複雜生產
复杂系统	複雜系統
复殖吸虫	複殖吸蟲
复氧能力	復氧能力
复水难收	覆水難收
复活节岛	復活節島
复海移山	覆海移山
复盂之固	覆盂之固
复盂之安	覆盂之安
复盆之冤	覆盆之冤
复盆难照	覆盆難照
复盘难照	覆盤難照
复礼克己	復禮克己
复种指数	複種指數
复舟载舟	覆舟載舟
复蕉寻鹿	覆蕉尋鹿
复蹈其辙	復蹈其轍
复蹈前辙	復蹈前轍
复车之戒	覆車之戒
复车之轨	覆車之軌
复车之辙	覆車之轍
复车之鉴	覆車之鑑
复车当戒	覆車當戒
复车继轨	覆車繼軌
复辙重蹈	覆轍重蹈
复辟事件	復辟事件
复雨翻云	覆雨翻雲
复鹿寻蕉	覆鹿尋蕉
复鹿遗蕉	覆鹿遺蕉
复𫗧之忧	覆餗之憂
复𫗧之患	覆餗之患
复𫗧之衅	覆餗之釁
夏姆锡克	夏姆錫克
夏川里美	夏川里美
夏炉冬扇	夏爐冬扇
夏虫朝菌	夏蟲朝菌
夏鑪冬扇	夏鑪冬扇
外交代表	外交代表
外交关系	外交關係
外出访问	外出訪問
外合里差	外合裏差
外合里应	外合裏應
外强中干	外強中乾
外御其侮	外禦其侮
外来物种	外來物種
外松内紧	外鬆內緊
外汇储备	外匯儲備
外汇兑换	外匯兌換
外汇存底	外匯存底
外汇市场	外匯市場
外汇收入	外匯收入
外汇汇率	外匯匯率
外汇管制	外匯管制
外汇银行	外匯銀行
外科学系	外科學系
外科手术	外科手術
外部链接	外部鏈接
外面儿光	外面兒光
夙心往志	夙心往志
夙愿以偿	夙願以償
多不胜数	多不勝數
多义关系	多義關係
多事之秋	多事之秋
多事逞才	多事逞才
多云偶雨	多雲偶雨
多云有雨	多雲有雨
多党选举	多黨選舉
多凶少吉	多凶少吉
多出电影	多齣電影
多功能表	多功能表
多历年代	多歷年代
多历年所	多歷年所
多吃多占	多吃多佔
多哈回合	多哈回合
多姿多彩	多姿多彩
多姿多采	多姿多采
多层复迭	多層複迭
多彩多姿	多彩多姿
多情种子	多情種子
多才多艺	多才多藝
多拉尔蒙	多拉爾蒙
多模光纤	多模光纖
多特蒙德	多特蒙德
多种多样	多種多樣
多种经营	多種經營
多种语言	多種語言
多管闲事	多管閒事
多米尼克	多米尼克
多蒙寄声	多蒙寄聲
多蒙推毂	多蒙推轂
多蒙药石	多蒙藥石
多轨录音	多軌錄音
多边合作	多邊合作
多采多姿	多采多姿
夜半钟声	夜半鐘聲
夜暗风高	夜暗風高
夜色迷蒙	夜色迷濛
夜谭随录	夜譚隨錄
大一统志	大一統誌
大不相同	大不相同
大不里士	大不里士
大专同学	大專同學
大业千秋	大業千秋
大仁药专	大仁藥專
大便干燥	大便乾燥
大修道院	大修道院
大傢伙儿	大傢伙兒
大出其汗	大出其汗
大出锋头	大出鋒頭
大出风头	大出風頭
大别山脉	大別山脈
大力发展	大力發展
大动干戈	大動干戈
大千世界	大千世界
大协奏曲	大協奏曲
大厦栋梁	大廈棟梁
大发利市	大發利市
大发慈悲	大發慈悲
大发牢骚	大發牢騷
大发神威	大發神威
大发脾气	大發脾氣
大发雷霆	大發雷霆
大叔于田	大叔于田
大台北区	大臺北區
大叶合欢	大葉合歡
大叶大学	大葉大學
大同世界	大同世界
大同主义	大同主義
大同之世	大同之世
大同商专	大同商專
大同国中	大同國中
大同大学	大同大學
大同小异	大同小異
大同煤矿	大同煤礦
大同盆地	大同盆地
大同社会	大同社會
大团白脸	大團白臉
大国家党	大國家黨
大地回春	大地回春
大地春回	大地春回
大型钟表	大型鐘錶
大型钟面	大型鐘面
大天后宫	大天后宮
大头面目	大頭面目
大奸似忠	大奸似忠
大家伙儿	大家夥兒
大家风范	大家風範
大干一场	大幹一場
大干一票	大幹一票
大干特干	大幹特幹
大才小用	大才小用
大才槃槃	大才槃槃
大打出手	大打出手
大打折扣	大打折扣
大批涌到	大批涌到
大摆褶子	大擺褶子
大摇大摆	大搖大擺
大放异彩	大放異彩
大放异采	大放異采
大政方针	大政方針
大敌当前	大敵當前
大斗小秤	大斗小秤
大旱云霓	大旱雲霓
大明历史	大明歷史
大明大摆	大明大擺
大是不同	大是不同
大有分别	大有分別
大有斩获	大有斬獲
大本钟敲	大本鐘敲
大气折射	大氣折射
大水冲溺	大水沖溺
大汗淋漓	大汗淋漓
大沽炮台	大沽砲臺
大海捞针	大海撈針
大涨小回	大漲小回
大溪豆干	大溪豆幹
大病初愈	大病初癒
大目干连	大目乾連
大秋作物	大秋作物
大笨钟敲	大笨鐘敲
大而无当	大而無當
大肆搜捕	大肆搜捕
大肠杆菌	大腸桿菌
大脚婆娘	大腳婆娘
大致说来	大致說來
大获全胜	大獲全勝
大衍历史	大衍歷史
大表惊叹	大表驚歎
大言非夸	大言非夸
大费周折	大費周折
大费周章	大費周章
大金发苔	大金髮苔
大陆同胞	大陸同胞
大陆板块	大陸板塊
大陆气团	大陸氣團
大陆法系	大陸法系
大陪审团	大陪審團
大雨如注	大雨如注
大面儿上	大面兒上
大面皮儿	大面皮兒
大马步挂	大馬步掛
大麻里乡	大麻里鄉
天下杂志	天下雜誌
天人合一	天人合一
天人永别	天人永別
天从人愿	天從人願
天作之合	天作之合
天克地冲	天剋地衝
天冬氨酸	天冬氨酸
天冬酰胺	天冬醯胺
天地万物	天地萬物
天地为范	天地爲範
天地之别	天地之別
天地可表	天地可表
天地志狼	天地志狼
天壤之别	天壤之別
天复地载	天覆地載
天妒英才	天妒英才
天孙娘娘	天孫娘娘
天差地别	天差地別
天干地支	天干地支
天干物燥	天乾物燥
天心和合	天心和合
天才儿童	天才兒童
天才教育	天才教育
天才横溢	天才橫溢
天文学钟	天文學鐘
天日之表	天日之表
天昏地暗	天昏地暗
天机云锦	天機雲錦
天津师范	天津師範
天渊之别	天淵之別
天然纤维	天然纖維
天纵之才	天縱之才
天缘凑合	天緣湊合
天缘巧合	天緣巧合
天缘注定	天緣注定
天翻地复	天翻地覆
天翻地覆	天翻地覆
天覆地载	天覆地載
天路历程	天路歷程
天门冬科	天門冬科
天随人愿	天隨人願
太乙神针	太乙神針
太仆寺卿	太僕寺卿
太仆寺旗	太僕寺旗
太初历史	太初歷史
太子舍人	太子舍人
太平御览	太平御覽
太极图说	太極圖說
太皇太后	太皇太后
太空艺术	太空藝術
太阳能板	太阳能板
太麻里乡	太麻里鄉
太麻里溪	太麻里溪
夫妇关系	夫婦關係
夫妇合璧	夫婦合璧
夫妇好合	夫婦好合
夫妻关系	夫妻關係
央浼营干	央浼營幹
夯土建筑	夯土建築
失之毫厘	失之毫釐
失信于人	失信於人
失张失志	失張失志
失而复得	失而復得
失饥伤饱	失飢傷飽
头发上指	頭髮上指
头发了狂	頭發了狂
头发了疯	頭發了瘋
头发壳子	頭髮殼子
头昏眼暗	頭昏眼暗
头破血出	頭破血出
头脑发胀	頭腦發脹
头面人物	頭面人物
夸下海口	誇下海口
夸多斗靡	誇多鬥靡
夸大不实	誇大不實
夸大之词	誇大之詞
夸大其词	誇大其詞
夸大其辞	誇大其辭
夸夸其谈	誇誇其談
夸张其辞	誇張其辭
夸强说会	誇強說會
夸才卖智	誇才賣智
夸来夸去	誇來誇去
夸父逐日	夸父逐日
夸胜道强	誇勝道強
夸能斗智	誇能鬥智
夸诞不经	夸誕不經
夹心饼干	夾心餅乾
夺眶而出	奪眶而出
夺门而出	奪門而出
奇丑无比	奇醜無比
奇冤极枉	奇冤極枉
奇异夸克	奇異夸克
奇才异能	奇才異能
奇袭战术	奇襲戰術
奉公克己	奉公剋己
奉毂后车	奉轂後車
奉系军阀	奉系軍閥
奋勇向前	奮勇向前
奋勇当先	奮勇當先
奋发向上	奮發向上
奋发图强	奮發圖強
奋发有为	奮發有爲
奋发自强	奮發自強
奋发蹈厉	奮發蹈厲
奋斗不懈	奮鬥不懈
奋斗到底	奮鬥到底
奋斗目标	奮鬥目標
奎尼匹克	奎尼匹克
奏鸣曲式	奏鳴曲式
契合金兰	契合金蘭
奖励制度	獎勵制度
套装旅游	套裝旅遊
奥士力克	奧士力克
奥密克戎	奧密克戎
奥德修斯	奧德修斯
奥托瓦兹	奧托瓦茲
奥林匹克	奧林匹克
奥特朗托	奧特朗托
奥迪修斯	奧迪修斯
奥里萨省	奧里薩省
奥里萨邦	奧里薩邦
奥里里亚	奧里里亞
女丑剧场	女丑劇場
女中豪杰	女中豪傑
女修道张	女修道張
女修道院	女修道院
女大当嫁	女大當嫁
女大须嫁	女大須嫁
女性厌恶	女性厭惡
女性艺术	女性藝術
女生外向	女生外嚮
女系家族	女系家族
女貌郎才	女貌郎才
女长须嫁	女長須嫁
奴隶制度	奴隸制度
奸人之雄	奸人之雄
奸同鬼蜮	奸同鬼蜮
奸夫淫妇	姦夫淫婦
奸官污吏	奸官汙吏
奸淫掳掠	姦淫擄掠
奸盗邪淫	姦盜邪淫
奸胥猾吏	奸胥猾吏
奸诈不级	奸詐不級
好兵帅克	好兵帥克
好几十万	好幾十萬
好几千万	好幾千萬
好几百万	好幾百萬
好出风头	好出風頭
好勇斗狠	好勇鬥狠
好善嫉恶	好善嫉惡
好善恶恶	好善惡惡
好好地干	好好地幹
好戏连台	好戲連臺
好手如云	好手如雲
好气万千	好氣萬千
好生恶杀	好生惡殺
好管闲事	好管閒事
好自矜夸	好自矜誇
好话说尽	好話說盡
好谀恶直	好諛惡直
好逸恶劳	好逸惡勞
好酒贪杯	好酒貪杯
如不胜衣	如不勝衣
如临深谷	如臨深谷
如临渊谷	如臨淵谷
如入云端	如入雲端
如出一口	如出一口
如出一辙	如出一轍
如坐云雾	如坐雲霧
如坐针毡	如坐鍼氈
如堕烟雾	如墮煙霧
如愿以偿	如願以償
如所周知	如所周知
如日东升	如日東昇
如日方升	如日方升
如有雷同	如有雷同
如法泡制	如法泡製
如法炮制	如法炮製
如获珍宝	如獲珍寶
如获至宝	如獲至寶
如隔三秋	如隔三秋
如饥似渴	如飢似渴
如饥如渴	如飢如渴
妇人生须	婦人生鬚
妇女团体	婦女團體
妇女杂志	婦女雜誌
妖术惑众	妖術惑眾
妖术邪法	妖術邪法
妖气冲天	妖氣衝天
妖里妖气	妖里妖氣
妙发灵机	妙發靈機
妙手回春	妙手回春
妙探寻凶	妙探尋兇
姑息养奸	姑息養奸
委曲成全	委曲成全
委曲求全	委曲求全
委派代表	委派代表
委罪于人	委罪於人
姜家大被	姜家大被
姜就是老	薑就是老
姜桂老辣	薑桂老辣
姜还是老	薑還是老
威克菲尔	威克菲爾
威布里吉	威布里吉
威比苏诺	威比蘇諾
威风八面	威風八面
娇嫩欲滴	嬌嫩欲滴
娇艳欲滴	嬌豔欲滴
娇袅不胜	嬌嫋不勝
娴于辞令	嫻於辭令
婚前婚后	婚前婚後
婚姻制度	婚姻制度
媚如秋月	媚如秋月
媮合苟容	媮合苟容
嫁个老公	嫁個老公
嫁祸于人	嫁禍於人
嫉恶好善	嫉惡好善
嫉恶如仇	嫉惡如仇
嫉恶若仇	嫉惡若仇
嫌好道丑	嫌好道醜
嫌好道恶	嫌好道惡
嫠忧宗周	嫠憂宗周
子之丰兮	子之丰兮
子姜炒鸡	子薑炒鶏
子孙娘娘	子孫娘娘
子曰诗云	子曰詩云
子癫前症	子癲前症
孔明借箭	孔明借箭
孔章望斗	孔章望斗
字里行间	字裏行間
字面意义	字面意義
字面意思	字面意思
字面解释	字面解釋
存亡之秋	存亡之秋
存亡未卜	存亡未卜
存托凭证	存託憑證
孟什维克	孟什維克
孟德尔松	孟德爾松
季布一诺	季布一諾
季札挂剑	季札掛劍
季瑟雅克	季瑟雅克
季节洄游	季節洄游
孤云野鹤	孤雲野鶴
孤军奋斗	孤軍奮鬥
孤寡不谷	孤寡不穀
孤形只影	孤形隻影
孤形吊影	孤形吊影
孤注一掷	孤注一擲
孤灯挑尽	孤燈挑盡
孤身只影	孤身隻影
孤辰合注	孤辰合注
学习曲线	學習曲綫
学习范例	學習範例
学习计划	學習計劃
学以致用	學以致用
学优才赡	學優才贍
学位制度	學位制度
学力鉴定	學力鑑定
学术团体	學術團體
学术报告	學術報告
学术水平	學術水平
学术研究	學術研究
学术网路	學術網路
学术自由	學術自由
学校同学	學校同學
学浅才疏	學淺才疏
学疏才浅	學疏才淺
孽障种子	孽障種子
宁夏回族	寧夏回族
宁当玉碎	寧當玉碎
宁折不弯	寧折不彎
宁静致远	寧靜致遠
守先待后	守先待後
守正不回	守正不回
守节不回	守節不回
安于一隅	安於一隅
安于泰山	安於泰山
安于现状	安於現狀
安仁鬓秋	安仁鬢秋
安克拉治	安克拉治
安克雷奇	安克雷奇
安全系数	安全係數
安全系统	安全系統
安全防范	安全防範
安吉里科	安吉里科
安布罗斯	安布羅斯
安步当车	安步當車
安沈铁路	安瀋鐵路
安营扎寨	安營紮寨
安适如常	安適如常
安闲惬意	安閒愜意
安闲自在	安閒自在
安闲自得	安閒自得
安闲舒适	安閒舒適
安闲随意	安閒隨意
安魂弥撒	安魂彌撒
完全愈复	完全癒復
完全正确	完全正確
完税价格	完稅價格
完税货价	完稅貨價
宏碁集团	宏碁集團
宗教团体	宗教團體
宗法制度	宗法制度
官兵一致	官兵一致
官商合办	官商合辦
官地为采	官地爲寀
官复原职	官復原職
官报私仇	官報私仇
官私合营	官私合營
定义范围	定義範圍
定于一尊	定於一尊
定向培育	定向培育
定向天线	定向天綫
定向越野	定向越野
定时号志	定時號誌
宛若游龙	宛若游龍
宛转周折	宛轉周折
宝山空回	寶山空回
宝里宝气	寶里寶氣
宝钢集团	寶鋼集團
实业计划	實業計劃
实况录影	實況錄影
实况录音	實況錄音
实时技术	實時技術
实用价值	實用價值
实际范围	實際範圍
审囚刷卷	審囚刷卷
审曲面势	審曲面勢
审级制度	審級制度
审计范围	審計範圍
客串演出	客串演出
客如云集	客如雲集
宣布无效	宣佈無效
宣布独立	宣佈獨立
宣布破产	宣布破產
宣誓代表	宣誓代表
室內乐团	室內樂團
家庭制度	家庭制度
家庭计划	家庭計劃
家族同盟	家族同盟
家无斗储	家無斗儲
家财万贯	家財萬貫
家赀万贯	家貲萬貫
家长里短	家長里短
家门不幸	家門不幸
家门有幸	家門有幸
容光焕发	容光煥發
容后说明	容後說明
宽宽松松	寬寬鬆鬆
宽打周遭	寬打周遭
宾主关系	賓主關係
宾主尽欢	賓主盡歡
宾客如云	賓客如雲
宿愿已偿	宿願已償
宿愿得偿	宿願得償
宿舍网路	宿舍網路
寄挂号信	寄掛號信
寄生昆虫	寄生昆蟲
寄生虫病	寄生蟲病
密云不雨	密雲不雨
密切关系	密切關係
密切注意	密切注意
密切注视	密切注視
密密扎扎	密密扎扎
密苏里州	密蘇里州
密苏里河	密蘇里河
富于想像	富於想像
富兰克林	富蘭克林
富富有余	富富有餘
富布赖特	富布賴特
富贵浮云	富貴浮雲
寒冬腊月	寒冬臘月
寒武爆发	寒武爆發
寒波荡漾	寒波盪漾
寓兵于农	寓兵於農
寓教于乐	寓教於樂
寓禁于征	寓禁於征
寝丘之志	寢丘之志
察布查尔	察布査爾
寥寥无几	寥寥無幾
寸丝不挂	寸絲不掛
寸发千金	寸髮千金
对了槛儿	對了檻兒
对冲基金	對衝基金
对准目标	對準目標
对准钟表	對準鐘錶
对华发动	對華發動
对合起来	對合起來
对外关系	對外關係
对天发誓	對天發誓
对流云系	對流雲系
对焦范围	對焦範圍
对症下药	對症下藥
对症发药	對症發藥
对等关系	對等關係
对酒当歌	對酒當歌
寻幽探胜	尋幽探勝
寻幽访胜	尋幽訪勝
寻找出来	尋找出來
寻来范畴	尋來範疇
寻求出来	尋求出來
导向思考	導向思考
导向飞弹	導向飛彈
导向鱼雷	導向魚雷
导引之术	導引之術
导引系统	導引系統
导弹系统	導彈系統
导气之术	導氣之術
导致死亡	導致死亡
导航系统	導航系統
寿数已尽	壽數已盡
封侯万里	封侯萬里
封官许愿	封官許願
封建制度	封建制度
封建割据	封建割據
封杀出局	封殺出局
封胡羯末	封胡羯末
封胡遏末	封胡遏末
封面人物	封面人物
封面女郎	封面女郎
封面设计	封面設計
射影几何	射影幾何
射频干扰	射頻干擾
射频识别	射頻識別
将假当真	將假當真
将功折罪	將功折罪
将功折过	將功折過
将尽未尽	將盡未盡
将遇良才	將遇良才
将门之后	將門之後
小丑丫鬟	小醜丫鬟
小丑跳梁	小醜跳樑
小人得志	小人得志
小众艺术	小眾藝術
小千世界	小千世界
小型柜橱	小型櫃櫥
小型钟表	小型鐘錶
小型钟面	小型鐘面
小姑娘树	小姑娘樹
小子后生	小子後生
小廉曲谨	小廉曲謹
小才大用	小才大用
小时了了	小時了了
小步舞曲	小步舞曲
小泽征尔	小澤征爾
小红萝卜	小紅蘿蔔
小花远志	小花遠志
小苏打粉	小蘇打粉
小萝卜头	小蘿蔔頭
小表姊夫	小表姊夫
小里小气	小裏小氣
小针美容	小針美容
小鬼当家	小鬼當家
少年才俊	少年才俊
少惹闲事	少惹閒事
少私寡欲	少私寡慾
少管闲事	少管閒事
少说几句	少說幾句
尘襟尽涤	塵襟盡滌
尘饭涂羹	塵飯塗羹
尝尽心酸	嘗盡心酸
尝来尝去	嚐來嚐去
尝胆臥薪	嘗膽臥薪
尝鼎一脔	嘗鼎一臠
尤云殢雨	尤雲殢雨
尤克利斯	尤克利斯
尤克勒斯	尤克勒斯
尤克里斯	尤克里斯
尤基里斯	尤基里斯
尤班克斯	尤班克斯
尤里西斯	尤里西斯
尨眉皓发	尨眉皓髮
就干一杯	就乾一杯
就日瞻云	就日瞻雲
就汤下面	就湯下麵
尸位素餐	尸位素餐
尸体剖检	屍體剖檢
尸体解剖	屍體解剖
尸居余气	尸居餘氣
尸居馀气	尸居餘氣
尸居龙见	尸居龍見
尸山血海	屍山血海
尸横遍野	屍橫遍野
尸祝代庖	尸祝代庖
尸禄素餐	尸祿素餐
尸骨无存	屍骨無存
尸骨早寒	屍骨早寒
尸骨未寒	屍骨未寒
尸鸠之仁	尸鳩之仁
尸鸠之平	尸鳩之平
尹邢避面	尹邢避面
尺二秀才	尺二秀才
尺寸千里	尺寸千里
尺寸斗粟	尺寸斗粟
尺布斗粟	尺布斗粟
尺幅千里	尺幅千里
尺板斗食	尺板斗食
尼克劳斯	尼克勞斯
尼勒克县	尼勒克縣
尼坦雅胡	尼坦雅胡
尽人皆知	盡人皆知
尽付东流	盡付東流
尽付阙如	盡付闕如
尽做坏事	盡做壞事
尽兴而归	盡興而歸
尽其在我	盡其在我
尽其所有	盡其所有
尽其所能	盡其所能
尽其所长	盡其所長
尽力去做	儘力去做
尽力而为	儘力而爲
尽善尽美	盡善盡美
尽如人意	盡如人意
尽展所长	盡展所長
尽心图报	盡心圖報
尽心尽力	盡心盡力
尽心竭力	盡心竭力
尽心竭诚	盡心竭誠
尽忠报国	盡忠報國
尽忠竭力	盡忠竭力
尽忠职守	盡忠職守
尽态极妍	盡態極妍
尽情吐露	盡情吐露
尽情尽理	盡情盡理
尽情欢乐	盡情歡樂
尽情欢唱	盡情歡唱
尽情歌唱	盡情歌唱
尽情玩乐	盡情玩樂
尽意随心	儘意隨心
尽收眼底	盡收眼底
尽日穷夜	盡日窮夜
尽有可能	儘有可能
尽欢而散	盡歡而散
尽瘁鞠躬	盡瘁鞠躬
尽盘将军	盡盤將軍
尽管如此	儘管如此
尽美尽善	盡美盡善
尽职尽责	盡職盡責
尽节竭诚	盡節竭誠
尽诚竭节	盡誠竭節
尽释前嫌	盡釋前嫌
尽里边儿	儘裏邊兒
尽量克制	盡量剋制
尾身幸次	尾身幸次
层出不穷	層出不窮
层出叠见	層出疊見
层见叠出	層見疊出
层见迭出	層見迭出
居心险恶	居心險惡
居里夫人	居里夫人
屈一伸万	屈一伸萬
展现出来	展現出來
展露出来	展露出來
属毛离里	屬毛離裏
屡仆屡起	屢仆屢起
屡出新招	屢出新招
屡出狂言	屢出狂言
屡战屡胜	屢戰屢勝
屡顾尔仆	屢顧爾僕
山中白云	山中白雲
山前山后	山前山後
山地同胞	山地同胞
山崩钟应	山崩鐘應
山有扶苏	山有扶蘇
山栖谷隐	山棲谷隱
山栖谷饮	山棲谷飲
山洪暴发	山洪暴發
山穷水尽	山窮水盡
山羊胡子	山羊鬍子
山胡桃木	山胡桃木
山重水复	山重水複
山雨欲来	山雨欲來
岁丰年稔	歲豐年稔
岁寒松柏	歲寒松柏
岁稔年丰	歲稔年豐
岁聿云暮	歲聿云暮
岁计余绌	歲計餘絀
岚烟波影	嵐煙波影
岩墙之下	巖牆之下
岩居穴处	巖居穴處
岩居谷饮	巖居谷飲
岩村明宪	岩村明憲
岩石循环	岩石循環
岩穴之士	巖穴之士
峇峇娘惹	峇峇孃惹
峰回路转	峰迴路轉
崑仑奴传	崑崙奴傳
崑仑山脉	崑崙山脈
嵚埼历落	嶔埼歷落
巅崖峻谷	巔崖峻谷
巍巍荡荡	巍巍蕩蕩
巡回公演	巡迴公演
巡回剧团	巡迴劇團
巡回医疗	巡迴醫療
巡回大使	巡迴大使
巡回学校	巡迴學校
巡回审判	巡迴審判
巡回检査	巡迴檢査
巡回法庭	巡回法庭
巡回演出	巡迴演出
巡回演唱	巡迴演唱
工业体系	工業體系
工业团体	工業團體
工业技术	工業技術
工于心计	工於心計
工作制度	工作制度
工作规范	工作規範
工厂卫生	工廠衛生
工厂工业	工廠工業
工厂布置	工廠布置
工团主义	工團主義
工布江达	工布江達
工矿炸药	工礦炸藥
工程学系	工程學系
工艺美术	工藝美術
左冲右突	左衝右突
左右前后	左右前後
左右摇摆	左右搖擺
左右采之	左右采之
左右采获	左右採獲
左氏春秋	左氏春秋
左邻右舍	左鄰右舍
左邻右里	左鄰右里
巧克力糖	巧克力糖
巧克力色	巧克力色
巧克力酱	巧克力醬
巧发奇中	巧發奇中
巧同造化	巧同造化
巫山云雨	巫山雲雨
差之千里	差之千里
差之毫厘	差之毫釐
差别待遇	差別待遇
差别费率	差別費率
己所不欲	己所不欲
己饥己溺	己飢己溺
已作出保	已作出保
巴人下里	巴人下里
巴克南德	巴克南德
巴克夏猪	巴克夏豬
巴克科思	巴克科思
巴克霍兹	巴克霍茲
巴前算后	巴前算後
巴尔干山	巴爾幹山
巴尔扎克	巴爾扎克
巴尔札克	巴爾札克
巴尔陶克	巴爾陶克
巴布亚省	巴布亞省
巴布亚纽	巴布亞紐
巴布拉族	巴布拉族
巴布狄伦	巴布狄倫
巴斯克人	巴斯克人
巴斯克语	巴斯克語
巴比合金	巴比合金
巴比布朗	巴比布朗
巴氏杆菌	巴氏桿菌
巴洛克式	巴洛克式
巴里坤县	巴裏坤縣
巴马干酪	巴馬乾酪
巾帼须眉	巾幗鬚眉
市不二价	市不二價
市不豫价	市不豫價
市地重划	市地重劃
市场价格	市場價格
市场准入	市場準入
市无二价	市無二價
布什尔省	布什爾省
布伦托海	布倫托海
布兰枯秀	布蘭枯秀
布兰登堡	布蘭登堡
布列兹涅	布列茲涅
布列塔尼	佈列塔尼
布利斯班	布利斯班
布勒斯特	布勒斯特
布匿战争	布匿戰爭
布囊其口	佈囊其口
布尔乔亚	布爾喬亞
布尔代数	布爾代數
布尔哥尼	布爾哥尼
布尔津县	布爾津縣
布帆无恙	布帆無恙
布希威克	布希威克
布希总统	布希總統
布帛菽粟	布帛菽粟
布干维尔	布干維爾
布德施仁	布德施仁
布德施惠	布德施惠
布拉加队	布拉加隊
布拉姆兹	布拉姆茲
布拉姆斯	布拉姆斯
布拉恰诺	布拉恰諾
布拉曼德	布拉曼德
布拉格队	布拉格隊
布拉索夫	布拉索夫
布拉萨市	布拉薩市
布朗克士	布朗克士
布朗克斯	布朗克斯
布朗大学	布朗大學
布朗贝克	布朗貝克
布朗费德	布朗費德
布朗运动	布朗運動
布林代数	布林代數
布林底希	布林底希
布林迪西	布林迪西
布氏杆菌	布氏桿菌
布氏菌苗	布氏菌苗
布氏非鲫	布氏非鯽
布洛斯顿	布洛斯頓
布洛沙德	布洛沙德
布琼布拉	布瓊布拉
布瑞斯特	布瑞斯特
布立吞族	布立吞族
布草衣服	布草衣服
布莱克曼	布萊克曼
布莱克本	布萊克本
布莱希特	布萊希特
布莱德利	布萊德利
布莱德福	布萊德福
布莱德雷	布萊德雷
布莱恩特	布萊恩特
布衣之交	布衣之交
布衣之怒	布衣之怒
布衣卿相	布衣卿相
布衣小民	布衣小民
布衣粝食	布衣糲食
布衣苇带	布衣葦帶
布衣蔬食	布衣蔬食
布衣韦带	布衣韋帶
布衣黔首	布衣黔首
布袋和尚	布袋和尚
布袋戏偶	布袋戲偶
布袋戏馆	布袋戲館
布袜青鞋	布襪青鞋
布被十年	布被十年
布裙荆钗	布裙荊釵
布谷鸟钟	布穀鳥鐘
布达佩斯	布達佩斯
布达拉宫	布達拉宮
布达拉寺	布達拉寺
布达拉山	布達拉山
布道大会	佈道大會
布里亚族	布里亞族
布里坦尼	布里坦尼
布里奇顿	布里奇頓
布里斯托	布里斯托
布里斯本	布里斯本
布里斯班	布里斯班
布里迪雅	布里迪雅
布防迎战	布防迎戰
布阵安营	佈陣安營
布隆伯格	布隆伯格
布隆克特	布隆克特
布隆方丹	布隆方丹
布雷克磨	布雷克磨
布雷封锁	佈雷封鎖
布雷尔港	布雷爾港
布雷希特	布雷希特
布雷速度	佈雷速度
布面相片	布面相片
布须曼人	布須曼人
布鲁乐谷	布魯樂谷
布鲁克斯	布魯克斯
布鲁克林	布魯克林
布鲁克纳	布魯克納
布鲁塞尔	布魯塞爾
布鲁斯特	布魯斯特
布鲁氏菌	布魯氏菌
布鲁金斯	布魯金斯
布鼓雷门	布鼓雷門
师云而云	師云而云
师出无名	師出無名
师出有名	師出有名
师徒合同	師徒合同
师范大学	師範大學
师范学校	師範學校
师范学院	師範學院
师范教育	師範教育
师范毕业	師範畢業
师范附小	師範附小
师范院校	師範院校
希伯来历	希伯來曆
希区考克	希區考克
希布伦市	希布倫市
希斯莱杰	希斯萊傑
希斯雷杰	希斯雷傑
希腊建筑	希臘建築
帐面价值	帳面價值
帕丝齐克	帕絲齊克
帕特里克	帕特里克
帕特里夏	帕特里夏
帕索里尼	帕索里尼
帕罗贝克	帕羅貝克
帕金森症	帕金森症
帝制时代	帝制時代
带发修行	帶髮修行
带团参加	帶團參加
带罪征收	帶罪徵收
带膆貂挂	帶膆貂掛
席丰履厚	席豐履厚
席卷一空	席捲一空
席卷亚洲	席捲亞洲
席卷天下	席捲天下
席卷而来	席捲而來
席卷而逃	席捲而逃
帮个场子	幫個場子
帮懒钻闲	幫懶鑽閒
帮闲钻懒	幫閒鑽懶
帷薄不修	帷薄不修
常任代表	常任代表
常态分布	常態分佈
常绿阔叶	常綠闊葉
常胜将军	常勝將軍
幕前幕后	幕前幕後
幕后人物	幕後人物
幕后新闻	幕後新聞
幕后消息	幕後消息
幕后花絮	幕後花絮
幕后英雄	幕後英雄
干一坛法	幹一壇法
干不干净	乾不乾淨
干不干杯	乾不乾杯
干云蔽日	乾雲蔽日
干净俐落	乾淨俐落
干劲冲天	幹勁衝天
干劲十足	幹勁十足
干卿何事	干卿何事
干卿底事	干卿底事
干啼湿哭	乾啼濕哭
干圆洁净	乾圓潔淨
干坤一掷	乾坤一擲
干坤再造	乾坤再造
干女同事	幹女同事
干女教师	幹女教師
干姬松茸	乾姬松茸
干将莫邪	干將莫邪
干尽一坛	乾盡一罈
干尽一壺	乾盡一壺
干尽一杯	乾盡一杯
干尽一碗	乾盡一碗
干巴巴的	乾巴巴的
干干儿的	乾乾兒的
干干净净	乾乾淨淨
干干巴巴	乾乾巴巴
干干干干	幹幹幹幹
干干淨淨	乾乾淨淨
干干爽爽	乾乾爽爽
干干瘦瘦	乾乾瘦瘦
干干脆脆	乾乾脆脆
干得一杯	乾得一杯
干得三杯	乾得三杯
干得两杯	乾得兩杯
干性皮肤	乾性皮膚
干戈扰攘	干戈擾攘
干扁豆角	干扁豆角
干手净脚	乾手淨腳
干掉一杯	乾掉一杯
干掉一瓶	乾掉一瓶
干掉一碗	乾掉一碗
干掉这杯	乾掉這杯
干掉这碗	乾掉這碗
干掉那杯	乾掉那杯
干掉那碗	乾掉那碗
干旱地区	乾旱地區
干柴烈火	乾柴烈火
干涉现象	干涉現象
干淨俐落	乾淨俐落
干父之蛊	幹父之蠱
干球温度	幹球溫度
干的停当	幹的停當
干纲不振	乾綱不振
干羣关系	幹羣關係
干群关系	幹羣關係
干脆利落	乾脆俐落
干过一杯	乾過一杯
干这一杯	乾這一杯
干这一行	幹這一行
干这种事	幹這種事
干那一杯	乾那一杯
干隆年间	乾隆年間
干隆皇帝	乾隆皇帝
平价住宅	平價住宅
平价商店	平價商店
平准基金	平準基金
平分秋色	平分秋色
平台阶段	平臺階段
平地松林	平地松林
平地楼台	平地樓臺
平地青云	平地青雲
平均股价	平均股價
平复起来	平復起來
平头并进	平頭並進
平平当当	平平當當
平方公里	平方公里
平方千米	平方千米
平易谦冲	平易謙沖
平板玻璃	平板玻璃
平步青云	平步青雲
平行六面	平行六面
平行叶脉	平行葉脈
平行表亲	平行表親
平面几何	平面幾何
平面图形	平面圖形
平面媒体	平面媒體
平面描迹	平面描蹟
平面曲线	平面曲綫
平面测量	平面測量
平面艺术	平面藝術
平面雕刻	平面雕刻
年久失修	年久失修
年复一年	年復一年
年少得志	年少得志
年德并高	年德並高
年金制度	年金制度
年龄特征	年齡特徵
并一不二	併一不二
并不在乎	並不在乎
并世无双	並世無雙
并为一体	併爲一體
并为一家	併爲一家
并介之人	並介之人
并列关系	並列關係
并列冠军	並列冠軍
并列第一	並列第一
并列译文	並列譯文
并垂不朽	並垂不朽
并头之花	並頭之花
并存不悖	並存不悖
并州故乡	並州故鄉
并排而坐	並排而坐
并无不可	並無不可
并无不当	並無不當
并无此事	並無此事
并日而食	並日而食
并曰入淀	並曰入澱
并案处理	併案處理
并概青云	並概青雲
并翼齐飞	並翼齊飛
并肩作战	並肩作戰
并肩前进	並肩前進
并肩而行	並肩而行
并行不悖	並行不悖
并行程序	並行程序
并行计算	並行計算
并赃拿败	並贓拿敗
并赃拿贼	併贓拿賊
并赃治罪	併贓治罪
并驾齐驱	並駕齊驅
幸不辱命	幸不辱命
幸为先容	幸爲先容
幸免于难	倖免於難
幸感歌姬	倖感歌姬
幸灾乐祸	幸災樂禍
幸福家庭	幸福家庭
幸福戏院	幸福戲院
幸获识荆	幸獲識荊
幸运之星	幸運之星
幸运之神	幸運之神
幸运抽奖	幸運抽獎
幺麽小丑	幺麼小丑
幼发拉底	幼發拉底
幼稚师范	幼稚師範
幽幽暗暗	幽幽暗暗
幽栖岩谷	幽棲巖谷
广东炒面	廣東炒麵
广厦万间	廣廈萬間
广播电台	廣播電臺
广播系统	廣播系統
庄周梦蝶	莊周夢蝶
庄园制度	莊園制度
庄士顿道	莊士頓道
庄舄越吟	莊舄越吟
庆历新政	慶曆新政
庇里牛斯	庇里牛斯
庐山面目	廬山面目
库仑定律	庫侖定律
库克群岛	庫克羣島
库克船长	庫克船長
库尔斯克	庫爾斯克
库布里克	庫布裏克
库贾氏症	庫賈氏症
库辛尼克	庫辛尼克
库里尔台	庫里爾臺
库里提巴	庫裏提巴
应付得当	應付得當
应付票据	應付票據
应急出口	應急出口
应收票据	應收票據
应时当令	應時當令
应有尽有	應有盡有
应用平台	應用平臺
应用技术	應用技術
应用范例	應用範例
应用范围	應用範圍
应运而出	應運而出
底格里斯	底格里斯
底脚里人	底腳裏人
店面广告	店面廣告
庞巴瓦克	龐巴瓦克
庞德维克	龐德維克
庞琴曲线	龐琴曲綫
庞眉白发	龐眉白髮
庞眉皓发	龐眉皓髮
度假胜地	度假勝地
度身定制	度身定制
庵罗树园	菴羅樹園
庶几无愧	庶幾無愧
康乃狄克	康乃狄克
康复医学	康復醫學
康庄大道	康庄大道
康纳克立	康納克立
廪膳秀才	廩膳秀才
延陵挂剑	延陵掛劍
廷争面折	廷爭面折
廷巴克图	廷巴克圖
建教合作	建教合作
建立规范	建立規範
建筑工业	建築工業
建筑工人	建築工人
建筑工地	建築工地
建筑工程	建築工程
建筑执照	建築執照
建筑机械	建築機械
建筑材料	建築材料
建筑法规	建築法規
建筑结构	建築結構
建筑艺术	建築藝術
建筑设计	建築設計
建筑起来	建築起來
建筑面积	建築面積
开云见日	開雲見日
开刀手术	開刀手術
开列于后	開列於後
开卷有得	開卷有得
开卷有益	開卷有益
开发中国	開發中國
开发人员	開發人員
开发出来	開發出來
开发周期	開發週期
开发国家	開發國家
开发基金	開發基金
开发环境	開發環境
开发过程	開發過程
开发银行	開發銀行
开台圣王	開臺聖王
开台锣鼓	開臺鑼鼓
开天辟地	開天闢地
开支范围	開支範圍
开放系统	開放系統
开放舞台	開放舞臺
开明专制	開明專制
开棺验尸	開棺驗屍
开疆辟土	開疆闢土
开盘汇率	開盤匯率
开诚布公	開誠佈公
开辟出来	開闢出來
开除党籍	開除黨籍
开齐合撮	開齊合撮
异中求同	異中求同
异口同声	異口同聲
异口同辞	異口同辭
异口同音	異口同音
异曲同工	異曲同工
异派同源	異派同源
异苔同岑	異苔同岑
异路同归	異路同歸
异途同归	異途同歸
弃宗弄赞	棄宗弄贊
弃弓折箭	棄弓折箭
弃恶从善	棄惡從善
弃暗投明	棄暗投明
弃武修文	棄武修文
弃瑕录用	棄瑕錄用
弄盏传杯	弄盞傳杯
弄粉调朱	弄粉調朱
弄鬼吊猴	弄鬼弔猴
弊帚千金	弊帚千金
弓不虚发	弓不虛發
弓影杯蛇	弓影杯蛇
弓影浮杯	弓影浮杯
弓折矢尽	弓折矢盡
弓折箭尽	弓折箭盡
弓腰曲背	弓腰曲背
引人入胜	引人入勝
引人注意	引人注意
引人注目	引人注目
引以为鉴	引以爲鑑
引体向上	引體向上
引信系统	引信系統
引发物质	引發物質
引渡回国	引渡回國
引线穿针	引綫穿針
引经据典	引經據典
引经据古	引經據古
引而不发	引而不發
引蛇出洞	引蛇出洞
弗罗里达	弗羅裏達
弗里斯兰	弗里斯蘭
张堪折辕	張堪折轅
张扬出去	張揚出去
张扬出来	張揚出來
张挂起来	張掛起來
张灯挂彩	張燈掛彩
张灯结彩	張燈結綵
张罗殆尽	張羅殆盡
张良借箸	張良借箸
张飞穿针	張飛穿針
弥习弥佳	彌習彌佳
弥勒菩萨	彌勒菩薩
弥天亙地	彌天亙地
弥天大罪	彌天大罪
弥天大谎	彌天大謊
弥山遍野	瀰山遍野
弥撒经书	彌撒經書
弥月之喜	彌月之喜
弥漫星云	瀰漫星雲
弥生文化	彌生文化
弥留之际	彌留之際
弥足珍贵	彌足珍貴
弦不虚发	弦不虛發
弧长参数	弧長參數
弯弯曲曲	彎彎曲曲
弯曲空间	彎曲空間
弱不胜衣	弱不勝衣
弱势团体	弱勢團體
弱水三千	弱水三千
弱音踏板	弱音踏板
弹尽援绝	彈盡援絕
弹尽粮绝	彈盡糧絕
弹性控制	彈性控制
弹性纤维	彈性纖維
弹无虚发	彈無虛發
强制作用	強制作用
强制保险	強制保險
强制处分	強制處分
强制手段	強制手段
强制执行	強制執行
强制认领	強制認領
强制辩护	強制辯護
强力攻占	強力攻佔
强加于人	強加於人
强台圣帕	強颱聖帕
强奸民意	強姦民意
强干弱枝	強幹弱枝
强烈台风	強烈颱風
强烈愿望	強烈願望
强聒不舍	強聒不捨
强音踏板	強音踏板
彊干弱枝	彊幹弱枝
归向导引	歸向導引
归真反朴	歸真反璞
归里包堆	歸裏包堆
当一回事	當一回事
当且仅当	當且僅當
当世之冠	當世之冠
当世儒宗	當世儒宗
当世才度	當世才度
当世无双	當世無雙
当世无敌	當世無敵
当之无愧	當之無愧
当之有愧	當之有愧
当仁不让	當仁不讓
当今无辈	當今無輩
当代大师	當代大師
当众宣布	當眾宣佈
当众表明	當眾表明
当众表示	當眾表示
当前之计	當前之計
当务之急	當務之急
当劳之急	當勞之急
当啷落地	噹啷落地
当回事儿	當回事兒
当地居民	當地居民
当地时间	當地時間
当场出丑	當場出醜
当场出彩	當場出彩
当场只手	當場隻手
当场听到	當場聽到
当场抓到	當場抓到
当场献丑	當場獻醜
当场看到	當場看到
当坊土地	當坊土地
当头一棒	當頭一棒
当头棒喝	當頭棒喝
当官追究	當官追究
当家作主	當家作主
当家和尚	當家和尚
当家小生	當家小生
当家立事	當家立事
当家花旦	當家花旦
当局者迷	當局者迷
当当丁丁	當當丁丁
当断不断	當斷不斷
当时得令	當時得令
当朝宰相	當朝宰相
当机立断	當機立斷
当来当去	當來當去
当牢节级	當牢節級
当班人员	當班人員
当用则用	當用則用
当的一响	噹的一響
当的一声	噹的一聲
当直巡逻	當直巡邏
当罏红袖	當罏紅袖
当者披靡	當者披靡
当耳边风	當耳邊風
当艄拿舵	當艄拿舵
当行出色	當行出色
当选无效	當選無效
当量剂量	當量劑量
当量浓度	當量濃度
当门对户	當門對戶
当门抵户	當門抵戶
当门牙齿	當門牙齒
当面唾骂	當面唾罵
当面对质	當面對質
当面言明	當面言明
当面错过	當面錯過
当风秉烛	當風秉燭
录取人数	錄取人數
录取分数	錄取分數
录取名单	錄取名單
录取名额	錄取名額
录影带奖	錄影帶獎
录影节目	錄影節目
录放影机	錄放影機
录放音机	錄放音機
录音电话	錄音電話
彗氾画涂	彗氾畫塗
形丑心善	形醜心善
形于言色	形於言色
形于辞色	形於辭色
形于颜色	形於顏色
形单影只	形單影隻
形只影单	形隻影單
形同具文	形同具文
形同虚设	形同虛設
形同陌路	形同陌路
形名参同	形名參同
形孤影只	形孤影隻
形容尽致	形容盡致
形影相吊	形影相弔
形疲神困	形疲神困
形象艺术	形象藝術
彩云易散	彩雲易散
彩凤随鸦	彩鳳隨鴉
彩笔生花	綵筆生花
彩管生花	彩管生花
彩色世界	彩色世界
彩色正片	彩色正片
彩色照片	彩色照片
彩色玻璃	彩色玻璃
彩色电影	彩色電影
彩色电视	彩色電視
彩色缤纷	彩色繽紛
彩虹仙子	彩虹仙子
彩虹冰舖	彩虹冰舖
彩衣娱亲	綵衣娛親
彩陶文化	彩陶文化
彪炳千古	彪炳千古
彰善瘅恶	彰善癉惡
彰彰可据	彰彰可據
影像合成	影像合成
影只形单	影隻形單
影响不了	影響不了
影坛红星	影壇紅星
影评人周	影評人週
役于外物	役於外物
彻里彻外	徹裏徹外
彼得后书	彼得後書
彼得里皿	彼得里皿
彼此克制	彼此剋制
往事如烟	往事如煙
往复运动	往復運動
往日無仇	往日無讎
往泥里踩	往泥裏踩
往里面冲	往裏面衝
征兵制度	徵兵制度
征名责实	徵名責實
征收范围	徵收範圍
征敛无度	征斂無度
征文启事	徵文啓事
征文比赛	徵文比賽
征服到地	征服到地
征求启事	徵求啓事
征聘人员	徵聘人員
征风召雨	徵風召雨
待价而沽	待價而沽
待价藏珠	待價藏珠
待在家里	待在家裏
待如己出	待如己出
徐娘半老	徐娘半老
徒托空言	徒託空言
徒步当车	徒步當車
得偿所愿	得償所願
得准不准	得準不準
得失参半	得失參半
得意之余	得意之餘
得未尝有	得未嘗有
得而复失	得而復失
得胜之兵	得勝之兵
得胜之师	得勝之師
得胜回朝	得勝回朝
得胜头回	得勝頭回
得道升天	得道昇天
御前会议	御前會議
御史大夫	御史大夫
御夫有术	御夫有術
御沟流叶	御溝流葉
御沟题叶	御溝題葉
御驾亲征	御駕親征
循环反复	循環反覆
循环往复	循環往復
循环系统	循環系統
循环赛制	循環賽制
微分几何	微分幾何
德佛亚克	德佛亞克
德克萨斯	德克薩斯
德兰克林	德蘭克林
德勒巴克	德勒巴克
德国马克	德國馬克
德垂后裔	德垂後裔
德布勒森	德布勒森
德干高原	德干高原
德弗札克	德弗札克
德才兼备	德才兼備
德沃夏克	德沃夏克
德法年鉴	德法年鑑
德润佣书	德潤傭書
德胜头回	德勝頭迴
德薄才疏	德薄才疏
心口合一	心口合一
心同此理	心同此理
心向往之	心嚮往之
心向祖国	心向祖國
心回意转	心回意轉
心存侥幸	心存僥倖
心安神闲	心安神閒
心意回转	心意回轉
心慈面软	心慈面軟
心折首肯	心折首肯
心有余悸	心有餘悸
心有戚戚	心有戚戚
心服情愿	心服情願
心术不正	心術不正
心活面软	心活面軟
心满愿足	心滿願足
心物合一	心物合一
心理学系	心理學系
心甘情愿	心甘情願
心神专注	心神專注
心细似发	心細似髮
心细如发	心細如髮
心脏地区	心臟地區
心脏按摩	心臟按摩
心脏疾患	心臟疾患
心脏病发	心臟病發
心脏病史	心臟病史
心脏痲痹	心臟痲痹
心脏痲痺	心臟痲痺
心脏移植	心臟移植
心脏移殖	心臟移殖
心脏衰竭	心臟衰竭
心脏麻痹	心臟麻痹
心脏麻痺	心臟麻痺
心花怒发	心花怒發
心荡神怡	心蕩神怡
心荡神摇	心蕩神搖
心荡神迷	心蕩神迷
心荡神驰	心蕩神馳
心虔志诚	心虔志誠
心路历程	心路歷程
心里不安	心裏不安
心里有数	心裏有數
心里有谱	心裏有譜
心里有鬼	心裏有鬼
心里痒痒	心裏癢癢
心长发短	心長髮短
心闲手敏	心閒手敏
必修课程	必修課程
必备良药	必備良藥
必死之症	必死之症
忍受不了	忍受不了
忍受得了	忍受得了
忍饥受渴	忍饑受渴
忍饥受饿	忍饑受餓
忍饥挨饿	忍飢挨餓
忖前思后	忖前思後
志不可夺	志不可奪
志不可满	志不可滿
志不在此	志不在此
志之不忘	誌之不忘
志冲斗牛	志沖斗牛
志同心合	志同心合
志同气合	志同氣合
志同道合	志同道合
志在千里	志在千里
志在四方	志在四方
志在必得	志在必得
志坚胆壮	志堅膽壯
志士仁人	志士仁人
志大心高	志大心高
志大才疏	志大才疏
志大才短	志大才短
志广才疏	志廣才疏
志得意满	志得意滿
志怪小说	志怪小說
志气凌云	志氣凌雲
志满气得	志滿氣得
志能之士	志能之士
志航基地	志航基地
志诚君子	志誠君子
志趣相投	志趣相投
志足意满	志足意滿
志骄意满	志驕意滿
志高气扬	志高氣揚
忘生舍死	忘生捨死
忙不择价	忙不擇價
忙了手脚	忙了手腳
忙作一团	忙作一團
忙成一团	忙成一團
忙昏了头	忙昏了頭
忙进忙出	忙進忙出
忙里偷闲	忙裏偷閒
忙里忙外	忙裏忙外
忠于国家	忠於國家
忠于职守	忠於職守
忠人之托	忠人之托
忧喜参半	憂喜參半
忧形于色	憂形於色
快乐幸福	快樂幸福
快去快回	快去快回
快快当当	快快當當
快速发展	快速發展
念了一声	唸了一聲
念曲叫曲	念曲叫曲
忽前忽后	忽前忽後
忽明忽暗	忽明忽暗
怀宠尸位	懷寵尸位
怀忧丧志	懷憂喪志
怀恶不悛	懷惡不悛
怀才不遇	懷才不遇
怀才抱德	懷才抱德
怎么回事	怎麼回事
怎么得了	怎麼得了
怒发冲冠	怒髮衝冠
怒发冲天	怒髮衝天
怒容满面	怒容滿面
怒形于色	怒形於色
怒气冲冲	怒氣衝衝
怒气冲发	怒氣衝髮
怒气冲天	怒氣衝天
怒火万丈	怒火萬丈
怒火冲天	怒火衝天
怒目相向	怒目相向
怒臂当车	怒臂當車
怙恶不悛	怙惡不悛
怙恶不改	怙惡不改
思不出位	思不出位
思前思后	思前思後
思前想后	思前想後
思前算后	思前算後
思如泉涌	思如泉涌
思想体系	思想體系
思想准备	思想準備
思虑周详	思慮周詳
急于星火	急於星火
急于求成	急於求成
急人之困	急人之困
急冲而下	急衝而下
急并各邦	急並各邦
急征重敛	急征重斂
性交关系	性交關係
性别歧视	性別歧視
性别角色	性別角色
性向测验	性向測驗
性格不合	性格不合
性欲高潮	性慾高潮
性泼凶顽	性潑凶頑
性神经症	性神經症
性荷尔蒙	性荷爾蒙
怨气冲天	怨氣衝天
怪里怪气	怪里怪氣
总体规划	總體規劃
总参谋部	總參謀部
总参谋长	總參謀長
总后勤部	總後勤部
总量管制	總量管制
恃才傲物	恃才傲物
恃才矜己	恃才矜己
恃才自专	恃才自專
恋恋不舍	戀戀不捨
恋恋难舍	戀戀難捨
恋生恶死	戀生惡死
恋酒贪杯	戀酒貪杯
恐后争先	恐後爭先
恒星周期	恆星週期
恒生指数	恒生指數
恒生银行	恒生銀行
恕乏价催	恕乏价催
恢复原状	恢復原狀
恢复名誉	恢復名譽
恢复常态	恢復常態
恢复起来	恢復起來
恢复过来	恢復過來
恢恢有余	恢恢有餘
恣心所欲	恣心所欲
恣情纵欲	恣情縱欲
恨意尽消	恨意盡消
恨苦修行	恨苦修行
恩克鲁玛	恩克魯瑪
恩同再造	恩同再造
恩同父母	恩同父母
恩威并施	恩威並施
恩威并济	恩威並濟
恩威并用	恩威並用
恩威并行	恩威並行
恩威并重	恩威並重
恩将仇报	恩將仇報
恩艾斯克	恩艾斯克
恬淡寡欲	恬淡寡欲
恬淡无欲	恬淡無欲
恭喜发财	恭喜發財
息交绝游	息交絕遊
恶习不改	惡習不改
恶作剧者	惡作劇者
恶劣影响	惡劣影響
恶化趋势	惡化趨勢
恶化顷向	惡化頃向
恶叉白赖	惡叉白賴
恶名昭彰	惡名昭彰
恶名昭著	惡名昭著
恶唑啉酮	惡唑啉酮
恶女阿楚	惡女阿楚
恶形恶状	惡形惡狀
恶性不改	惡性不改
恶性倒闭	惡性倒閉
恶性循环	惡性循環
恶性竞争	惡性競爭
恶性肿瘤	惡性腫瘤
恶性补习	惡性補習
恶性贫血	惡性貧血
恶恶从短	惡惡從短
恶恶实实	惡惡實實
恶意中伤	惡意中傷
恶意代码	惡意代碼
恶意毁谤	惡意毀謗
恶搞文化	惡搞文化
恶有善报	惡有善報
恶有恶报	惡有惡報
恶梦探侦	惡夢探偵
恶棍歹徒	惡棍歹徒
恶模恶样	惡模惡樣
恶湿居下	惡濕居下
恶直丑正	惡直醜正
恶眉恶眼	惡眉惡眼
恶积祸盈	惡積禍盈
恶稔祸盈	惡稔禍盈
恶稔罪盈	惡稔罪盈
恶稔贯盈	惡稔貫盈
恶紫夺朱	惡紫奪朱
恶缘恶业	惡緣惡業
恶臭扑鼻	惡臭撲鼻
恶衣恶食	惡衣惡食
恶衣粝食	惡衣糲食
恶衣菲食	惡衣菲食
恶衣蔬食	惡衣蔬食
恶言伤人	惡言傷人
恶言恶语	惡言惡語
恶言泼语	惡言潑語
恶言相向	惡言相向
恶言詈辞	惡言詈辭
恶语中伤	惡語中傷
恶语伤人	惡語傷人
恶语相向	惡語相向
恶贯满盈	惡貫滿盈
恶贯祸盈	惡貫禍盈
恶运当头	惡運當頭
恶醉强酒	惡醉強酒
恶霸地主	惡霸地主
恶霸成性	惡霸成性
悒郁不忿	悒鬱不忿
悒郁寡欢	悒鬱寡歡
悔不当初	悔不當初
悖入悖出	悖入悖出
悠哉游哉	悠哉遊哉
悠悠荡荡	悠悠盪盪
悠活丽致	悠活麗緻
悠然自适	悠然自適
悠闲自在	悠閒自在
悬岩峭壁	懸巖峭壁
悬心吊胆	懸心吊膽
悬挂国旗	懸掛國旗
悬旌万里	懸旌萬里
悬梁刺股	懸樑刺股
悬梁自尽	懸樑自盡
悬河注水	懸河注水
悬河注火	懸河注火
悬灯结彩	懸燈結彩
悬肠挂肚	懸腸掛肚
悬车致仕	懸車致仕
悬针垂露	懸針垂露
悭吝苦克	慳吝苦剋
悲不自胜	悲不自勝
悲喜交并	悲喜交並
悲悲戚戚	悲悲戚戚
悲欢合散	悲歡合散
悲欢离合	悲歡離合
悲歌当哭	悲歌當哭
悲泗淋漓	悲泗淋漓
悲犬咸阳	悲犬咸陽
悲痛欲绝	悲痛欲絕
悲秋伤春	悲秋傷春
惄如调饥	惄如調饑
情不自胜	情不自勝
情况证据	情況證據
情同一家	情同一家
情同手足	情同手足
情同骨肉	情同骨肉
情同鱼水	情同魚水
情孚意合	情孚意合
情感冲动	情感衝動
情投意合	情投意合
情报系统	情報系統
情文并茂	情文並茂
情有所钟	情有所钟
情有独钟	情有獨鐘
情溢于表	情溢於表
情至意尽	情至意盡
情面难却	情面難卻
惊恐万分	驚恐萬分
惊恐万状	驚恐萬狀
惊才绝艳	驚才絕豔
惊险百出	驚險百出
惟天可表	惟天可表
惨遭不幸	慘遭不幸
惩前毖后	懲前毖後
惩忿窒欲	懲忿窒欲
惩恶劝善	懲惡勸善
惩恶奖善	懲惡獎善
想不出来	想不出來
想个办法	想個辦法
想个方法	想個方法
想也别想	想也別想
想了又想	想了又想
想像出来	想像出來
想前顾后	想前顧後
想尽办法	想盡辦法
想尽方法	想盡方法
想干什么	想幹什麼
想当然耳	想當然耳
想都别想	想都別想
惹人注意	惹人注意
惹人注目	惹人注目
愁云惨雾	愁雲慘霧
愁容满面	愁容滿面
愈出愈奇	愈出愈奇
意出望外	意出望外
意切言尽	意切言盡
意切辞尽	意切辭盡
意前笔后	意前筆後
意合情投	意合情投
意大利面	意大利麵
意广才疏	意廣才疏
意得志满	意得志滿
意志消沈	意志消沈
意志消沉	意志消沉
意思表示	意思表示
意气相合	意氣相合
意气风发	意氣風發
意满志得	意滿志得
意犹未尽	意猶未盡
意见不合	意見不合
意识历程	意識歷程
意转心回	意轉心回
意里意思	意裏意思
感化饼干	感化餅乾
感同身受	感同身受
感恩不尽	感恩不盡
感慨万千	感慨萬千
感激万分	感激萬分
感激不尽	感激不盡
感觉出来	感覺出來
愤而行凶	憤而行兇
愧不敢当	愧不敢當
愿不愿意	願不願意
愿天下有	願天下有
愿寘诚念	願寘誠念
愿干一杯	願乾一杯
愿干这杯	願乾這杯
愿干那杯	願乾那杯
愿者上钩	願者上鉤
愿闻其详	願聞其詳
慈安太后	慈安太后
慈悲喜舍	慈悲喜捨
慈禧太后	慈禧太后
慌了手脚	慌了手腳
慌了神儿	慌了神兒
慌作一团	慌作一團
慌成一团	慌成一團
慌里慌张	慌里慌張
慢板情歌	慢板情歌
慰情胜无	慰情勝無
懵里懵懂	懵裏懵懂
懿范长昭	懿範長昭
戏彩娱亲	戲綵娛親
成功范例	成功範例
成千上万	成千上萬
成千成万	成千成萬
成千成百	成千成百
成千累万	成千累萬
成千论万	成千論萬
成团打块	成團打塊
成套出售	成套出售
成岩作用	成岩作用
成批出售	成批出售
成百上千	成百上千
成群打伙	成羣打夥
成群结伙	成羣結夥
成群结党	成羣結黨
成都卖卜	成都賣卜
我干一杯	我乾一杯
我醉欲眠	我醉欲眠
或系之牛	或繫之牛
战云密布	戰雲密佈
战云浓密	戰雲濃密
战前战后	戰前戰後
战地钟声	戰地鐘聲
战天斗地	戰天鬥地
战战栗栗	戰戰慄慄
战斗人员	戰鬥人員
战斗任务	戰鬥任務
战斗意志	戰鬥意志
战斗编组	戰鬥編組
战斗英雄	戰鬥英雄
战斗行为	戰鬥行爲
战斗轰炸	戰鬥轟炸
战斗队形	戰鬥隊形
战无不克	戰無不克
战无不胜	戰無不勝
战术导弹	戰術導彈
战术轰炸	戰術轟炸
战略伙伴	戰略伙伴
戚墅堰区	慼墅堰區
截发留宾	截髮留賓
截然不同	截然不同
截趾适履	截趾適履
截趾适屦	截趾適屨
戮力同心	戮力同心
戳脊梁骨	戳脊梁骨
戴克拉克	戴克拉克
戴发含齿	戴髮含齒
戴天之仇	戴天之仇
戴希穆克	戴希穆克
戴瑞克罗	戴瑞克羅
戴维斯杯	戴維斯杯
户口制度	戶口制度
户对门当	戶對門當
房屋修护	房屋修護
所剩无几	所剩無幾
所向披靡	所向披靡
所向无前	所向無前
所向无敌	所向無敵
所见略同	所見略同
所见而云	所見而云
所讥而云	所譏而云
所谓而云	所謂而云
扁锹形虫	扁鍬形蟲
扇叶蒲葵	扇葉蒲葵
手不释卷	手不釋卷
手写识别	手寫識別
手冢治虫	手冢治虫
手到回春	手到回春
手塚治虫	手冢治虫
手板葫芦	手板葫蘆
手足口症	手足口症
手面赚吃	手面賺吃
才为世出	才爲世出
才储八斗	才儲八斗
才兼文武	才兼文武
才勇兼优	才勇兼優
才华出众	才華出眾
才华横溢	才華橫溢
才华洋溢	才華洋溢
才华盖世	才華蓋世
才大难用	才大難用
才如史迁	才如史遷
才子佳人	才子佳人
才学兼优	才學兼優
才广妨身	才廣妨身
才当曹斗	才當曹斗
才得两年	纔得兩年
才微智浅	才微智淺
才德兼备	才德兼備
才思敏捷	才思敏捷
才气无双	才氣無雙
才气纵横	才氣縱橫
才气过人	才氣過人
才略过人	才略過人
才疏学浅	才疏學淺
才疏德薄	才疏德薄
才疏志大	才疏志大
才疏意广	才疏意廣
才疏计拙	才疏計拙
才短气粗	才短氣粗
才秀人微	才秀人微
才能干济	才能幹濟
才艺卓绝	才藝卓絕
才艺技能	才藝技能
才蔽识浅	才蔽識淺
才识过人	才識過人
才貌出众	才貌出眾
才貌双全	才貌雙全
才贯二酉	才貫二酉
才轻德薄	才輕德薄
才过子建	才過子建
才过屈宋	才過屈宋
才非玉润	才非玉潤
才高八斗	才高八斗
才高意广	才高意廣
才高气傲	才高氣傲
才高行厚	才高行厚
才高行洁	才高行潔
扎兰屯市	扎蘭屯市
扎好底子	紮好底子
扎实推进	紮實推進
扎尔达里	扎爾達里
扎手舞脚	扎手舞腳
扎扎实实	紮紮實實
扎格罗斯	扎格羅斯
扎欧扎翁	紮歐紮翁
扎眉扎眼	扎眉扎眼
扎脑门儿	扎腦門兒
扎赉特旗	扎賚特旗
扎马剌丁	紮馬剌丁
扎马鲁丁	紮馬魯丁
扎鲁特旗	扎魯特旗
扑个满怀	撲個滿懷
扑作教刑	扑作教刑
扑灭蚊虫	撲滅蚊蟲
扑通通冬	撲通通冬
扑面而来	撲面而來
打一个吞	打一個吞
打个前失	打個前失
打个千儿	打個千兒
打个沉儿	打個沉兒
打个照会	打個照會
打个照面	打個照面
打个问号	打個問號
打了偏手	打了偏手
打了半跪	打了半跪
打出吊入	打出弔入
打出头棍	打出頭棍
打击报复	打擊報復
打制石器	打製石器
打印范围	打印範圍
打发时间	打發時間
打太极拳	打太極拳
打家劫舍	打家劫舍
打心眼里	打心眼裏
打成一团	打成一團
打棍出箱	打棍出箱
打没头坛	打沒頭壇
打淨捞干	打淨撈乾
打破纪录	打破紀錄
打耳刮子	打耳刮子
打花胡哨	打花胡哨
打话不同	打話不同
打诨发科	打諢發科
打路庄板	打路莊板
打道回府	打道回府
打里打外	打裏打外
打里照外	打裏照外
扔在脑后	扔在腦後
托克托县	托克托縣
托克逊县	托克遜縣
托利党人	托利黨人
托利米尔	托利米爾
托勒密王	托勒密王
托古讽今	託古諷今
托塔天王	托塔天王
托尔斯泰	托爾斯泰
托拉博拉	托拉博拉
托斯卡尼	托斯卡尼
托木尔峰	托木爾峰
托比亚斯	托比亞斯
托洛斯基	托洛斯基
托洛茨基	托洛茨基
托登汉队	托登漢隊
托福考试	托福考試
托米欧佳	托米歐佳
托罗斯山	托羅斯山
托老中心	托老中心
托荤咸食	托葷鹹食
托足无门	托足無門
托辣斯法	托辣斯法
托运行李	托運行李
托里拆利	托裏拆利
托钵修会	托鉢修會
扣分标准	扣分標準
扩厂计划	擴廠計劃
扩大范围	擴大範圍
扩建工厂	擴建工廠
扩散出来	擴散出來
扪参历井	捫參歷井
扪隙发罅	捫隙發罅
扫地俱尽	掃地俱盡
扫地出门	掃地出門
扫田刮地	掃田刮地
扫眉才子	掃眉才子
扫荡残敌	掃蕩殘敵
扬名后世	揚名後世
扬名立万	揚名立萬
扬善去恶	揚善去惡
扬善隐恶	揚善隱惡
扬州清曲	揚州清曲
扬己露才	揚己露才
扭头折颈	扭頭折頸
扭成一团	扭成一團
扭摆不停	扭擺不停
扭曲作直	扭曲作直
扭转干坤	扭轉乾坤
扮装皇后	扮裝皇后
扯篷拉纤	扯篷拉縴
扯闲盘儿	扯閒盤兒
扳回一城	扳回一城
扶危救困	扶危救困
扶危济困	扶危濟困
扶同硬证	扶同硬證
扶同诖误	扶同詿誤
扶善惩恶	扶善懲惡
扶贫济困	扶貧濟困
批准下来	批准下來
批发价格	批發價格
批发市场	批發市場
找台阶下	找臺階下
找台阶儿	找臺階兒
承先启后	承先啓後
承前启后	承前啓後
承受不了	承受不了
承当不起	承當不起
承蒙关照	承蒙關照
承蒙指教	承蒙指教
承销价差	承銷價差
技术专科	技術專科
技术人员	技術人員
技术作物	技術作物
技术分析	技術分析
技术单位	技術單位
技术发展	技術發展
技术合作	技術合作
技术学院	技術學院
技术情报	技術情報
技术所限	技術所限
技术指导	技術指導
技术援助	技術援助
技术故障	技術故障
技术标准	技術標準
技术水准	技術水準
技术水平	技術水平
技术潜水	技術潛水
技术犯规	技術犯規
技术知识	技術知識
技术线型	技術綫型
技术装备	技術裝備
技术规范	技術規範
技术部门	技術部門
技术降落	技術降落
技术革命	技術革命
技术革新	技術革新
抄录下来	抄錄下來
抄录编目	抄錄編目
抄手游廊	抄手遊廊
把定了心	把定了心
把脸一板	把臉一板
把饭叫饥	把飯叫饑
抑制作用	抑制作用
抑制栽培	抑制栽培
抑恶扬善	抑惡揚善
抑郁不平	抑鬱不平
抑郁寡欢	抑鬱寡歡
抒情歌曲	抒情歌曲
抔土未干	抔土未乾
投井自尽	投井自盡
投影几何	投影幾何
投梭折齿	投梭折齒
投河自尽	投河自盡
投环自尽	投環自盡
投票表决	投票表決
投闲置散	投閒置散
抖了起来	抖了起來
抖搜精神	抖搜精神
抗干扰性	抗干擾性
抗忧郁药	抗憂鬱藥
抗战歌曲	抗戰歌曲
抗战胜利	抗戰勝利
抗拒不了	抗拒不了
抗病品种	抗病品種
抗病毒药	抗病毒藥
抗癌药物	抗癌藥物
抗组胺药	抗組胺藥
抗药能力	抗藥能力
抗逆转录	抗逆轉錄
折价出售	折價出售
折冲厌难	折衝厭難
折冲尊俎	折衝尊俎
折冲御侮	折衝禦侮
折冲樽俎	折衝樽俎
折半出售	折半出售
折叠起来	摺疊起來
折戟沈河	折戟沈河
折戟沉沙	折戟沉沙
折旧基金	折舊基金
折柳攀花	折柳攀花
折桂攀蟾	折桂攀蟾
折箭为盟	折箭爲盟
折箭为誓	折箭爲誓
折腰五斗	折腰五斗
折腰升斗	折腰升斗
折臂三公	折臂三公
折节下交	折節下交
折节下士	折節下士
折节向学	折節向學
折节待士	折節待士
折节礼士	折節禮士
折节读书	折節讀書
折衷主义	折衷主義
折衷家庭	折衷家庭
折衷方案	折衷方案
折衷鹦鹉	折衷鸚鵡
折足复𫗧	折足覆餗
折长补短	折長補短
折鼎复𫗧	折鼎覆餗
抚尸恸哭	撫尸慟哭
抚尸痛哭	撫屍痛哭
抚梁易柱	撫梁易柱
抚面痛哭	撫面痛哭
抛在脑后	拋在腦後
抛头露面	拋頭露面
抛妻别子	拋妻別子
抛尸露骨	拋屍露骨
抟击掀发	摶擊掀發
抟柱乘梁	摶柱乘梁
抟沙嚼蜡	摶沙嚼蠟
抟砂炼汞	摶砂煉汞
抢修工作	搶修工作
抢尽锋头	搶盡鋒頭
抢救出来	搶救出來
护发乳液	護髮乳液
报仇雪恨	報仇雪恨
报仇雪耻	報仇雪恥
报值挂号	報值掛號
报刊杂志	報刊雜誌
报告出来	報告出來
报国尽忠	報國盡忠
报复主义	報復主義
报复关税	報復關稅
报导出来	報導出來
报穷制裁	報窮制裁
报章杂志	報章雜誌
报表语言	報表語言
披发入山	披髮入山
披发垢面	披髮垢面
披发左衽	披髮左衽
披发涂面	披髮塗面
披发缨冠	披髮纓冠
披发藻目	披髮藻目
披头散发	披頭散髮
披挂上阵	披掛上陣
披挂绰鎗	披掛綽鎗
披榛采兰	披榛採蘭
披红挂彩	披紅掛綵
披肝挂胆	披肝掛膽
披针形叶	披針形葉
抬高身价	擡高身價
抱大足杆	抱大足桿
抱布贸丝	抱布貿絲
抱成一团	抱成一團
抱素怀朴	抱素懷樸
抱负水准	抱負水準
抵御外侮	抵禦外侮
抵押借款	抵押借款
抵挡不了	抵擋不了
抽油烟机	抽油煙機
抽蓄发电	抽蓄發電
拂钟无声	拂鐘無聲
拂面而来	拂面而來
担当不起	擔當不起
担当不过	擔當不過
担当起来	擔當起來
担饥受冻	擔飢受凍
拆迁范围	拆遷範圍
拈花摘叶	拈花摘葉
拉丁语系	拉丁語系
拉了一把	拉了一把
拉克替醇	拉克替醇
拉卜楞寺	拉卜楞寺
拉合尔市	拉合爾市
拉尔维克	拉爾維克
拉布拉他	拉布拉他
拉布拉多	拉布拉多
拉托维亚	拉托維亞
拉文克劳	拉文克勞
拉法叶舰	拉法葉艦
拉皮手术	拉皮手術
拉里加尼	拉里加尼
拉里拉尼	拉里拉尼
拉链工程	拉鍊工程
拌嘴斗舌	拌嘴鬥舌
拍出好戏	拍齣好戲
拍台拍凳	拍檯拍凳
拏云攫石	拏雲攫石
拒拿回扣	拒拿回扣
拔围出夫	拔圍出夫
拔地参天	拔地參天
拔宅上升	拔宅上昇
拔宅飞升	拔宅飛昇
拔羣出类	拔羣出類
拔羣出萃	拔羣出萃
拔萃出类	拔萃出類
拔萃出羣	拔萃出羣
拖延战术	拖延戰術
拖麻拽布	拖麻拽布
拗别搅炒	拗彆攪炒
拗曲作直	拗曲作直
拙于言词	拙於言詞
拙于言辞	拙於言辭
拚生尽死	拚生盡死
招供出来	招供出來
招待不周	招待不週
拟于不伦	擬於不倫
拦前断后	攔前斷後
拨万论千	撥萬論千
拨万轮千	撥萬輪千
拨乱之才	撥亂之才
拨云撩雨	撥雲撩雨
拨云睹日	撥雲睹日
拨云见日	撥雲見日
拨号系统	撥號系統
拨雨撩云	撥雨撩雲
拱手而别	拱手而別
拱手让出	拱手讓出
拼合版画	拼合版畫
拼图游戏	拼圖遊戲
拼字游戏	拼字遊戲
拼布图形	拼布圖形
拼板游戏	拼板遊戲
拼板玩具	拼板玩具
拼死拼活	拼死拼活
拼生尽死	拚生盡死
拼花地板	拼花地板
拼贴艺术	拼貼藝術
拽布披麻	拽布披麻
拽布拖麻	拽布拖麻
拿不出手	拿不出手
拿云捉月	拿雲捉月
拿云握雾	拿雲握霧
拿坡里号	拿坡里號
拿板弄势	拿板弄勢
挂一漏万	掛一漏萬
挂一漏百	掛一漏百
挂了幌子	掛了幌子
挂冠归里	掛冠歸里
挂冠求去	掛冠求去
挂冠而去	掛冠而去
挂印悬牌	掛印懸牌
挂印而逃	掛印而逃
挂名夫妻	掛名夫妻
挂在口上	掛在口上
挂在嘴上	掛在嘴上
挂在嘴边	掛在嘴邊
挂失止付	掛失止付
挂来挂去	掛來掛去
挂灯结彩	掛燈結綵
挂牌汇率	掛牌匯率
挂肚牵心	掛肚牽心
挂肚牵肠	掛肚牽腸
挂肠悬胆	掛腸懸膽
挂角读书	掛角讀書
指不胜屈	指不勝屈
指亲托故	指親托故
指向装置	指向裝置
指手划脚	指手劃腳
指日高升	指日高升
指标体系	指標體系
指水盟松	指水盟松
指破迷团	指破迷團
指纹纪录	指紋紀錄
指纹鉴定	指紋鑑定
指证历历	指證歷歷
按下不表	按下不表
按照字面	按照字面
按照计划	按照計劃
按理出牌	按理出牌
按表操课	按表操課
按质定价	按質定價
按需出版	按需出版
挑选出来	挑選出來
挖心搜胆	挖心搜膽
挖掘出来	挖掘出來
挖耳当招	挖耳當招
挚而有别	摯而有別
挟朋树党	挾朋樹黨
挠直为曲	撓直爲曲
挤兑出来	擠兌出來
挤成一团	擠成一團
挤昏了头	擠昏了頭
挥戈回日	揮戈回日
挥手告别	揮手告別
挥手致意	揮手致意
挨三顶五	挨三頂五
挨三顶四	捱三頂四
挨了过去	捱了過去
挨了过来	捱了過來
挨家挨户	挨家挨戶
挨山塞海	挨山塞海
挨打受气	挨打受氣
挨打受骂	挨打受罵
挨挨抢抢	挨挨搶搶
挨挨蹭蹭	挨挨蹭蹭
挨肩叠背	挨肩疊背
挨肩搭背	挨肩搭背
挨肩擦背	挨肩擦背
挨肩擦脸	挨肩擦臉
挨肩擦膀	挨肩擦膀
挨门挨户	挨門挨戶
挨门逐户	挨門逐戶
挨风缉缝	挨風緝縫
挨饥抵饿	捱飢抵餓
挨饿受冻	挨餓受凍
振聋发嘳	振聾發嘳
振聋发聩	振聾發聵
振荡电流	振盪電流
振荡电路	振盪電路
挹彼注兹	挹彼注茲
挹彼注此	挹彼注此
挺身而出	挺身而出
挽回不了	挽回不了
挽救不了	挽救不了
挽救儿童	挽救兒童
捉不胜捉	捉不勝捉
捉奸捉双	捉姦捉雙
捉奸见双	捉姦見雙
捉奸见床	捉姦見牀
捉摸不出	捉摸不出
捏造出来	捏造出來
捐赠盈余	捐贈盈餘
捕影系风	捕影繫風
捕虫堇菜	捕蟲堇菜
捕虫植物	捕蟲植物
捕风系影	捕風繫影
损兵折将	損兵折將
损军折将	損軍折將
损将折兵	損將折兵
换心手术	換心手術
换房旅游	換房旅遊
换肾手术	換腎手術
捣鬼吊白	搗鬼弔白
据为己有	據爲己有
据义履方	據義履方
据守天险	據守天險
据实以报	據實以報
据实相告	據實相告
据情办理	據情辦理
据牀指麾	據牀指麾
据理力争	據理力爭
据理而争	據理而爭
据险固守	據險固守
捶台拍凳	捶檯拍凳
捷众药业	捷眾藥業
捷运系统	捷運系統
掀了开来	掀了開來
掂梢折本	掂梢折本
授权范围	授權範圍
掊斗折衡	掊斗折衡
掌状复叶	掌狀複葉
排兵布阵	排兵布陣
排出作用	排出作用
排列组合	排列組合
排放系统	排放系統
排水系统	排水系統
排泄系统	排泄系統
排版系统	排版系統
排门挨户	排門挨戶
排除万难	排除萬難
掘墓鞭尸	掘墓鞭屍
探个究竟	探個究竟
探奇访胜	探奇訪勝
探寻胜迹	探尋勝蹟
探幽访胜	探幽訪勝
探骊获珠	探驪獲珠
掤扒吊栲	掤扒吊栲
接受不了	接受不了
接口规范	接口規範
接合生殖	接合生殖
接合菌纲	接合菌綱
接合起来	接合起來
接绍香烟	接紹香煙
接续香烟	接續香煙
控制不了	控制不了
控制单元	控制單元
控制范围	控制範圍
控制裕如	控制裕如
推定出来	推定出來
推干淨儿	推乾淨兒
推心致腹	推心致腹
推情准理	推情準理
推托之词	推托之詞
推演出来	推演出來
推算出来	推算出來
推舟于陆	推舟於陸
推诚布信	推誠布信
推诚布公	推誠布公
推辇归里	推輦歸里
推陈出新	推陳出新
推陈布新	推陳佈新
掩口卢胡	掩口盧胡
掩口胡卢	掩口胡盧
掩恶扬善	掩惡揚善
掩恶溢美	掩惡溢美
掩罪藏恶	掩罪藏惡
掩耳盗钟	掩耳盜鐘
掩面大哭	掩面大哭
掩面失色	掩面失色
掩面而泣	掩面而泣
掩面而过	掩面而過
措置失当	措置失當
措置得当	措置得當
措词不当	措詞不當
措辞不当	措辭不當
揉成一团	揉成一團
描写出来	描寫出來
描绘出来	描繪出來
提克瑞提	提克瑞提
提克里特	提克裏特
提出建议	提出建議
提出异议	提出異議
提出抗辩	提出抗辯
提学御史	提學御史
提心吊胆	提心吊膽
提拉米苏	提拉米蘇
提甕出汲	提甕出汲
提纯复壮	提純復壯
插架万轴	插架萬軸
插箭游营	插箭遊營
握云拿雾	握雲拿霧
握云携雨	握雲攜雨
握发吐哺	握髮吐哺
握发吐餐	握髮吐餐
握手极欢	握手極歡
握手道别	握手道別
握雨携云	握雨攜雲
握雾拿云	握霧拿雲
揣合逢迎	揣合逢迎
揣在怀里	揣在懷裏
揣奸把猾	揣奸把猾
揩台抹凳	揩檯抹凳
揽湿布衫	攬濕布衫
搋在怀里	搋在懷裏
搏砂炼汞	搏砂煉汞
搓粉团朱	搓粉團朱
搓粉抟朱	搓粉摶朱
搜奇抉怪	搜奇抉怪
搜奇访古	搜奇訪古
搜奇选妙	搜奇選妙
搜寻引擎	搜尋引擎
搜寻软体	搜尋軟體
搜扬仄陋	搜揚仄陋
搜扬侧陋	搜揚側陋
搜括一空	搜括一空
搜搜客网	搜搜客網
搜根剔齿	搜根剔齒
搜根究底	搜根究底
搜根问底	搜根問底
搜章擿句	搜章擿句
搜索前进	搜索前進
搜索半径	搜索半徑
搜索引擎	搜索引擎
搜索枯肠	搜索枯腸
搜索结果	搜索結果
搜索范围	搜索範圍
搜肠刮肚	搜腸刮肚
搞好关系	搞好關係
搤肮拊背	搤肮拊背
携云挈雨	攜雲挈雨
携云握雨	攜雲握雨
携手合作	攜手合作
携手同心	攜手同心
携手并肩	攜手並肩
搽穰卷儿	搽穰捲兒
摄录影机	攝錄影機
摄影艺术	攝影藝術
摆了一道	擺了一道
摆云锣儿	擺雲鑼兒
摆在心上	擺在心上
摆在眼前	擺在眼前
摆官架子	擺官架子
摆尾摇头	擺尾搖頭
摆开阵势	擺開陣勢
摆拨不下	擺撥不下
摆摆摇摇	擺擺搖搖
摆来摆去	擺來擺去
摆空架子	擺空架子
摆脱不了	擺脫不了
摆脱危机	擺脫危機
摆花架子	擺花架子
摆荡吊环	擺蕩吊環
摆荡起来	擺盪起來
摆袖却金	擺袖卻金
摆龙门阵	擺龍門陣
摇了一下	搖了一下
摇头摆尾	搖頭擺尾
摇头摆脑	搖頭擺腦
摇摆不定	搖擺不定
摇摇摆摆	搖搖擺擺
摇摇欲坠	搖搖欲墜
摇摇荡荡	搖搖蕩蕩
摇滚乐团	搖滾樂團
摇荡不停	搖盪不停
摊了人命	攤了人命
摔了一跤	摔了一跤
摔断了腿	摔斷了腿
摘伏发隐	摘伏發隱
摘奸发伏	摘奸發伏
摛藻雕章	摛藻雕章
摧兰折玉	摧蘭折玉
摧坚获丑	摧堅獲醜
摧志屈道	摧志屈道
摧枯折腐	摧枯折腐
摧眉折腰	摧眉折腰
摩厉以须	摩厲以須
摩托罗垃	摩托羅垃
摩托罗拉	摩托羅拉
摩托车组	摩托車組
摩擦系数	摩擦係數
摩肩如云	摩肩如雲
摩苏尔市	摩蘇爾市
摩诃迦叶	摩訶迦葉
摩里西斯	摩里西斯
撑头获脑	撐頭獲腦
撑杆跳高	撐桿跳高
撒克逊人	撒克遜人
撒马尔干	撒馬爾幹
撞个正著	撞個正著
撞个满怀	撞個滿懷
撞府冲州	撞府沖州
撞钟太岁	撞鐘太歲
撞阵冲军	撞陣衝軍
撤销记录	撤銷記錄
撩云拨雨	撩雲撥雨
播出频道	播出頻道
播恶遗臭	播惡遺臭
播放列表	播放列表
播放歌曲	播放歌曲
播种面积	播種面積
播越失据	播越失據
撮科打哄	撮科打哄
撺哄鸟乱	攛哄鳥亂
操作系统	操作系統
操作规范	操作規範
擎拳合掌	擎拳合掌
擒奸摘伏	擒奸摘伏
擒奸擿伏	擒奸擿伏
擒奸讨暴	擒奸討暴
擢发抽肠	擢髮抽腸
擢发难数	擢髮難數
擿埴索涂	擿埴索塗
擿奸发伏	擿奸發伏
攀亲引戚	攀親引戚
攀今吊古	攀今吊古
攀花折柳	攀花折柳
攀蟾折桂	攀蟾折桂
攧攧仆仆	攧攧仆仆
支出费用	支出費用
支撑不了	支撐不了
收发短信	收發短信
收回成命	收回成命
收复失土	收復失土
收复失地	收復失地
收复河山	收復河山
收录音机	收錄音機
收拾干淨	收拾乾淨
收盘价格	收盤價格
收盘汇率	收盤匯率
收购价格	收購價格
攸戚相关	攸戚相關
改了又改	改了又改
改变不了	改變不了
改善关系	改善關係
改头换面	改頭換面
改头換面	改頭換面
改恶向善	改惡向善
改良品种	改良品種
攻击范围	攻擊範圍
攻守同盟	攻守同盟
攻无不克	攻無不克
放出手眼	放出手眼
放在心里	放在心裏
放在眼里	放在眼裏
放大系数	放大係數
放射出来	放射出來
放松管制	放松管制
放烟幕弹	放煙幕彈
放荡不羁	放蕩不羈
放荡任气	放蕩任氣
放荡弛纵	放蕩弛縱
放马后炮	放馬後炮
放马后砲	放馬後砲
政党政治	政黨政治
政出多门	政出多門
政工干校	政工幹校
政教合一	政教合一
政治体制	政治體制
政治关系	政治關係
政治局面	政治局面
政治斗争	政治鬥爭
政治舞台	政治舞臺
政见发表	政見發表
故地重游	故地重遊
故态复萌	故態復萌
敌前敌后	敵前敵後
敌后伏击	敵後伏擊
敌后作战	敵後作戰
敌后工作	敵後工作
敌忾同仇	敵愾同仇
救困扶危	救困扶危
救恩计划	救恩計劃
教外别传	教外別傳
教学示范	教學示範
教学计划	教學計劃
教猱升木	教猱升木
教育出来	教育出來
教育制度	教育制度
教育团体	教育團體
教育方针	教育方針
敝帚千金	敝帚千金
敢作敢当	敢作敢當
敢做敢当	敢做敢當
敢斗了胆	敢斗了膽
散兵游勇	散兵遊勇
散发传单	散發傳單
散发出来	散發出來
敦煌曲子	敦煌曲子
敬姜犹绩	敬姜猶績
数不胜数	數不勝數
数与虏确	數與虜确
数以万计	數以萬計
数以万订	數以萬訂
数以千计	數以千計
数位控制	數位控制
数位艺术	數位藝術
数值控制	數值控制
数值范围	數值範圍
数字修复	數位修補
数字时钟	數字時鐘
数字系数	數字係數
数字钟表	數字鐘錶
数据专线	數據專綫
数据介面	數據介面
数据传输	數據傳輸
数据压缩	數據壓縮
数据处理	數據處理
数据总线	數據總綫
数据挖掘	數據挖掘
数据接口	數據接口
数据结构	數據結構
数据网络	數據網絡
数据资料	數據資料
数据通信	數據通信
数据通讯	數據通訊
数据链路	數據鏈路
数米志炊	數米志炊
数罪并罚	數罪併罰
整个地球	整個地球
整个来说	整個來說
整人游戏	整人遊戲
整厂输出	整廠輸出
整发用品	整髮用品
整合系统	整合系統
整型手术	整型手術
整容手术	整容手術
整数集合	整數集合
整理出来	整理出來
整装待发	整裝待發
整齐划一	整齊劃一
整齐干淨	整齊乾淨
敷彩泥塑	敷彩泥塑
敷衍了事	敷衍了事
文不尽意	文不盡意
文书鉴定	文書鑑定
文件旅游	文件旅遊
文修武偃	文修武偃
文修武备	文修武備
文创志业	文創志業
文化体系	文化體系
文化冲击	文化衝擊
文化斗争	文化鬥爭
文化水准	文化水準
文君当垆	文君當壚
文坛人士	文壇人士
文心雕龙	文心雕龍
文思泉涌	文思泉涌
文情并茂	文情並茂
文擅雕龙	文擅雕龍
文斯范恩	文斯范恩
文星和合	文星和合
文武全才	文武全才
文武合一	文武合一
文炳雕龙	文炳雕龍
文章星斗	文章星斗
文艺复兴	文藝復興
文艺演出	文藝演出
文身断发	文身斷髮
文采出众	文采出眾
文采郁郁	文采郁郁
文采风流	文采風流
文锦复阱	文錦覆阱
斐然向风	斐然向風
斗上一斗	鬥上一鬥
斗了一斗	鬥了一鬥
斗了起来	鬥了起來
斗争大会	鬥爭大會
斗争形式	鬥爭形式
斗争意志	鬥爭意志
斗争斗合	鬥爭鬥合
斗争方式	鬥爭方式
斗他一斗	鬥他一鬥
斗升之水	斗升之水
斗升之禄	斗升之祿
斗南一人	斗南一人
斗她一斗	鬥她一鬥
斗室生辉	斗室生輝
斗巧争奇	鬥巧爭奇
斗志昂扬	鬥志昂揚
斗志高昂	鬥志高昂
斗折蛇行	斗折蛇行
斗斛之禄	斗斛之祿
斗方名士	斗方名士
斗智斗力	鬥智鬥力
斗杓东指	斗杓東指
斗杓转势	斗杓轉勢
斗来斗去	鬥來鬥去
斗牙拌齿	鬥牙拌齒
斗牙斗齿	鬥牙鬥齒
斗牛之间	斗牛之間
斗私批修	鬥私批修
斗筲之人	斗筲之人
斗筲之器	斗筲之器
斗筲之徒	斗筲之徒
斗筲之才	斗筲之才
斗筲之材	斗筲之材
斗筲之辈	斗筲之輩
斗筲小器	斗筲小器
斗筲穿窬	斗筲穿窬
斗粟囊金	斗粟囊金
斗粟尺布	斗粟尺布
斗绝一隅	斗絕一隅
斗罗大陆	斗羅大陸
斗而铸兵	鬥而鑄兵
斗而铸锥	鬥而鑄錐
斗艳争芳	鬥豔爭芳
斗转参横	斗轉參橫
斗转星移	斗轉星移
斗酒只鸡	斗酒隻雞
斗酒学士	斗酒學士
斗酒百篇	斗酒百篇
斗重山齐	斗重山齊
斗量车载	斗量車載
斗鸡走狗	鬥雞走狗
斗鸡走马	鬥雞走馬
料敌制胜	料敵制勝
斜座标系	斜座標系
斩尽杀绝	斬盡殺絕
斫雕为朴	斫雕爲樸
断发文身	斷髮文身
断根绝种	斷根絕種
断纸余墨	斷紙余墨
断绝关系	斷絕關係
断钗重合	斷釵重合
断雨残云	斷雨殘雲
斯伯丁杯	斯伯丁盃
斯坦贝克	斯坦貝克
斯洛伐克	斯洛伐克
斯瓦希里	斯瓦希裏
斯科普里	斯科普裏
斯芬克士	斯芬克士
斯芬克斯	斯芬克斯
斯里兰卡	斯里蘭卡
斯里査潘	斯里査潘
新书看板	新書看板
新修本草	新修本草
新几內亚	新幾內亞
新几内亚	新幾內亞
新出土儿	新出土兒
新出手儿	新出手兒
新城电台	新城電臺
新慕道团	新慕道團
新斯科舍	新斯科舍
新板特区	新板特區
新潮流系	新潮流系
新疆回变	新疆回變
新罕布夏	新罕布夏
新莺出谷	新鶯出谷
新闻价值	新聞價值
新闻周刊	新聞週刊
新闻杂志	新聞雜誌
斲雕为朴	斲雕爲樸
方圆十里	方圓十里
方斯蔑如	方斯蔑如
方方面面	方方面面
方济谷派	方濟谷派
方面兼圻	方面兼圻
方面大耳	方面大耳
方面官员	方面官員
施仁布德	施仁布德
施仁布恩	施仁布恩
施仁布泽	施仁布澤
施恩布德	施恩布德
施放烟火	施放煙火
施朱傅粉	施朱傅粉
施粥舍饭	施粥捨飯
施舍之道	施舍之道
旁征博引	旁徵博引
旁系亲属	旁系親屬
旁系血亲	旁系血親
旅游事业	旅遊事業
旅游城市	旅遊城市
旅游局长	旅遊局長
旅游手冊	旅遊手冊
旅游景点	旅遊景點
旅游热点	旅遊熱點
旅游胜地	旅遊勝地
旅游集散	旅遊集散
旅行剧团	旅行劇團
旋干转坤	旋乾轉坤
旋涡星云	旋渦星雲
旋涡星系	旋渦星系
旋转干坤	旋轉乾坤
旋转曲面	旋轉曲面
旌善惩恶	旌善懲惡
旗开得胜	旗開得勝
旗鼓相当	旗鼓相當
无一幸免	無一倖免
无业游民	無業遊民
无业闲散	無業閒散
无了无休	無了無休
无以复加	無以復加
无价之宝	無價之寶
无价珍珠	無價珍珠
无偏无党	無偏無黨
无党无偏	無黨無偏
无党无派	無黨無派
无冤无仇	無冤無仇
无冬无夏	無冬無夏
无凭无据	無憑無據
无出其右	無出其右
无动于衷	無動於衷
无千大万	無千大萬
无千带数	無千帶數
无千无万	無千無萬
无可救药	無可救藥
无后为大	無後爲大
无复孑遗	無復孑遺
无尽无休	無盡無休
无尽无穷	無盡無窮
无尽缘起	無盡緣起
无形输出	無形輸出
无征不信	無徵不信
无恶不作	無惡不作
无所牵挂	無所牽掛
无所适从	無所適從
无挂无碍	無掛無礙
无敌不克	無敵不克
无梁楼盖	無樑樓蓋
无欲则刚	無欲則剛
无法克制	無法剋制
无法挽救	無法挽救
无济于事	無濟於事
无烟火药	無煙火藥
无烟焦煤	無煙焦煤
无牵无挂	無牽無掛
无畏布施	無畏佈施
无穷无尽	無窮無盡
无精打采	無精打采
无线电台	無綫電臺
无缘见面	無緣見面
无药可救	無藥可救
无补于世	無補於世
无补于事	無補於事
无补于时	無補於時
无足挂齿	無足掛齒
无适无莫	無適無莫
无钩绦虫	無鉤絛蟲
日久弥新	日久彌新
日出三竿	日出三竿
日出日落	日出日落
日出而作	日出而作
日升月恒	日升月恆
日历年度	日曆年度
日复一日	日復一日
日干夜干	日幹夜幹
日据时代	日據時代
日月升恒	日月升恆
日月参辰	日月參辰
日月合璧	日月合璧
日本国志	日本國誌
日正当中	日正當中
日理万机	日理萬機
日行千里	日行千里
日试万言	日試萬言
日趋恶劣	日趨惡劣
日转千街	日轉千街
日转千阶	日轉千階
日进斗金	日進斗金
日锻月炼	日鍛月煉
日食万钱	日食萬錢
旧地重游	舊地重遊
旧念复萌	舊念復萌
旧态复萌	舊態復萌
旧恨新仇	舊恨新仇
旧疾复发	舊疾復發
旧病复发	舊病復發
早借早还	早借早還
早出晚归	早出晚歸
早占勿药	早占勿藥
早去早回	早去早回
早名必折	早名必折
早日康复	早日康復
早有计划	早有計劃
旭日东升	旭日東昇
旭日初升	旭日初昇
时代周刊	時代週刊
时刻准备	時刻準備
时和岁丰	時和歲豐
时和年丰	時和年豐
时报周刊	時報週刊
时报杂志	時報雜誌
时紧时松	時緊時鬆
时装表演	時裝表演
时间电价	時間電價
时间艺术	時間藝術
时间范围	時間範圍
旷世之才	曠世之才
旷世奇才	曠世奇才
旷世逸才	曠世逸才
旷日弥久	曠日彌久
旷若发蒙	曠若發矇
旷课记录	曠課記錄
昆仑山脉	崑崙山脈
昆宁佩克	昆寧佩克
昆虫学家	昆蟲學家
昆都仑区	昆都侖區
昊天不吊	昊天不弔
昊天罔极	昊天罔極
明争暗斗	明爭暗鬥
明于观人	明於觀人
明伙画供	明伙畫供
明修栈道	明修棧道
明升暗降	明升暗降
明媚闲雅	明媚閒雅
明察暗访	明察暗訪
明察秋毫	明察秋毫
明尼苏达	明尼蘇達
明岗暗哨	明崗暗哨
明并日月	明並日月
明弃暗取	明棄暗取
明志工专	明志工專
明志工业	明志工業
明暗不定	明暗不定
明月当空	明月當空
明来暗往	明來暗往
明枪暗箭	明槍暗箭
明查暗访	明査暗訪
明査暗访	明査暗訪
明欺暗骗	明欺暗騙
明沟暗渠	明溝暗渠
明珠暗投	明珠暗投
明白了当	明白了當
明目张胆	明目張胆
明知就里	明知就裏
明窗净几	明窗淨几
明窗彩户	明窗彩戶
明窗淨几	明窗淨几
明见万里	明見萬里
明鉴万里	明鑑萬里
明鉴秋毫	明鑑秋毫
明降暗升	明降暗升
昏天暗地	昏天暗地
昏头转向	昏頭轉向
昏昏暗暗	昏昏暗暗
昏昏欲睡	昏昏欲睡
易于反掌	易於反掌
易卜拉辛	易卜拉辛
易发难收	易發難收
易学启蒙	易學啓蒙
易熔合金	易熔合金
星彩正彩	星彩正彩
星点弹涂	星點彈塗
星移斗换	星移斗換
星移斗转	星移斗轉
星罗云布	星羅雲佈
星罗云散	星羅雲散
星罗棋布	星羅棋佈
星落云散	星落雲散
星象恶曜	星象惡曜
星驰电发	星馳電發
映入眼帘	映入眼簾
映照出来	映照出來
春兰秋菊	春蘭秋菊
春华秋实	春華秋實
春去秋来	春去秋來
春回大地	春回大地
春困秋乏	春困秋乏
春夏秋冬	春夏秋冬
春心荡漾	春心蕩漾
春来秋去	春來秋去
春树暮云	春樹暮雲
春武里府	春武里府
春生秋杀	春生秋殺
春祈秋报	春祈秋報
春秋三传	春秋三傳
春秋五霸	春秋五霸
春秋几何	春秋幾何
春秋大梦	春秋大夢
春秋战国	春秋戰國
春秋日高	春秋日高
春秋时代	春秋時代
春秋笔削	春秋筆削
春秋笔法	春秋筆法
春秋繁露	春秋繁露
春秋鼎盛	春秋鼎盛
春笋怒发	春筍怒發
春花秋月	春花秋月
春蚓秋蛇	春蚓秋蛇
春露秋霜	春露秋霜
春风满面	春風滿面
春香斗学	春香鬥學
昧于事理	昧於事理
昨天夜里	昨天夜裏
昭君出塞	昭君出塞
是非善恶	是非善惡
是非曲直	是非曲直
昴宿星团	昴宿星團
昼伏夜出	晝伏夜出
昼伏夜游	晝伏夜游
显微手术	顯微手術
显现出来	顯現出來
显着标志	顯着標志
显示出来	顯示出來
显示钟表	顯示鐘錶
显著标志	顯著標志
显露出来	顯露出來
晃晃荡荡	晃晃蕩蕩
晏子春秋	晏子春秋
晕头转向	暈頭轉向
晚娘面孔	晚娘面孔
晚期癌症	晚期癌症
晚生后学	晚生後學
晚秋作物	晚秋作物
晚秋时节	晚秋時節
晚食当肉	晚食當肉
晨参暮省	晨參暮省
晨参暮礼	晨參暮禮
晨钟暮鼓	晨鐘暮鼓
普利艾托	普利艾托
普同文化	普同文化
普天同庆	普天同慶
普奥同盟	普奧同盟
普庵老祖	普庵老祖
普拉齐克	普拉齊克
普普艺术	普普藝術
普罗扎克	普羅扎克
普莱克斯	普萊克斯
普里切特	普里切特
普里斯特	普里斯特
普里斯莱	普里斯萊
普里查德	普里査德
景从云合	景從雲合
景从云集	景從雲集
景星庆云	景星慶雲
晴云秋月	晴雲秋月
晴时多云	晴時多雲
晴空万里	晴空萬里
晴转多云	晴轉多雲
晶体振荡	晶體振盪
智尽能索	智盡能索
暖荡撩锅	暖盪撩鍋
暗中作怪	暗中作怪
暗中摸索	暗中摸索
暗中监视	暗中監視
暗中行事	暗中行事
暗了下来	暗了下來
暗叫一声	暗叫一聲
暗吃一惊	暗吃一驚
暗室不欺	暗室不欺
暗室亏心	暗室虧心
暗室可欺	暗室可欺
暗室私心	暗室私心
暗室逢灯	暗室逢燈
暗察明访	暗察明訪
暗射地图	暗射地圖
暗度陈仓	暗度陳倉
暗操贱业	暗操賤業
暗无天日	暗無天日
暗暗淡淡	暗暗淡淡
暗淡无光	暗淡無光
暗渡陈仓	暗渡陳倉
暗潮汹涌	暗潮洶涌
暗然失色	暗然失色
暗笑一声	暗笑一聲
暗箭中人	暗箭中人
暗箭伤人	暗箭傷人
暗箭明鎗	暗箭明鎗
暗箭难防	暗箭難防
暗箱操作	暗箱操作
暗线光谱	暗綫光譜
暗结珠胎	暗結珠胎
暗自流泪	暗自流淚
暗自神伤	暗自神傷
暗自窃喜	暗自竊喜
暗藏春色	暗藏春色
暗藏玄机	暗藏玄機
暗藏鬼胎	暗藏鬼胎
暗记在心	暗記在心
暗送秋波	暗送秋波
暗通款曲	暗通款曲
暗香疏影	暗香疏影
暮云亲舍	暮雲親舍
暮云春树	暮雲春樹
暮礼晨参	暮禮晨參
暮雨朝云	暮雨朝雲
暮鼓晨钟	暮鼓晨鐘
暴发出来	暴發出來
暴尸于市	暴屍於市
暴敛横征	暴斂橫徵
暴露出来	暴露出來
曙后星孤	曙後星孤
曲媚取容	曲媚取容
曲学诐行	曲學詖行
曲学阿世	曲學阿世
曲尺楼梯	曲尺樓梯
曲尽人情	曲盡人情
曲尽其妙	曲盡其妙
曲径通幽	曲徑通幽
曲心矫肚	曲心矯肚
曲意俯就	曲意俯就
曲意奉承	曲意奉承
曲意逢迎	曲意逢迎
曲折离奇	曲折離奇
曲折萦纡	曲折縈紆
曲曲弯弯	曲曲彎彎
曲曲折折	曲曲折折
曲棍球员	曲棍球員
曲棍球赛	曲棍球賽
曲水流觞	曲水流觴
曲率向量	曲率向量
曲直分明	曲直分明
曲突徙薪	曲突徙薪
曲线拟合	曲綫擬合
曲线运动	曲綫運動
曲终人散	曲終人散
曲终奏雅	曲終奏雅
曲肱为枕	曲肱爲枕
曲肱之乐	曲肱之樂
曲肱而枕	曲肱而枕
曲里拐弯	曲裏拐彎
曲阜孔庙	曲阜孔廟
曲霉毒素	曲黴毒素
曲靖地区	曲靖地區
曲高和寡	曲高和寡
曲麻莱县	曲麻萊縣
曳尾泥涂	曳尾泥塗
曳尾涂中	曳尾塗中
更仆难数	更僕難數
更加规范	更加規範
更大范围	更大範圍
更待干罢	更待干罷
更胜一筹	更勝一籌
更鼓敲尽	更鼓敲盡
曼谷邮报	曼谷郵報
曾几何时	曾幾何時
曾参杀人	曾參殺人
曾母暗沙	曾母暗沙
最初几天	最初幾天
最初几年	最初幾年
最后一天	最後一天
最后审判	最後審判
最后晚餐	最後晚餐
最后更新	最後更新
最后期限	最後期限
最后胜利	最後勝利
最后通牒	最後通牒
最大范围	最大範圍
最小范围	最小範圍
最近几天	最近幾天
最近几年	最近幾年
最高当局	最高當局
月中折桂	月中折桂
月丽于箕	月麗於箕
月入数万	月入數萬
月地云阶	月地雲階
月坠花折	月墜花折
月宫娘娘	月宮娘娘
月桂树叶	月桂樹葉
月球表面	月球表面
月离于毕	月離於畢
月色迷蒙	月色迷濛
月落参横	月落參橫
月里嫦娥	月裏嫦娥
月锻季炼	月鍛季煉
有个好歹	有個好歹
有个屁用	有個屁用
有个数儿	有個數兒
有个说儿	有個說兒
有了人家	有了人家
有仇必报	有仇必報
有价証券	有價証券
有价证券	有價證券
有何面目	有何面目
有佛出世	有佛出世
有关方面	有關方面
有凭有据	有憑有據
有出好戏	有齣好戲
有力出力	有力出力
有去无回	有去無回
有同情心	有同情心
有奖征答	有獎徵答
有女同车	有女同車
有尽有让	有儘有讓
有征无战	有征無戰
有志一同	有志一同
有志之士	有志之士
有志竟成	有志竟成
有志难酬	有志難酬
有感而云	有感而云
有感而发	有感而發
有所不同	有所不同
有才无命	有才無命
有把傢伙	有把傢伙
有效范围	有效範圍
有效面积	有效面積
有机化合	有機化合
有机合成	有機合成
有板有眼	有板有眼
有枝有叶	有枝有葉
有枝添叶	有枝添葉
有棱有角	有棱有角
有求于人	有求於人
有福同享	有福同享
有色人种	有色人種
有药瘾者	有藥癮者
有进有出	有進有出
有鉴于此	有鑑於此
有钩绦虫	有鉤絛蟲
有钱出钱	有錢出錢
有钱有闲	有錢有閒
有难同当	有難同當
朋党为奸	朋黨爲奸
朋党之争	朋黨之爭
朋党比周	朋黨比周
朋比为奸	朋比爲奸
朋比作仇	朋比作仇
朋比作奸	朋比作奸
服务周到	服務周到
服务范围	服務範圍
服务规范	服務規範
服毒自尽	服毒自盡
服药过量	服藥過量
朗朗云天	朗朗雲天
望云之情	望雲之情
望眼欲穿	望眼欲穿
望秋先零	望秋先零
望穿秋水	望穿秋水
朝乾夕惕	朝乾夕惕
朝云暮雨	朝雲暮雨
朝出夕改	朝出夕改
朝升暮合	朝升暮合
朝参暮礼	朝參暮禮
朝发夕至	朝發夕至
朝干夕惕	朝乾夕惕
朝梁暮晋	朝梁暮晉
朝梁暮陈	朝梁暮陳
朝野两党	朝野兩黨
朝钟暮鼓	朝鐘暮鼓
朝鲜冷面	朝鮮冷麵
朦在鼓里	朦在鼓裏
木偶戏扎	木偶戲紮
木强则折	木強則折
木朽不雕	木朽不雕
木材干馏	木材乾餾
木板大鼓	木板大鼓
木薯淀粉	木薯澱粉
木雕泥塑	木雕泥塑
未了公案	未了公案
未卜先知	未卜先知
未嫁新娘	未嫁新娘
未尝不可	未嘗不可
未尽事宜	未盡事宜
未必尽然	未必盡然
未知万一	未知萬一
未竟之志	未竟之志
未签字者	未簽字者
未降反升	未降反升
末大必折	末大必折
本古里昂	本古里昂
本台消息	本臺消息
本同末异	本同末異
本征向量	本徵向量
本所同仁	本所同仁
本期发生	本期發生
本机振荡	本機振盪
本来面目	本來面目
本色当行	本色當行
本草药学	本草藥學
札格拉布	札格拉布
札格瑞布	札格瑞布
术德兼修	術德兼修
朱云折槛	朱雲折檻
朱利亚尼	朱利亞尼
朱利安尼	朱利安尼
朱口皓齿	朱口皓齒
朱古力糖	朱古力糖
朱古律糖	朱古律糖
朱唇皓齿	硃脣皓齒
朱墨烂然	朱墨爛然
朱子家训	朱子家訓
朱子语录	朱子語錄
朱子语类	朱子語類
朱干玉戚	朱干玉戚
朱弦玉磬	朱弦玉磬
朱拉隆功	朱拉隆功
朱理安历	朱理安曆
朱瑞特兹	朱瑞特茲
朱瓦碧甍	朱瓦碧甍
朱甍碧瓦	朱甍碧瓦
朱紫难别	朱紫難別
朱脣榴齿	朱脣榴齒
朱脣皓齿	朱脣皓齒
朱脣粉面	朱脣粉面
朱衣点头	朱衣點頭
朱轓皂盖	朱轓皂蓋
朱轮华毂	朱輪華轂
朱门绣户	朱門繡戶
朱阁青楼	朱閣青樓
朱陆异同	朱陸異同
朱陈之好	朱陳之好
朱颜粉面	朱顏粉面
朱颜鹤发	朱顏鶴髮
朴实作风	樸實作風
朴实无华	樸實無華
朴次茅斯	樸次茅斯
朴素无华	樸素無華
朴茨茅斯	朴茨茅斯
朴讷诚笃	樸訥誠篤
朴质无华	樸質無華
朴资茅斯	朴資茅斯
朴野无文	樸野無文
机关团体	機關團體
机关布景	機關布景
机关用尽	機關用盡
机器压制	機器壓製
机械学系	機械學系
机械钟表	機械鐘錶
机缘巧合	機緣巧合
朽木不雕	朽木不雕
朽木之才	朽木之才
朽棘不雕	朽棘不雕
杀出重围	殺出重圍
杀千刀的	殺千刀的
杀敌致果	殺敵致果
杀身出生	殺身出生
杂交育种	雜交育種
杂合面儿	雜合麵兒
杂和面儿	雜和麵兒
杂技表演	雜技表演
杂种优势	雜種優勢
杂种后代	雜種後代
杂谷脑镇	雜谷腦鎮
权力斗争	權力鬥爭
权变锋出	權變鋒出
权欲熏心	權慾薰心
权能划分	權能劃分
李代桃僵	李代桃僵
李郭同舟	李郭同舟
杏雨梨云	杏雨梨雲
材疏志大	材疏志大
杜松子酒	杜松子酒
杜秋娘歌	杜秋娘歌
杜绝后患	杜絕後患
杜老志道	杜老誌道
杜门不出	杜門不出
杜雅里克	杜雅里克
杞宋无征	杞宋無徵
束发封帛	束髮封帛
束发金冠	束髮金冠
束矢难折	束矢難折
束身修行	束身修行
束身自修	束身自修
杠杆收购	杠杆收購
来千去万	來千去萬
来历不明	來歷不明
来台访问	來臺訪問
来回来去	來回來去
来回的话	來回的話
来宾致词	來賓致詞
来来回回	來來回回
杨叶窜儿	楊葉竄兒
杨志卖刀	楊志賣刀
杨氏系数	楊氏係數
杭锦后旗	杭錦後旗
杯中之物	杯中之物
杯弓蛇影	杯弓蛇影
杯水之谢	杯水之謝
杯水粒粟	杯水粒粟
杯水车薪	杯水車薪
杯盘狼借	杯盤狼藉
杯盘狼籍	杯盤狼籍
杯盘狼藉	杯盤狼藉
杯葛运动	杯葛運動
杯蛇鬼车	杯蛇鬼車
杯觥交错	杯觥交錯
杯酒戈矛	杯酒戈矛
杯酒解怨	杯酒解怨
杯酒言欢	杯酒言歡
杰伊汉港	傑伊漢港
杰克伦敦	傑克倫敦
杰克德米	傑克德米
杰拉尔德	傑拉爾德
杰森包恩	傑森包恩
杳无人烟	杳無人煙
松一口气	鬆一口氣
松下一口	鬆下一口
松下公司	松下公司
松下电器	松下電器
松下电机	松下電機
松乔之寿	松喬之壽
松井秀喜	松井秀喜
松冈利胜	松岡利勝
松叶牡丹	松葉牡丹
松尾芭蕉	松尾芭蕉
松山机场	松山機場
松巴哇岛	松巴哇島
松弛下来	鬆弛下來
松懈下来	鬆懈下來
松散物料	鬆散物料
松本秀树	松本秀樹
松材线虫	松材綫蟲
松松垮垮	鬆鬆垮垮
松松散散	鬆鬆散散
松松脆脆	鬆鬆脆脆
松松软软	鬆鬆軟軟
松柏之坚	松柏之堅
松柏之寿	松柏之壽
松柏之茂	松柏之茂
松柏后凋	松柏後凋
松柏节操	松柏節操
松柏长青	松柏長青
松毛松翼	鬆毛鬆翼
松田圣子	松田聖子
松筠之操	松筠之操
松筠之节	松筠之節
松篁交翠	松篁交翠
松节油精	松節油精
松萝共倚	松蘿共倚
松赞干布	松贊干布
松软适口	鬆軟適口
松辽平原	松遼平原
松雪泰子	松雪泰子
松风水月	松風水月
松鹤延年	松鶴延年
松鹤遐龄	松鶴遐齡
板上钉钉	板上釘釘
板块构造	板塊構造
板块理论	板塊理論
板桥中学	板橋中學
板桥国中	板橋國中
板桥国小	板橋國小
板起面孔	板起面孔
极为庞大	極爲龐大
极乐世界	極樂世界
极切瞻韩	極切瞻韓
极力争取	極力爭取
极右份子	極右份子
极右分子	極右份子
极地气候	極地氣候
极坐标系	極座標系
极头麻化	極頭麻化
极婺联辉	極婺聯輝
极左份子	極左份子
极带地区	極帶地區
极有可能	極有可能
极权主义	極權主義
极权国家	極權國家
极权政治	極權政治
极深研几	極深研幾
极盛时期	極盛時期
极目望去	極目望去
极目远望	極目遠望
极目远眺	極目遠眺
极端主义	極端主義
极端份子	極端份子
极表同情	極表同情
极间电容	極間電容
极限体育	極限體育
极限强度	極限強度
构筑工事	構築工事
析毫剖厘	析毫剖釐
枕岩漱流	枕巖漱流
枕戈尝胆	枕戈嘗膽
枕经借史	枕經藉史
林下风致	林下風致
林下风范	林下風範
林克海德	林克海德
林冲夜奔	林沖夜奔
林口台地	林口臺地
林木参天	林木參天
果子干儿	果子乾兒
枝叶扶疏	枝葉扶疏
枝叶茂盛	枝葉茂盛
枝繁叶茂	枝繁葉茂
枪枝弹药	槍枝彈藥
枪械弹药	槍械彈藥
枯草杆菌	枯草桿菌
架海金梁	架海金梁
柏台乌府	柏臺烏府
柏林剧团	柏林劇團
柏节松操	柏節松操
染指于鼎	染指於鼎
柔情万千	柔情萬千
柔情万种	柔情萬種
柔枝嫩叶	柔枝嫩葉
柔能克刚	柔能克剛
柔能制刚	柔能制剛
柜买中心	櫃買中心
柜台委讬	櫃檯委託
柜坊赌局	櫃坊賭局
柯尔克孜	柯爾克孜
柳暗花明	柳暗花明
柳烟花雾	柳煙花霧
査找周期	査找周期
査无实据	査無實據
标准偏差	標準偏差
标准元音	標準元音
标准公顷	標準公頃
标准动作	標準動作
标准单位	標準單位
标准号码	標準號碼
标准大气	標準大氣
标准字体	標準字體
标准尺寸	標準尺寸
标准工资	標準工資
标准接口	標準接口
标准时区	標準時區
标准时间	標準時間
标准普尔	標準普爾
标准模型	標準模型
标准气压	標準氣壓
标准溶液	標準溶液
标准状况	標準狀況
标准状态	標準狀態
标准电阻	標準電阻
标准组织	標準組織
标准规格	標準規格
标准规范	標準規範
标准镜头	標準鏡頭
标准题名	標準題名
标同伐异	標同伐異
标本同治	標本同治
标标致致	標標致致
标记识别	標記識別
栋折榱崩	棟折榱崩
栋梁之任	棟樑之任
栋梁之材	棟樑之材
栋梁之臣	棟樑之臣
栖栖皇皇	棲棲皇皇
栗栗不安	慄慄不安
栗栗危惧	慄慄危懼
栗田雄介	栗田雄介
校园骨干	校園骨幹
核发电厂	核發電廠
核战斗部	核戰斗部
核查制度	核査制度
核能发电	核能發電
核能技术	核能技術
核能电厂	核能電廠
根壮叶茂	根壯葉茂
根据上表	根據上表
根据规定	根據規定
根深叶茂	根深葉茂
格丹斯克	格丹斯克
格于成例	格於成例
格于环境	格於環境
格但斯克	格但斯克
格子棉布	格子棉布
格物致知	格物致知
格瑞诺布	格瑞諾布
格致中学	格致中學
格致国中	格致國中
格里高利	格里高利
桂系军阀	桂系軍閥
桃叶珊瑚	桃葉珊瑚
桃花人面	桃花人面
桃金娘科	桃金娘科
桌椅板凳	桌椅板凳
桌面儿上	桌面兒上
桌面系统	桌面系統
桐叶知秋	桐葉知秋
桑干盆地	桑乾盆地
桑蓬之志	桑蓬之志
桥梁工事	橋樑工事
桥梁工程	橋樑工程
桶里射鱼	桶裏射魚
梁上君子	樑上君子
梁园宴雪	梁園宴雪
梁子湖区	梁子湖區
梁木其坏	樑木其壞
梁狱上书	梁獄上書
梁皇宝忏	梁皇寶懺
梁简文帝	梁簡文帝
梁鸿五噫	梁鴻五噫
梅花小娘	梅花小娘
梅里斯区	梅里斯區
梅里雪山	梅里雪山
梦兰叶吉	夢蘭叶吉
梦往神游	夢往神遊
梦里蝴蝶	夢裏蝴蝶
梯度回波	梯度回波
梵册贝叶	梵冊貝葉
检査出来	檢査出來
检测出来	檢測出來
检索系统	檢索系統
检警合一	檢警合一
检验出来	檢驗出來
棉花火药	棉花火藥
棋布星罗	棋佈星羅
棋罗星布	棋羅星佈
棒子面儿	棒子麵兒
棒旋星系	棒旋星系
棒曲霉素	棒麴黴素
棒状杆菌	棒狀桿菌
森林学系	森林學系
森罗万象	森羅萬象
植党营私	植黨營私
植物区系	植物區系
植物纤维	植物纖維
植皮手术	植皮手術
椭圆星系	橢圓星系
椭圆曲线	橢圓曲綫
椿萱并茂	椿萱並茂
楚庄绝缨	楚莊絕纓
楚庄问鼎	楚莊問鼎
楚汉春秋	楚漢春秋
楣运当头	楣運當頭
楼台亭阁	樓臺亭閣
楼梯平台	樓梯平臺
楼阁亭台	樓閣亭臺
榕坛问业	榕壇問業
槃槃大才	槃槃大才
槓杆原理	槓桿原理
模网论坛	模網論壇
模范丈夫	模範丈夫
模范人物	模範人物
模范作用	模範作用
模范城市	模範城市
模范学生	模範學生
模范带头	模範帶頭
模范教师	模範教師
模范行动	模範行動
模里西斯	模里西斯
横冲直撞	橫衝直撞
横尸遍野	橫屍遍野
横征暴敛	橫徵暴斂
横扫千军	橫掃千軍
横须贺市	橫須賀市
樵苏不爨	樵蘇不爨
橡子面儿	橡子麵兒
次级团体	次級團體
欢喜欲狂	歡喜欲狂
欣喜欲狂	欣喜欲狂
欣欣向荣	欣欣向榮
欣然同意	欣然同意
欣生恶死	欣生惡死
欧几里得	歐幾里得
欧几里德	歐幾里德
欧化倾向	歐化傾向
欧布拉多	歐布拉多
欧布莱特	歐布萊特
欧式几何	歐式幾何
欧式建筑	歐式建築
欧拉朱万	歐拉朱萬
欧普艺术	歐普藝術
欧游之行	歐遊之行
欧游记趣	歐遊記趣
欧特里尼	歐特里尼
欧萨苏纳	歐薩蘇納
欧足联杯	歐足聯杯
欲不可从	欲不可從
欲令智昏	慾令智昏
欲加之罪	欲加之罪
欲取固与	欲取固與
欲取姑与	欲取姑與
欲取姑予	欲取姑予
欲哭无泪	欲哭無淚
欲壑难填	慾壑難填
欲壑难饱	欲壑難飽
欲就还推	欲就還推
欲振乏力	欲振乏力
欲擒故纵	欲擒故縱
欲求不满	慾求不滿
欲海难填	欲海難填
欲深谿壑	欲深谿壑
欲火焚身	慾火焚身
欲炙之色	欲炙之色
欲益反损	欲益反損
欲盖弥彰	欲蓋彌彰
欲罢不能	欲罷不能
欲言又止	欲言又止
欲语还休	欲語還休
欲说还休	欲說還休
欲购从速	欲購從速
欲速不达	欲速不達
欹嵚历落	欹嶔歷落
欺善怕恶	欺善怕惡
欺敌战术	欺敵戰術
歇斯底里	歇斯底里
歌仔戏团	歌仔戲團
歌台舞榭	歌臺舞榭
歌坛新秀	歌壇新秀
歌声绕梁	歌聲繞梁
歌舞升平	歌舞昇平
止于至善	止於至善
止恶扬善	止惡揚善
止涨回跌	止漲回跌
止跌回升	止跌回升
正义斗争	正義鬥爭
正修工专	正修工專
正则参数	正则參數
正反两面	正反兩面
正合我意	正合我意
正向前看	正向前看
正在叱咤	正在叱咤
正多面体	正多面體
正头娘子	正頭娘子
正宫娘娘	正宮娘娘
正常范围	正常範圍
正弦曲线	正弦曲綫
正当理由	正當理由
正当行为	正當行爲
正当防卫	正當防衛
正方晶系	正方晶系
正枝正叶	正枝正葉
正正当当	正正當當
正正确确	正正確確
正确处理	正確處理
正确路线	正確路綫
正面人物	正面人物
正面攻击	正面攻擊
此仆彼起	此仆彼起
此发彼应	此發彼應
步人后尘	步人後塵
步斗踏罡	步斗踏罡
步月登云	步月登雲
步步行凶	步步行兇
步步高升	步步高升
步线行针	步綫行針
步罡踏斗	步罡踏斗
步调一致	步調一致
步飞烟传	步飛煙傳
武偃文修	武偃文修
武器系统	武器系統
武术指导	武術指導
武术比赛	武術比賽
武术竞赛	武術競賽
武松打虎	武松打虎
武装冲突	武裝衝突
武装斗争	武裝鬥爭
歪曲事实	歪曲事實
死不了心	死不了心
死于安乐	死於安樂
死于非命	死於非命
死伤枕借	死傷枕藉
死伤相借	死傷相藉
死别生离	死別生離
死后多年	死後多年
死命挣扎	死命掙扎
死有余辜	死有餘辜
死气沈沈	死氣沈沈
死海古卷	死海古卷
死海经卷	死海經卷
死灰复然	死灰復然
死灰复燃	死灰復燃
死灰复燎	死灰復燎
死生未卜	死生未卜
死相枕借	死相枕藉
死而不僵	死而不僵
死而后已	死而後已
死而后止	死而後止
死而复活	死而復活
死而复生	死而復生
死而复苏	死而復甦
死要面子	死要面子
死里求生	死裏求生
死里逃生	死裏逃生
死难同胞	死難同胞
殊属不当	殊屬不當
殊方同致	殊方同致
殊涂一致	殊塗一致
殊涂同会	殊塗同會
殊涂同归	殊塗同歸
殊涂同致	殊塗同致
殊致同归	殊致同歸
殊路同归	殊路同歸
殊途同归	殊途同歸
残余沾染	殘餘沾染
残冬腊月	殘冬臘月
残杯冷炙	殘杯冷炙
殚思极虑	殫思極慮
殚精极思	殫精極思
殚精极虑	殫精極慮
殢云尤雨	殢雲尤雨
殢雨尤云	殢雨尤雲
殷墟卜辞	殷墟卜辭
殷师牛斗	殷師牛鬥
殷鉴不远	殷鑑不遠
殿钟自鸣	殿鐘自鳴
毁于一旦	毀於一旦
毁尸灭迹	毀屍滅蹟
毁廉蔑耻	毀廉蔑恥
毁方瓦合	毀方瓦合
毁誉参半	毀譽參半
毁钟为铎	毀鐘爲鐸
毋贻后患	毋貽後患
母乳喂养	母乳餵養
母系亲属	母系親屬
母系制度	母系制度
母系社会	母系社會
每一个人	每一個人
每周一次	每週一次
每战必胜	每戰必勝
每日限价	每日限價
毒药苦口	毒藥苦口
比个高下	比個高下
比个高低	比個高低
比什凯克	比什凱克
比众不同	比眾不同
比喻失当	比喻失當
比手划脚	比手劃腳
比约克曼	比約克曼
比较规范	比較規範
毕力同心	畢力同心
毕宿星团	畢宿星團
毕生发展	畢生發展
毕翠克丝	畢翠克絲
毗婆尸佛	毗婆尸佛
毗舍婆佛	毗舍婆佛
毙而后已	斃而後已
毛了手脚	毛了手腳
毛发之功	毛髮之功
毛发俱竖	毛髮俱豎
毛发倒竖	毛髮倒豎
毛发悚然	毛髮悚然
毛发森竖	毛髮森豎
毛发皆竖	毛髮皆豎
毛发耸然	毛髮聳然
毛团把戏	毛團把戲
毛里拖毡	毛裏拖氈
毛里求斯	毛里求斯
毫不相干	毫不相干
毫厘不差	毫釐不差
毫厘不爽	毫釐不爽
毫厘之差	毫釐之差
毫厘千里	毫釐千里
毫发不差	毫髮不差
毫发不爽	毫髮不爽
毫发之差	毫髮之差
毫发无损	毫髮無損
毫发未伤	毫髮未傷
毫无二致	毫無二致
毫无价值	毫無價值
毫无准备	毫無準備
毫无根据	毫無根據
毫无节制	毫無節制
民主党人	民主黨人
民主党员	民主黨員
民主党派	民主黨派
民主党籍	民主黨籍
民主制度	民主制度
民众代表	民眾代表
民众团体	民眾團體
民俗曲艺	民俗曲藝
民和年丰	民和年豐
民坠涂炭	民墜塗炭
民心向背	民心向背
民心所向	民心所向
民心趋向	民心趨向
民怨盈涂	民怨盈塗
民意代表	民意代表
民意向背	民意向背
民族同化	民族同化
民族团结	民族團結
民族色彩	民族色彩
民生涂炭	民生塗炭
民生雕敝	民生雕敝
民用建筑	民用建築
民穷财尽	民窮財盡
民谣歌曲	民謠歌曲
民进党员	民進黨員
民进党团	民進黨團
民进党版	民進黨版
民进党籍	民進黨籍
民间合会	民間合會
民间团体	民間團體
民间艺术	民間藝術
民风淳朴	民風淳樸
民风纯朴	民風純樸
气充志定	氣充志定
气充志骄	氣充志驕
气克斗牛	氣克斗牛
气冲斗牛	氣衝斗牛
气冲牛斗	氣衝牛斗
气冲霄汉	氣衝霄漢
气力用尽	氣力用盡
气动控制	氣動控制
气势熏灼	氣勢熏灼
气吞牛斗	氣吞牛斗
气味相合	氣味相合
气喘吁吁	氣喘吁吁
气在心里	氣在心裏
气定神闲	氣定神閒
气扬采飞	氣揚采飛
气数已尽	氣數已盡
气极败坏	氣極敗壞
气满志得	氣滿志得
气满志骄	氣滿志驕
气焰熏天	氣焰熏天
气燄万丈	氣燄萬丈
气若游丝	氣若游絲
气象万千	氣象萬千
气骄志满	氣驕志滿
水光云影	水光雲影
水准测量	水準測量
水力发电	水力發電
水复难收	水覆難收
水尽山穷	水盡山窮
水尽鹅飞	水盡鵝飛
水底捞针	水底撈針
水彩画家	水彩畫家
水彩颜料	水彩顏料
水波荡漾	水波盪漾
水浒后传	水滸後傳
水清可鉴	水清可鑑
水穷山尽	水窮山盡
水落石出	水落石出
水谷之海	水穀之海
水轮发动	水輪發動
水轮发电	水輪發電
水逝云卷	水逝雲卷
水里纳瓜	水裏納瓜
水陆并进	水陸並進
水面系数	水面係數
水面舰艇	水面艦艇
永不录用	永不錄用
永志不忘	永誌不忘
永结同心	永結同心
永续发展	永續發展
求助于人	求助於人
求同存异	求同存異
求才若渴	求才若渴
求死愿望	求死願望
求生意志	求生意志
求田问舍	求田問舍
求神问卜	求神問卜
求过于供	求過於供
求道于盲	求道於盲
汇丰银行	匯豐銀行
汇率差额	匯率差額
汇编语言	彙編語言
汉克阿伦	漢克阿倫
汉奸走狗	漢奸走狗
汉宫秋月	漢宮秋月
汉弥尔顿	漢彌爾頓
汉弥登钟	漢彌登鐘
汉萨同盟	漢薩同盟
汉藏语系	漢藏語系
汗出如浆	汗出如漿
汗出如雨	汗出如雨
汗洽股栗	汗洽股慄
汗流满面	汗流滿面
江云渭树	江雲渭樹
江海同归	江海同歸
江淹才尽	江淹才盡
江湖术士	江湖術士
江湖术语	江湖術語
江苏南钢	江蘇南鋼
江郎才尽	江郎才盡
汤加里罗	湯加里羅
汤姆斯杯	湯姆斯杯
汤姆汉克	湯姆漢克
汽轮发电	汽輪發電
沃依采克	沃依采克
沃兹尼克	沃茲尼克
沃野千里	沃野千里
沈不住气	沈不住氣
沈北新区	沈北新區
沈得住气	沈得住氣
沈思往事	沈思往事
沈海铁路	瀋海鐵路
沈淀出来	沈澱出來
沈湎酒色	沈湎酒色
沈睡不醒	沈睡不醒
沈腰潘鬓	沈腰潘鬢
沈迷不醒	沈迷不醒
沈阳师范	瀋陽師範
沈静下来	沈靜下來
沈鱼落雁	沈魚落雁
沈默不语	沈默不語
沈默寡言	沈默寡言
沉渐刚克	沉漸剛克
沉潜刚克	沉潛剛克
沉郁顿挫	沉鬱頓挫
沙依巴克	沙依巴克
沙克疫苗	沙克疫苗
沙洛培克	沙洛培克
沙里淘金	沙裏淘金
没个出豁	沒個出豁
没个开交	沒個開交
没个是处	沒個是處
没个见识	沒個見識
没了主意	沒了主意
没了指望	沒了指望
没了经纬	沒了經緯
没了结处	沒了結處
没做摆布	沒做擺佈
没关系用	沒關係用
没出豁处	沒出豁處
没合眼儿	沒合眼兒
没处出豁	沒處出豁
没完没了	沒完沒了
没干没净	沒乾沒淨
没干没淨	沒乾沒淨
没张没致	沒張沒致
没摆布处	沒擺佈處
没有人烟	沒有人煙
没有关系	沒有關係
没有准儿	沒有準兒
没有差别	沒有差別
没有来历	沒有來歷
没有联系	沒有聯繫
没有面目	沒有面目
没极奈何	沒極奈何
没爹没娘	沒爹沒孃
没精打彩	沒精打彩
没精打采	沒精打采
没见世面	沒見世面
没见食面	沒見食面
没里没外	沒裏沒外
沥血之仇	瀝血之仇
河不出图	河不出圖
河外星云	河外星雲
河外星系	河外星系
河曲智叟	河曲智叟
河流汇集	河流匯集
河涸海干	河涸海乾
河落海干	河落海乾
油光满面	油光滿面
油回磨转	油回磨轉
油头粉面	油頭粉面
油尽灯枯	油盡燈枯
油漆未干	油漆未乾
油茶面儿	油茶麵兒
治疗炎症	治療炎症
沽名吊誉	沽名吊譽
沽名干誉	沽名干譽
沽酒当炉	沽酒當爐
沾染控制	沾染控制
沿才授职	沿才授職
沿门托钵	沿門托鉢
沿门挨户	沿門挨戶
泊松分布	泊松分佈
泌尿系统	泌尿系統
泌水乐饥	泌水樂飢
法书要录	法書要錄
法兰克林	法蘭克林
法兰克福	法蘭克福
法出多门	法出多門
法制日报	法制日報
法外行凶	法外行凶
法律制裁	法律制裁
法律学系	法律學系
法律规范	法律規範
法术无边	法術無邊
法柜奇兵	法櫃奇兵
法西斯党	法西斯黨
法身舍利	法身舍利
泡沫发胶	泡沫髮膠
泡面哲学	泡麵哲學
泡面市场	泡麵市場
波光荡漾	波光盪漾
波兰舞曲	波蘭舞曲
波哥里卡	波哥里卡
波尔布特	波爾布特
波布政权	波布政權
波斯里亚	波斯里亞
波浪周期	波浪週期
波涌云乱	波涌雲亂
波诡云谲	波詭雲譎
波谲云诡	波譎雲詭
泣别虞姬	泣別虞姬
泥塑木雕	泥塑木雕
泥封函谷	泥封函谷
泥质页岩	泥質頁岩
注冊主任	註冊主任
注冊商标	註冊商標
注冊手续	註冊手續
注冊用户	注冊用戶
注册商标	註冊商標
注射针头	注射針頭
注意事项	注意事項
注生娘娘	註生娘娘
注音一式	注音一式
注音字母	注音字母
注音符号	注音符號
泪出痛肠	淚出痛腸
泪如泉涌	淚如泉涌
泪容满面	淚容滿面
泪干肠断	淚乾腸斷
泪流满面	淚流滿面
泪眼蒙眬	淚眼矇矓
泫然欲泣	泫然欲泣
泫然欲泪	泫然欲淚
泰勒制度	泰勒制度
泰国新娘	泰國新娘
泰山北斗	泰山北斗
泰山娘娘	泰山娘娘
泰山梁木	泰山梁木
泰极而否	泰極而否
泰爱泰党	泰愛泰黨
泰系各族	泰系各族
泼出胆子	潑出膽子
泼贱烟花	潑賤煙花
洋场恶少	洋場惡少
洋相尽出	洋相盡出
洋相百出	洋相百出
洗冤集录	洗冤集錄
洗出作用	洗出作用
洗发动机	洗發動機
洗发水儿	洗髮水兒
洗心革志	洗心革志
洗心革面	洗心革面
洗手不干	洗手不幹
洗面革心	洗面革心
洛克希德	洛克希德
洛克斐勒	洛克斐勒
洛克菲勒	洛克菲勒
洛克西德	洛克西德
洛钟东应	洛鐘東應
洛阳才子	洛陽才子
洞察其奸	洞察其奸
洞山良价	洞山良价
洞烛其奸	洞燭其奸
洞烛奸邪	洞燭奸邪
洞窟美术	洞窟美術
洞见症结	洞見癥結
洞鉴古今	洞鑑古今
津巴布韦	津巴布韋
津贴制度	津貼制度
洪宪帝制	洪憲帝制
洪炉燎发	洪爐燎髮
活动曲尺	活動曲尺
活动桌面	活動桌面
活动看板	活動看板
活动范围	活動範圍
活厂经营	活廠經營
派克大衣	派克大衣
派克斯顿	派克斯頓
派出机关	派出機關
派团参加	派團參加
派屈克节	派屈克節
派拉蒙影	派拉蒙影
流于形式	流於形式
流传于世	流傳於世
流传后世	流傳後世
流域面积	流域面積
流氓集团	流氓集團
流水行云	流水行雲
流泄出来	流泄出來
流离遇合	流離遇合
流芳后世	流芳後世
流荡忘反	流蕩忘反
流血冲突	流血衝突
流血千里	流血千里
流血浮尸	流血浮尸
流血漂卤	流血漂鹵
流行歌曲	流行歌曲
流觞曲水	流觴曲水
流通出来	流通出來
流里流气	流裏流氣
流露出来	流露出來
流风余俗	流風餘俗
流风余韵	流風餘韻
流风回雪	流風迴雪
流鱼出听	流魚出聽
浅尝则止	淺嘗則止
浅尝辄止	淺嘗輒止
浊臭熏天	濁臭熏天
测地曲率	測地曲率
测量范围	測量範圍
济世之才	濟世之才
济困扶危	濟困扶危
济胜之具	濟勝之具
浑朴自然	渾樸自然
浑身发抖	渾身發抖
浑身发软	渾身發軟
浓云密布	濃雲密佈
浓墨重彩	濃墨重彩
浓淡适中	濃淡適中
浓雾密布	濃霧密佈
浩如烟气	浩如煙氣
浩如烟海	浩如煙海
浩浩荡荡	浩浩蕩蕩
浪子回头	浪子回頭
浪荡子式	浪蕩子式
浪荡干坤	浪蕩乾坤
浪蝶游蜂	浪蝶游蜂
浮云富贵	浮雲富貴
浮云惊龙	浮雲驚龍
浮云朝露	浮雲朝露
浮云游子	浮雲遊子
浮云翳日	浮雲翳日
浮云蔽日	浮雲蔽日
浮动汇率	浮動匯率
浮游动物	浮游動物
浮游植物	浮游植物
浮游生物	浮游生物
浮现出来	浮現出來
浮词曲说	浮詞曲說
浮雕墙纸	浮雕牆紙
海上布雷	海上佈雷
海上采油	海上採油
海于格松	海于格松
海国图志	海國圖志
海宇升平	海宇昇平
海尔布隆	海爾布隆
海干河尽	海乾河盡
海底峡谷	海底峽谷
海底捞针	海底撈針
海洋开发	海洋開發
海涂围垦	海塗圍墾
海湾布雷	海灣佈雷
海立云垂	海立雲垂
海蒂克伦	海蒂克倫
海蚀台地	海蝕臺地
海蚀平台	海蝕平臺
海里海外	海裏海外
涂姓技士	塗姓技士
涂惠源雨	涂惠源雨
涂抹诗书	塗抹詩書
涂改无效	塗改無效
涂来涂去	塗來塗去
涂涂改改	塗塗改改
涂炭生民	塗炭生民
涂炭生灵	塗炭生靈
涂脂抹粉	塗脂抹粉
消化系统	消化系統
消毒药水	消毒藥水
消灭殆尽	消滅殆盡
消灭淨尽	消滅淨盡
消费借贷	消費借貸
涛生云灭	濤生雲滅
涤瑕荡垢	滌瑕盪垢
涤瑕荡秽	滌瑕盪穢
涤秽荡瑕	滌穢盪瑕
涨价归公	漲價歸公
涨红了脸	漲紅了臉
涨过了头	漲過了頭
淀谓之滓	澱謂之滓
淋巴系统	淋巴系統
淋淋漓漓	淋淋漓漓
淋漓尽致	淋漓盡致
淋漓痛快	淋漓痛快
淡于名利	淡於名利
淡入淡出	淡入淡出
淡出淡入	淡出淡入
淡水河系	淡水河系
淨化系统	淨化系統
深仇大恨	深仇大恨
深入敌后	深入敵後
深入显出	深入顯出
深入浅出	深入淺出
深奸巨猾	深奸巨猾
深居简出	深居簡出
深山穷谷	深山窮谷
深思极虑	深思極慮
深恶痛嫉	深惡痛嫉
深恶痛绝	深惡痛絕
深文周纳	深文周納
深有同感	深有同感
深沈不露	深沈不露
深沟墩台	深溝墩臺
深浅不同	深淺不同
深海烟囱	深海煙囪
深色系列	深色系列
深获好评	深獲好評
深表同情	深表同情
混合使用	混合使用
混合列车	混合列車
混合感染	混合感染
混合模型	混合模型
混合毒剂	混合毒劑
混合疫苗	混合疫苗
混合经济	混合經濟
混合结构	混合結構
混合肥料	混合肥料
混合裁判	混合裁判
混合齿列	混合齒列
添枝加叶	添枝加葉
添枝接叶	添枝接葉
清党行动	清黨行動
清心寡欲	清心寡慾
清杆运动	清桿運動
清汤挂面	清湯掛麵
清浊同流	清濁同流
清算斗争	清算鬥爭
清贫寡欲	清貧寡欲
清闲自在	清閒自在
清静寡欲	清靜寡欲
渊淳岳峙	淵淳嶽峙
渊鉴类函	淵鑑類函
渔民团体	漁民團體
渡假胜地	渡假勝地
渥兹尼克	渥茲尼克
温布尔登	溫佈爾登
温布尔顿	溫布爾頓
温布顿赛	溫布頓賽
温度范围	溫度範圍
温得和克	溫得和克
港台地区	港臺地區
渴饮饥餐	渴飲飢餐
游丝飞絮	遊絲飛絮
游云惊龙	遊雲驚龍
游人如织	遊人如織
游侠骑士	遊俠騎士
游兴正浓	遊興正濃
游刃有余	遊刃有餘
游刃有馀	遊刃有餘
游吟诗人	遊吟詩人
游嘴光棍	遊嘴光棍
游园惊梦	遊園驚夢
游头浪子	遊頭浪子
游子天涯	遊子天涯
游客在线	遊客在綫
游客如织	遊客如織
游客止步	遊客止步
游山玩水	遊山玩水
游心寓目	遊心寓目
游心骋目	遊心騁目
游必有方	遊必有方
游戏三昧	遊戲三昧
游戏人间	遊戲人間
游戏尘寰	遊戲塵寰
游戏机台	遊戲機檯
游戏规则	遊戲規則
游戏设备	遊戲設備
游手人户	遊手人戶
游手好闲	遊手好閒
游手恣睢	遊手恣睢
游手游食	遊手遊食
游来游去	游來游去
游标位置	遊標位置
游标卡尺	遊標卡尺
游民改造	遊民改造
游湖借伞	遊湖借傘
游牧民族	遊牧民族
游目骋怀	遊目騁懷
游离份子	遊離份子
游离电子	遊離電子
游离辐射	遊離輻射
游移不决	遊移不決
游移不定	遊移不定
游艇业者	遊艇業者
游花插趣	遊花插趣
游荡不归	遊蕩不歸
游营撞尸	遊營撞屍
游蜂戏蝶	遊蜂戲蝶
游蜂浪蝶	遊蜂浪蝶
游行示众	遊行示眾
游行示威	遊行示威
游街示众	遊街示眾
游览胜地	遊覽勝地
游说团体	遊說團體
游谈无根	遊談無根
游资氾滥	遊資氾濫
游辞浮说	遊辭浮說
游食之民	遊食之民
游骑兵队	遊騎兵隊
游骑无归	遊騎無歸
游龙戏凤	游龍戲鳳
渺无人烟	渺無人煙
湟潦生苹	湟潦生苹
湮灭证据	湮滅證據
源泉万斛	源泉萬斛
溜溜秋秋	溜溜秋秋
溜须拍马	溜鬚拍馬
溢于言表	溢於言表
溥天同庆	溥天同慶
溶液聚合	溶液聚合
溶溶荡荡	溶溶蕩蕩
滇西纵谷	滇西縱谷
滋补药品	滋補藥品
滑了一跤	滑了一跤
滑出跑道	滑出跑道
滑板运动	滑板運動
滔滔不尽	滔滔不盡
滚成一团	滾成一團
滞后现象	滯後現象
满口称赞	滿口稱讚
满口胡扯	滿口胡扯
满口胡柴	滿口胡柴
满口胡言	滿口胡言
满口胡说	滿口胡說
满口脏话	滿口髒話
满场一致	滿場一致
满坑满谷	滿坑滿谷
满天星斗	滿天星斗
满头洋发	滿頭洋髮
满山满谷	滿山滿谷
满布疑云	滿布疑雲
满拚自尽	滿拚自盡
满拼自尽	滿拚自盡
满洲里市	滿洲裏市
满满当当	滿滿當當
满脸溅朱	滿臉濺朱
满腹才学	滿腹才學
满腹疑云	滿腹疑雲
满面堆笑	滿面堆笑
满面怒容	滿面怒容
满面愁容	滿面愁容
满面春生	滿面春生
满面春风	滿面春風
满面杀气	滿面殺氣
满面生春	滿面生春
满面生花	滿面生花
满面笑容	滿面笑容
满面红胀	滿面紅脹
满面羞惭	滿面羞慚
满面羞愧	滿面羞愧
满面通红	滿面通紅
满面雪霜	滿面雪霜
满面飞红	滿面飛紅
滴修都速	滴修都速
滴水漏斗	滴水漏斗
滴羞都苏	滴羞都蘇
滴里嘟噜	滴里嘟嚕
滴里搭拉	滴里搭拉
滴里耷拉	滴里耷拉
漂荡子弟	漂蕩子弟
漆黑一团	漆黑一團
漏尽更阑	漏盡更闌
漏洞百出	漏洞百出
漏网游鱼	漏網游魚
漏脯充饥	漏脯充飢
漓漓拉拉	漓漓拉拉
演出地点	演出地點
演武修文	演武修文
漩涡星云	漩渦星雲
漫天叫价	漫天叫價
漫天开价	漫天開價
漫天索价	漫天索價
漫天讨价	漫天討價
漫无节制	漫無節制
漫无限制	漫無限制
漫游四方	漫遊四方
漱口药水	漱口藥水
潘太克斯	潘太克斯
潘安白发	潘安白髮
潘嶽白发	潘嶽白髮
潘鬓沈腰	潘鬢沈腰
潜意识里	潛意識裏
潜水夫症	潛水夫症
潜水钟表	潛水鐘錶
潜移暗化	潛移暗化
潜蛟困凤	潛蛟困鳳
潭祉叶吉	潭祉叶吉
潮力发电	潮力發電
澄澹精致	澄澹精致
澳新军团	澳新軍團
澳门汇业	澳門匯業
澹台灭明	澹臺滅明
澹泊寡欲	澹泊寡欲
澹泊明志	澹泊明志
激于义愤	激於義憤
激发出来	激發出來
激发注射	激發注射
激发起来	激發起來
激荡不已	激盪不已
濒临绝种	瀕臨絕種
濒于绝境	瀕於絕境
濒于绝种	瀕於絕種
濒危物种	瀕危物種
灌溉系统	灌溉系統
灌溉面积	灌溉面積
火中取栗	火中取栗
火力发电	火力發電
火山爆发	火山爆發
火浣布衫	火浣布衫
火海战术	火海戰術
火灭烟消	火滅煙消
火箭发动	火箭發動
火箭布雷	火箭佈雷
火耕水种	火耕水種
火耕流种	火耕流種
火里火发	火裏火發
灭绝种族	滅絕種族
灭罪修因	滅罪修因
灯火万家	燈火萬家
灯火管制	燈火管制
灰头土面	灰頭土面
灰头草面	灰頭草面
灰岩残丘	灰巖殘丘
灰灰暗暗	灰灰暗暗
灰灰蒙蒙	灰灰濛濛
灰面鵟鹰	灰面鵟鷹
灰飞烟灭	灰飛煙滅
灵丹圣药	靈丹聖藥
灵丹妙药	靈丹妙藥
灿烂多彩	燦爛多彩
炊烟袅袅	炊煙裊裊
炊臼之戚	炊臼之戚
炎日当空	炎日當空
炒面块子	炒麵塊子
炭疽杆菌	炭疽桿菌
炳烛夜游	炳燭夜遊
点染云烟	點染雲煙
点面结合	點面結合
炼之未定	煉之未定
炼石补天	煉石補天
炼金术士	煉金術士
烂了舌头	爛了舌頭
烂板乌龟	爛板烏龜
烂板洋钱	爛板洋錢
烈日当空	烈日當空
烈火干柴	烈火乾柴
烘云托月	烘雲托月
烟云供养	煙雲供養
烟云过眼	煙雲過眼
烟台地区	煙臺地區
烟岚云岫	煙嵐雲岫
烟波万顷	煙波萬頃
烟波浩渺	煙波浩渺
烟波钓叟	煙波釣叟
烟波钓徒	煙波釣徒
烟消云散	煙消雲散
烟消冰释	煙消冰釋
烟消火灭	煙消火滅
烟消雾散	煙消霧散
烟火之警	煙火之警
烟火邻居	煙火鄰居
烟熏火燎	煙熏火燎
烟燄障天	煙燄障天
烟生喉舌	煙生喉舌
烟笼雾锁	煙籠霧鎖
烟花寨主	煙花寨主
烟花柳巷	煙花柳巷
烟花粉柳	煙花粉柳
烟花粉黛	煙花粉黛
烟花行院	煙花行院
烟花门户	煙花門戶
烟花风月	煙花風月
烟蓑雨笠	煙蓑雨笠
烟袋哨子	菸袋哨子
烟袋嘴儿	菸袋嘴兒
烟袋杆儿	菸袋桿兒
烟袋油子	菸袋油子
烟袋荷包	菸袋荷包
烟袋锅子	菸袋鍋子
烟视媚行	煙視媚行
烟酒不沾	煙酒不沾
烟酒公卖	菸酒公賣
烟雾弥漫	煙霧瀰漫
烟雾迷漫	煙霧迷漫
烟霏雾集	煙霏霧集
烟霏露结	煙霏露結
烟霞外人	煙霞外人
烟霞痼疾	煙霞痼疾
烟飞星散	煙飛星散
烤面包机	烤麵包機
烫一个发	燙一個髮
烫一次发	燙一次髮
热出病来	熱出病來
热功当量	熱功當量
热闹哄哄	熱鬧哄哄
烽烟四起	烽煙四起
烽烟遍地	烽煙遍地
焊接艺术	焊接藝術
焕发起来	煥發起來
焚尸扬灰	焚屍揚灰
無言不仇	無言不讎
焦急万分	焦急萬分
焦面大士	焦面大士
煞费周章	煞費周章
煤气工厂	煤氣工廠
照价征税	照價徵稅
照价收买	照價收買
照价收购	照價收購
照价赔偿	照價賠償
照相制版	照相製版
照相干片	照相乾片
照签不误	照簽不誤
煨干就湿	煨乾就濕
煨干避湿	煨乾避濕
煮字疗饥	煮字療飢
煮粥焚须	煮粥焚鬚
熊据虎跱	熊據虎跱
熏陶成性	熏陶成性
熏风徐来	熏風徐來
熔岩穹丘	熔岩穹丘
熔融岩浆	熔融岩漿
熬姜呷醋	熬薑呷醋
燃料组合	燃料組合
燃气电厂	燃氣電廠
燕巢于幕	燕巢於幕
燕昭筑台	燕昭築臺
燕燕于飞	燕燕于飛
爆发出来	爆發出來
爬虫动物	爬蟲動物
爰定祥历	爰定祥厤
爱丽舍宫	愛麗捨宮
爱乐乐团	愛樂樂團
爱克斯光	愛克斯光
爱别离苦	愛別離苦
爱在心里	愛在心裏
爱心彩券	愛心彩券
爱恶分明	愛惡分明
爱才好士	愛才好士
爱才如命	愛才如命
爱才若渴	愛才若渴
爱管闲事	愛管閒事
爱远恶近	愛遠惡近
爵士乐团	爵士樂團
父女关系	父女關係
父子关系	父子關係
父子同牝	父子同牝
父系亲属	父系親屬
父系制度	父系制度
爷羹娘饭	爺羹孃飯
爷饭娘羹	爺飯孃羹
牀头金尽	牀頭金盡
片云遮顶	片雲遮頂
片善小才	片善小才
片甲不回	片甲不回
片石千钧	片石千鈞
片纸只字	片紙隻字
片言只字	片言隻字
片言只语	片言隻語
片言折狱	片言折獄
片语只字	片語隻字
片语只辞	片語隻辭
片面之言	片面之言
片面之词	片面之詞
牙克石市	牙克石市
牙机巧制	牙機巧制
牙签万轴	牙籤萬軸
牙签犀轴	牙簽犀軸
牙签玉轴	牙籤玉軸
牙签锦轴	牙籤錦軸
牙籤万轴	牙籤萬軸
牛回磨转	牛回磨轉
牛头马面	牛頭馬面
牛李党争	牛李黨爭
牛肉拉面	牛肉拉麵
牛肉汤面	牛肉湯麵
牛肉炒面	牛肉炒麵
牛肉面节	牛肉麵節
牛表牛觔	牛表牛觔
牛角挂书	牛角掛書
牛角面包	牛角麵包
牛骥同槽	牛驥同槽
牛骥同皁	牛驥同皁
牛骥同皂	牛驥同皂
牢靠妥当	牢靠妥當
牧神午后	牧神午後
物产丰富	物產豐富
物件导向	物件導向
物价指数	物價指數
物尽其用	物盡其用
物极则衰	物極則衰
物极必反	物極必反
物欲世界	物慾世界
物欲横流	物慾橫流
物流系统	物流系統
物种来由	物種來由
物种起源	物種起源
物美价廉	物美價廉
物腐虫生	物腐蟲生
物色人才	物色人才
物阜民丰	物阜民豐
牵三挂四	牽三掛四
牵五挂四	牽五掛四
牵制行动	牽制行動
牵合附会	牽合附會
牵心挂肠	牽心掛腸
牵籐带叶	牽籐帶葉
牵肚挂肠	牽肚掛腸
牵肠挂肚	牽腸掛肚
特克斯县	特克斯縣
特克斯市	特克斯市
特克斯河	特克斯河
特内里费	特內里費
特别公积	特別公積
特别刑法	特別刑法
特别助理	特別助理
特别卖力	特別賣力
特别客串	特别客串
特别待遇	特別待遇
特别感谢	特別感謝
特别护士	特別護士
特别护理	特別護理
特别报导	特別報導
特别报道	特別報道
特别来宾	特別來賓
特别节目	特別節目
特别费案	特別費案
特别门诊	特別門診
特征向量	特徵向量
特征联合	特徵聯合
特惠制度	特惠制度
特殊关系	特殊關係
特殊性向	特殊性向
特殊才能	特殊才能
特种作战	特種作戰
特种工艺	特種工藝
特种文书	特種文書
特种考试	特種考試
特种行业	特種行業
特种警察	特種警察
特种部队	特種部隊
特艺彩色	特藝彩色
犬牙相制	犬牙相制
犯罪团伙	犯罪團伙
犯罪集团	犯罪集團
状态参数	狀態參數
犹如钟表	猶如鐘錶
狂花病叶	狂花病葉
狃于成见	狃於成見
狎妓冶游	狎妓冶游
狐借虎威	狐藉虎威
狐朋狗党	狐朋狗黨
狐羣狗党	狐羣狗黨
狐群狗党	狐羣狗黨
狐裘蒙戎	狐裘蒙戎
狗党狐羣	狗黨狐羣
狗占马坑	狗占馬坑
狗娘养的	狗孃養的
狗皮膏药	狗皮膏藥
狞恶可怖	獰惡可怖
独具只眼	獨具隻眼
独出一时	獨出一時
独出心裁	獨出心裁
独出机杼	獨出機杼
独占事业	獨佔事業
独占市场	獨佔市場
独占花魁	獨佔花魁
独占资本	獨佔資本
独占鳌头	獨佔鰲頭
独占鼇头	獨佔鼇頭
独尊儒术	獨尊儒術
独当一面	獨當一面
独挑大梁	獨挑大樑
独擅胜场	獨擅勝場
独根孤种	獨根孤種
独步当时	獨步當時
独立出来	獨立出來
独立千古	獨立千古
独辟蹊径	獨闢蹊徑
狼心狗幸	狼心狗幸
狼烟四起	狼煙四起
狼狈万状	狼狽萬狀
狼狈为奸	狼狽爲奸
猎狩终极	獵狩終極
猜三划五	猜三划五
猥当大任	猥當大任
猪脚面线	豬腳麵綫
猪链球菌	豬鏈球菌
猫鼠同眠	貓鼠同眠
猫鼠游戏	貓鼠遊戲
猴面包树	猴麵包樹
猿鹤沙虫	猿鶴沙蟲
猿鹤虫沙	猿鶴蟲沙
玄机暗藏	玄機暗藏
玄黄翻复	玄黃翻覆
率先垂范	率先垂範
率团参加	率團參加
率土同庆	率土同慶
玉勒雕鞍	玉勒雕鞍
玉卮无当	玉卮無當
玉台新咏	玉臺新詠
玉叶金枝	玉葉金枝
玉叶金柯	玉葉金柯
玉叶金花	玉葉金花
玉尺量才	玉尺量才
玉手纤纤	玉手纖纖
玉枝卜寿	玉枝卜壽
玉石同沉	玉石同沉
玉石同烬	玉石同燼
玉石同焚	玉石同焚
玉米淀粉	玉米澱粉
王佐之才	王佐之才
王公贵戚	王公貴戚
王母娘娘	王母娘娘
王者风范	王者風範
玩物丧志	玩物喪志
玫瑰星云	玫瑰星雲
环保斗士	環保鬥士
环极涡旋	環極渦旋
环游世界	環遊世界
环顾四周	環顧四周
现代建筑	現代建築
现代舞团	現代舞團
现代艺术	現代藝術
现代集团	現代集團
现出原形	現出原形
现出原身	現出原身
现场表演	現場表演
现场采访	現場採訪
现进现出	現進現出
玻璃浮雕	玻璃浮雕
玻璃纤维	玻璃纖維
玻里尼西	玻里尼西
珍同拱璧	珍同拱璧
珍珠项链	珍珠項鍊
珍肴异馔	珍肴異饌
珠斗烂班	珠斗爛班
珠联璧合	珠聯璧合
珠胎暗结	珠胎暗結
珠还合浦	珠還合浦
班克劳夫	班克勞夫
班师回朝	班師回朝
球后艾宁	球后艾寧
球状星团	球狀星團
球面三角	球面三角
球面几何	球面幾何
理一个发	理一個髮
理一次发	理一次髮
理不胜辞	理不勝辭
理事长杯	理事長盃
理出头绪	理出頭緒
理发师傅	理髮師傅
理固当然	理固當然
理当如此	理當如此
理所当然	理所當然
琨玉秋霜	琨玉秋霜
琴断朱弦	琴斷朱絃
琵琶别抱	琵琶別抱
琼台玉宇	瓊臺玉宇
琼台玉阁	瓊臺玉閣
琼枝玉叶	瓊枝玉葉
瑞气祥云	瑞氣祥雲
瑞秋怀兹	瑞秋懷茲
瑞郎方面	瑞郎方麵
瑟瑟发抖	瑟瑟發抖
瑟瑟秋风	瑟瑟秋風
瑶台琼室	瑤臺瓊室
瑶台银阙	瑤臺銀闕
璧合珠联	璧合珠聯
璧合珠连	璧合珠連
瓦利泰克	瓦利泰克
瓦合之卒	瓦合之卒
瓦尔基里	瓦爾基里
瓦尔达克	瓦爾達克
瓦瑞泰克	瓦瑞泰克
瓦解云散	瓦解雲散
瓶坠簪折	瓶墜簪折
甄别考试	甄別考試
甄奇录异	甄奇錄異
甄才品能	甄才品能
甄选人才	甄選人才
甕尽杯干	甕盡杯乾
甕里醯鸡	甕裏醯雞
甘居下游	甘居下游
甘心情愿	甘心情願
甚么都干	甚麼都幹
甚获好评	甚獲好評
生于忧患	生於憂患
生产关系	生產關係
生产出来	生產出來
生产合作	生產合作
生产斗争	生產鬥爭
生产管制	生產管制
生佛万家	生佛萬家
生刍致祭	生芻致祭
生别死离	生別死離
生命周期	生命週期
生命征象	生命徵象
生态旅游	生態旅遊
生态系统	生態系統
生情发意	生情發意
生技医药	生技醫藥
生栋复屋	生棟覆屋
生死别离	生死別離
生死未卜	生死未卜
生死轮回	生死輪迴
生殖洄游	生殖洄游
生殖系统	生殖系統
生民涂炭	生民塗炭
生活水准	生活水準
生涯规划	生涯規劃
生灵涂地	生靈塗地
生灵涂炭	生靈塗炭
生物制剂	生物製劑
生物制品	生物製品
生物合成	生物合成
生物学系	生物學系
生物弹药	生物彈藥
生物技术	生物技術
生物时钟	生物時鐘
生理时钟	生理時鐘
生离死别	生離死別
生迭水准	生迭水準
用一当十	用一當十
用于修饰	用於修飾
用作配种	用作配種
用字不当	用字不當
用尽心思	用盡心思
用尽心机	用盡心機
用尽方法	用盡方法
用志不分	用志不分
用户数据	用戶數據
用户界面	用戶界面
用来配种	用來配種
用舍失宜	用舍失宜
用舍行藏	用舍行藏
用行舍藏	用行舍藏
用词不当	用詞不當
甩手掌柜	甩手掌櫃
甯戚扣角	甯戚扣角
甯戚饭牛	甯戚飯牛
田家庵区	田家庵區
田父之获	田父之獲
由恪志远	由恪志遠
由表及里	由表及裏
甲壳虫类	甲殼蟲類
甲种体位	甲種體位
甲第连云	甲第連雲
电卷星飞	電卷星飛
电卷风驰	電卷風馳
电子反制	電子反制
电子学系	電子學系
电子店面	電子店面
电子杂志	電子雜誌
电子游戏	電子遊戲
电子看板	電子看板
电子表单	電子表單
电子表情	電子表情
电子表格	電子表格
电子表示	電子表示
电子论坛	電子論壇
电子钟表	電子鐘錶
电影制作	電影製作
电影制片	電影製片
电影美术	電影美術
电影艺术	電影藝術
电影集团	電影集團
电磁干扰	電磁干擾
电磁振荡	電磁震盪
电磁脉冲	電磁脈衝
电脑彩喷	電腦彩噴
电脑游戏	電腦遊戲
电脑看板	電腦看板
电脑系统	電腦系統
电脑网志	電腦網誌
电脑艺术	電腦藝術
电荷耦合	電荷耦合
电视采访	電視採訪
电话录音	電話錄音
电针麻醉	電針麻醉
男大当婚	男大當婚
男女关系	男女關係
男女有别	男女有別
男性厌恶	男性厭惡
男才女貌	男才女貌
男生宿舍	男生宿舍
画栋雕梁	畫棟雕樑
画栋飞云	畫棟飛雲
画梁雕栋	畫樑雕棟
画法几何	畫法幾何
画阁朱楼	畫閣朱樓
画饼充饥	畫餅充飢
畅所欲为	暢所欲爲
畅所欲言	暢所欲言
界分别观	界分別觀
畎亩下才	畎畝下才
畏影恶迹	畏影惡蹟
留中不发	留中不發
留芳千古	留芳千古
留芳后世	留芳後世
留连不舍	留連不捨
略尽情谊	略盡情誼
略无参商	略無參商
略有出入	略有出入
略胜一筹	略勝一籌
番天复地	番天覆地
番张跟斗	番張跟斗
番来复去	番來覆去
畸形发展	畸形發展
疏于防备	疏於防備
疏于防范	疏於防範
疑云重重	疑雲重重
疑信参半	疑信參半
疑难杂症	疑難雜症
疲于奔命	疲於奔命
疲劳极限	疲勞極限
疵蒙谬累	疵蒙謬累
疾之如仇	疾之如仇
疾之若仇	疾之若仇
疾恶好善	疾惡好善
疾恶如仇	疾惡如仇
疾恶若仇	疾惡若仇
疾病突发	疾病突發
病后初愈	病後初愈
病后初癒	病後初癒
病容满面	病容滿面
病毒血症	病毒血症
病毒防范	病毒防範
病虫危害	病蟲危害
痘疹娘娘	痘疹娘娘
痛不欲生	痛不欲生
痛失英才	痛失英才
痛快淋漓	痛快淋漓
痛毁极诋	痛毀極詆
痛苦万分	痛苦萬分
痢疾杆菌	痢疾桿菌
痲痹不了	痲痹不了
痲痺不了	痲痺不了
瘅恶彰善	癉惡彰善
瘦小枯干	瘦小枯乾
癌症病患	癌症病患
癌症肿瘤	癌症腫瘤
登台拜将	登臺拜將
登台演唱	登臺演唱
登台表演	登臺表演
登坛拜将	登壇拜將
登峰造极	登峰造極
登庸人才	登庸人才
白云亲舍	白雲親舍
白云孤飞	白雲孤飛
白云机场	白雲機場
白云片片	白雲片片
白云矿区	白雲礦區
白云苍狗	白雲蒼狗
白兔捣药	白兔擣藥
白兔擣药	白兔擣藥
白净面皮	白淨面皮
白发其事	白發其事
白发如新	白髮如新
白发朱颜	白髮朱顏
白发相守	白髮相守
白发红颜	白髮紅顏
白发苍苍	白髮蒼蒼
白发苍颜	白髮蒼顏
白发郎潜	白髮郎潛
白发银须	白髮銀鬚
白发青衫	白髮青衫
白发齐眉	白髮齊眉
白古苏花	白古蘇花
白喉杆菌	白喉桿菌
白得发亮	白得發亮
白搽白折	白搽白折
白日升天	白日昇天
白日飞升	白日飛昇
白板单吊	白板單吊
白板天子	白板天子
白淨面皮	白淨面皮
白色人种	白色人種
白蜡明经	白蠟明經
白蜡杆子	白蠟杆子
白里透红	白裏透紅
白面书生	白面書生
白面书郎	白面書郎
白面无须	白面無鬚
白面鼯鼠	白面鼯鼠
白首北面	白首北面
白首同归	白首同歸
白马归周	白馬歸周
白驹空谷	白駒空谷
白鹤秀才	白鶴秀才
百万之众	百萬之眾
百万富翁	百萬富翁
百万赫兹	百萬赫茲
百万雄兵	百萬雄兵
百万雄师	百萬雄師
百不当一	百不當一
百中百发	百中百發
百了千当	百了千當
百事和合	百事和合
百卉千葩	百卉千葩
百发百中	百發百中
百只足够	百只足夠
百叶窗帘	百葉窗簾
百合花饰	百合花飾
百团大战	百團大戰
百姿千态	百姿千態
百媚千娇	百媚千嬌
百子千孙	百子千孫
百孔千创	百孔千創
百孔千疮	百孔千瘡
百岁之后	百歲之後
百岁千秋	百歲千秋
百巧千穷	百巧千窮
百年之后	百年之後
百年好合	百年好合
百战百胜	百戰百勝
百折不回	百折不回
百折不挠	百折不撓
百折不挫	百折不挫
百拙千丑	百拙千醜
百炼成钢	百煉成鋼
百紫千红	百紫千紅
百纵千随	百縱千隨
百胜餐饮	百勝餐飲
百舍重茧	百舍重繭
百舍重趼	百舍重趼
百花历史	百花歷史
百花娘子	百花娘子
百药之长	百藥之長
百虑一致	百慮一致
百计千心	百計千心
百计千方	百計千方
百计千谋	百計千謀
百谋千计	百謀千計
百足不僵	百足不僵
百足之虫	百足之蟲
百里之才	百里之才
百里挑一	百裏挑一
百锻千练	百鍛千練
的一确二	的一確二
的的确确	的的確確
的确如此	的確如此
的黎波里	的黎波里
皆可作淀	皆可作澱
皇亲国戚	皇親國戚
皇冠出版	皇冠出版
皇天后土	皇天后土
皇恩浩荡	皇恩浩蕩
皇极历史	皇極歷史
皓月千里	皓月千里
皓月当空	皓月當空
皓齿朱唇	皓齒硃脣
皓齿朱脣	皓齒朱脣
皖系军阀	皖系軍閥
皖系战败	皖系戰敗
皮下出血	皮下出血
皮下注射	皮下注射
皮克罗比	皮克羅比
皮松肉紧	皮鬆肉緊
皮松骨痒	皮鬆骨癢
皮特拉克	皮特拉克
皮里抽肉	皮裏抽肉
皮里春秋	皮裏春秋
皮里晋书	皮裏晉書
皮里膜外	皮裏膜外
皮里走肉	皮裏走肉
皮里阳秋	皮裏陽秋
皱叶欧芹	皺葉歐芹
盈千累万	盈千累萬
盈千累百	盈千累百
盈盈秋水	盈盈秋水
盈车嘉穗	盈車嘉穗
盈馀加征	盈餘加徵
益觉困难	益覺困難
益鸟益虫	益鳥益蟲
盎盂相系	盎盂相繫
盐水选种	鹽水選種
监听系统	監聽系統
监察御史	監察御史
监管不周	監管不周
监管体制	監管體制
监管范围	監管範圍
盖世之才	蓋世之才
盖了又盖	蓋了又蓋
盗无实据	盜無實據
盗钟掩耳	盜鐘掩耳
盘旋曲折	盤旋曲折
盛德遗范	盛德遺範
盛极一时	盛極一時
盛极必衰	盛極必衰
盛极而衰	盛極而衰
盟旗制度	盟旗制度
目前目后	目前目後
目无余子	目無餘子
目牛游刃	目牛游刃
目眦尽裂	目眥盡裂
目瞪口僵	目瞪口僵
目瞪舌僵	目瞪舌僵
目视云霄	目視雲霄
目骇耳回	目駭耳回
直上青云	直上青雲
直升飞机	直升飛機
直头布袋	直頭布袋
直布罗陀	直布羅陀
直截了当	直截了當
直捷了当	直捷了當
直接了当	直接了當
直接制版	直接制版
直接参与	直接參與
直接征税	直接徵稅
直接数据	直接數據
直接证据	直接證據
直系亲属	直系親屬
直系军阀	直係軍閥
直系祖先	直系祖先
直系血亲	直系血親
直言尽意	直言盡意
直言极谏	直言極諫
直进直出	直進直出
相为表里	相爲表裏
相互关系	相互關係
相关系数	相關係數
相别多年	相別多年
相去万里	相去萬里
相去无几	相去無幾
相叶雅纪	相葉雅紀
相同名字	相同名字
相向突击	相向突擊
相差无几	相差無幾
相当程度	相當程度
相提并论	相提並論
相生相克	相生相剋
相距千里	相距千里
相门出相	相門出相
相须为命	相須爲命
相须而行	相須而行
盼既示复	盼既示覆
省欲去奢	省慾去奢
省民同胞	省民同胞
眉分八彩	眉分八彩
眉南面北	眉南面北
眉垂目合	眉垂目合
看不出来	看不出來
看个究竟	看個究竟
看了又看	看了又看
看傻了眼	看傻了眼
看出了神	看出了神
看出电影	看齣電影
看得出来	看得出來
看朱成碧	看朱成碧
看淡后市	看淡後市
看走了眼	看走了眼
真凭实据	真憑實據
真凶实犯	真兇實犯
真受不了	真受不了
真才实学	真才實學
真理必胜	真理必勝
真身舍利	真身舍利
眼前花发	眼前花發
眼动技术	眼動技術
眼动记录	眼動記錄
眼圈红了	眼圈紅了
眼如秋水	眼如秋水
眼手并用	眼手並用
眼泪洗面	眼淚洗面
眼看四面	眼看四面
眼花了乱	眼花瞭亂
眼观四面	眼觀四面
眼迷心荡	眼迷心蕩
着色软体	着色軟體
着重指出	着重指出
睁一只眼	睜一隻眼
睟面盎背	睟面盎背
睡个痛快	睡個痛快
睡了又睡	睡了又睡
睡眼蒙眬	睡眼矇矓
睥睨物表	睥睨物表
瞎了眼睛	瞎了眼睛
瞠乎其后	瞠乎其後
瞠乎后矣	瞠乎後矣
瞬发中子	瞬發中子
瞬发辐射	瞬發輻射
瞬息万变	瞬息萬變
瞬息千变	瞬息千變
瞻前忽后	瞻前忽後
瞻前顾后	瞻前顧後
矛头指向	矛頭指向
矛盾百出	矛盾百出
矛盾相向	矛盾相向
矜功负胜	矜功負勝
矜才使气	矜才使氣
矜能负才	矜能負才
矢不虚发	矢不虛發
矢尽兵穷	矢盡兵窮
矢志不移	矢志不移
矢无虚发	矢無虛發
知人知面	知人知面
知几其神	知幾其神
知名当世	知名當世
知尽能索	知盡能索
知往鉴今	知往鑑今
知情同意	知情同意
知感不尽	知感不盡
知行合一	知行合一
知识范围	知識範圍
矫情干誉	矯情干譽
矫若游龙	矯若遊龍
短叹长吁	短嘆長吁
短小精干	短小精幹
矮了一截	矮了一截
矮了半截	矮了半截
矮杆品种	矮桿品種
石屋制果	石屋製果
石枯松老	石枯松老
石油输出	石油輸出
石灰岩洞	石灰巖洞
石膏墙板	石膏牆板
石英钟表	石英鐘錶
矿物纤维	礦物纖維
砌块建筑	砌塊建築
研几探赜	研幾探賾
研几析理	研幾析理
研制过程	研製過程
研发出来	研發出來
研发部门	研發部門
研究出来	研究出來
砥志砺行	砥志礪行
破产财团	破產財團
破格录用	破格錄用
破绽百出	破綻百出
破茧而出	破繭而出
破釜沈舟	破釜沈舟
破镜重合	破鏡重合
硝烟弹雨	硝煙彈雨
硫酸烟碱	硫酸菸鹼
硬了起来	硬了起來
硬件平台	硬件平臺
硬质合金	硬質合金
确保安全	確保安全
确信无疑	確信無疑
确凿不移	確鑿不移
确切不变	確切不變
确定判决	確定判決
确定故意	確定故意
确定效应	確定效應
确实可靠	確實可靠
确有其事	確有其事
确有其人	確有其人
确有此事	確有此事
确确实实	確確實實
碌碌庸才	碌碌庸才
碍于情面	礙於情面
碍难照准	礙難照准
碎尸万段	碎屍萬段
碧波万顷	碧波萬頃
碧波荡漾	碧波盪漾
碧瓦朱甍	碧瓦朱甍
碧眼紫须	碧眼紫鬚
碧眼金发	碧眼金髮
碧鸡漫志	碧雞漫志
碱纤维素	鹼纖維素
碳氢化合	碳氫化合
碳水化合	碳水化合
碳链纤维	碳鏈纖維
磁单极子	磁單極子
磊落轶荡	磊落軼蕩
磕个响头	磕個響頭
磨制石器	磨製石器
磨厉以须	磨厲以須
磨杵成针	磨杵成針
磨石子面	磨石子面
磨砺以须	磨礪以須
磨铁成针	磨鐵成針
磷酸盐岩	磷酸鹽岩
礁湖星云	礁湖星雲
示威游行	示威遊行
示范企业	示範企業
示范作用	示範作用
示范动作	示範動作
示范单位	示範單位
示范园区	示範園區
示范基地	示範基地
示范学校	示範學校
示范工程	示範工程
示范效应	示範效應
示范教学	示範教學
示范文本	示範文本
示范社区	示範社區
示范表演	示範表演
示范项目	示範項目
礼乐射御	禮樂射御
礼仪规范	禮儀規範
礼所当然	禮所當然
礼数周到	禮數周到
社交才能	社交才能
社会价值	社會價值
社会体系	社會體系
社会关系	社會關係
社会制度	社會制度
社会发展	社會發展
社会团体	社會團體
社会学系	社會學系
社会控制	社會控制
社会整合	社會整合
社会规范	社會規範
社会调适	社會調適
社区发展	社區發展
社区电台	社區電臺
社团活动	社團活動
祁奚荐仇	祁奚薦仇
祇洹精舍	祇洹精舍
祛蠹除奸	祛蠹除奸
神不守舍	神不守舍
神人鉴知	神人鑑知
神出鬼入	神出鬼入
神出鬼没	神出鬼沒
神分志夺	神分志奪
神圣同盟	神聖同盟
神头鬼面	神頭鬼面
神彩奕奕	神彩奕奕
神志昏迷	神志昏迷
神态悠闲	神態悠閒
神摇魂荡	神搖魂盪
神术妙法	神術妙法
神术妙策	神術妙策
神术妙计	神術妙計
神机妙术	神機妙術
神游太虚	神遊太虛
神经战术	神經戰術
神经系统	神經系統
神经纤维	神經纖維
神荼郁垒	神荼鬱壘
神采奕奕	神采奕奕
神采奕然	神采奕然
神采焕发	神采煥發
神采英拔	神采英拔
神采飘逸	神采飄逸
神采飞扬	神采飛揚
神采骏发	神采駿發
神雕侠侣	神鵰俠侶
神魂摇荡	神魂搖盪
神魂荡漾	神魂盪漾
神魂荡飏	神魂盪颺
神魂飘荡	神魂飄蕩
神魂飞荡	神魂飛蕩
神魂驰荡	神魂馳蕩
祥云瑞彩	祥雲瑞彩
祥云瑞气	祥雲瑞氣
祥风庆云	祥風慶雲
票房价值	票房價值
票房毒药	票房毒藥
票房纪录	票房紀錄
票房记录	票房記錄
票据交换	票據交換
票据存款	票據存款
票据行为	票據行爲
票面价值	票面價值
祭东施娘	祭東施娘
祭五脏庙	祭五臟廟
祭司权术	祭司權術
祭遵布被	祭遵布被
祸从口出	禍從口出
祸出不测	禍出不測
祸发萧墙	禍發蕭牆
祸发齿牙	禍發齒牙
祸因恶积	禍因惡積
祸生于忽	禍生於忽
祸盈恶稔	禍盈惡稔
祸福吉凶	禍福吉凶
祸福同门	禍福同門
祸稔恶盈	禍稔惡盈
禁奸除猾	禁奸除猾
禁忌站台	禁忌站臺
禁欲主义	禁慾主義
禁止吸烟	禁止吸菸
禁止外出	禁止外出
福尽灾生	福盡災生
福建师范	福建師範
福惠双修	福惠雙修
福生于微	福生于微
禹王台区	禹王臺區
离别多年	離別多年
离别已久	離別已久
离合体诗	離合體詩
离合悲欢	離合悲歡
离奇曲折	離奇曲折
离家出走	離家出走
离情别绪	離情別緒
离题万里	離題萬里
离鸾别凤	離鸞別鳳
禽困复车	禽困覆車
秀出班行	秀出班行
秀发垂肩	秀髮垂肩
秀才人情	秀才人情
秀才造反	秀才造反
私心藏奸	私心藏奸
私自同意	私自同意
秃妃之发	禿妃之髮
秉烛夜游	秉燭夜遊
秋凉时节	秋涼時節
秋后算帐	秋後算帳
秋后算账	秋後算賬
秋季学期	秋季學期
秋季旅行	秋季旅行
秋川雅史	秋川雅史
秋意已浓	秋意已濃
秋扇见捐	秋扇見捐
秋收冬藏	秋收冬藏
秋收季节	秋收季節
秋收起义	秋收起義
秋月寒江	秋月寒江
秋月春风	秋月春風
秋毫不犯	秋毫不犯
秋毫之末	秋毫之末
秋毫无犯	秋毫無犯
秋水仙素	秋水仙素
秋水伊人	秋水伊人
秋波送情	秋波送情
秋海棠花	秋海棠花
秋胡变文	秋胡變文
秋胡戏妻	秋胡戲妻
秋色宜人	秋色宜人
秋草人情	秋草人情
秋荼密网	秋荼密網
秋菊傲霜	秋菊傲霜
秋风团扇	秋風團扇
秋风落叶	秋風落葉
秋风过耳	秋風過耳
秋风送爽	秋風送爽
秋风飒飒	秋風颯颯
秋高气爽	秋高氣爽
秋高气肃	秋高氣肅
秋高马肥	秋高馬肥
种下祸根	種下禍根
种姓制度	種姓製度
种子植物	種子植物
种子球员	種子球員
种子网路	種子網路
种子选手	種子選手
种族主义	種族主義
种族偏见	種族偏見
种族平等	種族平等
种族歧视	種族歧視
种族清洗	種族清洗
种族清除	種族清除
种族灭绝	種族滅絕
种族迫害	種族迫害
种族问题	種族問題
种族隔离	種族隔離
种植义齿	種植義齒
种源中心	種源中心
种瓜得瓜	種瓜得瓜
种田人家	種田人家
种豆得豆	種豆得豆
种间杂交	種間雜交
种麦得麦	種麥得麥
科举制度	科舉制度
科学万能	科學萬能
科学中药	科學中藥
科学技术	科學技術
科学种田	科學種田
科学规范	科學規範
科尼賽克	科尼賽克
科布多河	科布多河
科特布斯	科特布斯
科班出身	科班出身
科纳克里	科納克里
科际整合	科際整合
租借法案	租借法案
秤平斗满	秤平斗滿
秤斤注两	秤斤注兩
积于忽微	積於忽微
积恶余殃	積惡餘殃
积恶馀殃	積惡餘殃
积极份子	積極份子
积极参与	積极參與
积极参加	積极參加
积极反应	積極反應
积极因素	積極因素
积谷防饥	積穀防饑
积里渐里	積裏漸裏
积金至斗	積金至斗
称心满志	稱心滿志
称王封后	稱王封后
称赞不已	稱讚不已
移情别恋	移情別戀
移星换斗	移星換斗
移植手术	移殖手術
秾纤合度	穠纖合度
稀松平常	稀鬆平常
稀松骨质	稀鬆骨質
稀里哗啦	稀里嘩啦
稀里打哄	稀里打哄
稀里糊涂	稀裏糊塗
程序修宪	程序修憲
程序控制	程序控制
程式控制	程式控制
程式规划	程式規劃
稍占上风	稍占上風
稍感不适	稍感不適
稍有不准	稍有不準
稍胜一筹	稍勝一籌
税捐稽征	稅捐稽徵
稔恶不悛	稔惡不悛
稳吃三注	穩吃三注
稳定物价	穩定物價
稳扎稳打	穩紮穩打
稳操胜券	穩操勝券
稳操胜算	穩操勝算
稳稳当当	穩穩當當
穆巴拉克	穆巴拉克
穗状花序	穗狀花序
穷于应付	窮於應付
穷兵极武	窮兵極武
穷兵黩武	窮兵黷武
穷凶恶极	窮兇惡極
穷凶极恶	窮兇極惡
穷凶极虐	窮兇極虐
穷困人家	窮困人家
穷天极地	窮天極地
穷奢极侈	窮奢極侈
穷奢极多	窮奢極多
穷奢极欲	窮奢極欲
穷妙极巧	窮妙極巧
穷富极贵	窮富極貴
穷山恶水	窮山惡水
穷工极巧	窮工極巧
穷幽极微	窮幽極微
穷当益坚	窮當益堅
穷形尽相	窮形盡相
穷形极状	窮形極狀
穷本极源	窮本極源
穷极其妙	窮極其妙
穷极则变	窮極則變
穷极无聊	窮極無聊
穷极要妙	窮極要妙
穷根寻叶	窮根尋葉
穷灵尽妙	窮靈盡妙
穷理尽性	窮理盡性
穷纤入微	窮纖入微
穷而后工	窮而後工
穷贵极富	窮貴極富
穷追不舍	窮追不捨
空中布雷	空中佈雷
空中格斗	空中格鬥
空优迷彩	空優迷彩
空前绝后	空前絕後
空心汤团	空心湯糰
空心萝卜	空心蘿蔔
空手而回	空手而回
空投布雷	空投佈雷
空疏无据	空疏無據
空空荡荡	空空蕩蕩
空谷传响	空谷傳響
空谷传声	空谷傳聲
空谷回音	空谷回音
空谷幽兰	空谷幽蘭
空谷足音	空谷足音
空间曲线	空間曲綫
空间艺术	空間藝術
穿云裂石	穿雲裂石
穿针引线	穿針引綫
穿针走线	穿針走綫
穿麻挂孝	穿麻掛孝
突出重围	突出重圍
突发事件	突發事件
突发奇想	突發奇想
突发状况	突發狀況
突围而出	突圍而出
突袭战术	突襲戰術
窃幸乘宠	竊幸乘寵
窃钟掩耳	竊鐘掩耳
窗明几亮	窗明几亮
窗明几净	窗明几淨
窘态百出	窘態百出
窜进窜出	竄進竄出
窝里发炮	窩裏發炮
窝里窝囊	窩里窩囊
窝阔台汗	窩闊臺汗
窟里拔蛇	窟裏拔蛇
窥御激夫	窺御激夫
立于不败	立於不敗
立体几何	立體幾何
立克次体	立克次體
立扫千言	立掃千言
立方公里	立方公里
立方厘米	立方厘米
立杆见影	立杆見影
竖人毛发	豎人毛髮
竖柱上梁	豎柱上梁
竖起脊梁	豎起脊梁
站干岸儿	站乾岸兒
竞合现象	競合現象
章台杨柳	章臺楊柳
章回小说	章回小說
童颜鹤发	童顏鶴髮
竭尽全力	竭盡全力
竭尽力量	竭盡力量
竭尽心思	竭盡心思
竭尽所能	竭盡所能
竭尽棉薄	竭盡棉薄
竭智尽力	竭智盡力
竭智尽忠	竭智盡忠
竭智尽虑	竭智盡慮
竭诚尽节	竭誠盡節
竹叶青蛇	竹葉青蛇
竹林之游	竹林之遊
竹篱茅舍	竹籬茅舍
竹苞松茂	竹苞松茂
竹野內丰	竹野內豐
笃志好学	篤志好學
笃志爱古	篤志愛古
笑个痛快	笑個痛快
笑了起来	笑了起來
笑出眼泪	笑出眼淚
笑口弥勒	笑口彌勒
笑容满面	笑容滿面
笑成一团	笑成一團
笑耍头回	笑耍頭回
笑话百出	笑話百出
笑里藏刀	笑裏藏刀
笑面夜叉	笑面夜叉
笔力万钧	筆力萬鈞
笔参造化	筆參造化
笔扫千军	筆掃千軍
笔秃墨干	筆禿墨乾
笔迹鉴定	筆蹟鑑定
笙磬同音	笙磬同音
符合标准	符合標準
笨笨呆呆	笨笨呆呆
第一千万	第一千萬
第一志愿	第一志願
第一性征	第一性徵
第九艺术	第九藝術
第二性征	第二性徵
第八艺术	第八藝術
第四出局	第四出局
等价交换	等價交換
等价关系	等價關係
等值价格	等值價格
等级制度	等級制度
等轴晶系	等軸晶系
等闲之辈	等閒之輩
等闲人物	等閒人物
等闲视之	等閒視之
等高种植	等高種植
筋疲力尽	筋疲力盡
筑坛拜将	築壇拜將
筑室反耕	築室反耕
筑室道谋	築室道謀
筑筑磕磕	築築磕磕
筑路工程	築路工程
筛子喂驴	篩子餵驢
签发地点	簽發地點
签发日期	簽發日期
签名运动	簽名運動
签约奖金	簽約獎金
简单明了	簡單明瞭
简字谱录	簡字譜錄
简截了当	簡截了當
简易师范	簡易師範
箕山之志	箕山之志
算了又算	算了又算
算术平均	算術平均
算术级数	算術級數
管制中心	管制中心
管制区域	管制區域
管制塔台	管制塔臺
管制空域	管制空域
管制路线	管制路綫
管圆线虫	管圓綫蟲
管家娘子	管家娘子
管弦乐团	管弦樂團
管理人才	管理人纔
管理体制	管理體制
管理规范	管理規範
管辖范围	管轄範圍
箭不虚发	箭不虛發
箭无虚发	箭無虛發
簌簌发抖	簌簌發抖
簪笔磬折	簪筆磬折
籧篨戚施	籧篨戚施
米克杰格	米克傑格
米克诺斯	米克諾斯
米厘米突	米釐米突
米苏里州	米蘇里州
粉拳绣腿	粉拳繡腿
粉红色系	粉紅色系
粉面朱脣	粉面硃脣
粉面油头	粉面油頭
粉饰门面	粉飾門面
粗制滥造	粗製濫造
粗枝大叶	粗枝大葉
粗衣恶食	粗衣惡食
粪秽蔑面	糞穢衊面
粮尽援绝	糧盡援絕
精于此道	精於此道
精奇里江	精奇里江
精干高效	精幹高效
精彩生动	精彩生動
精彩逼人	精彩逼人
精彩镜头	精彩鏡頭
精心制作	精心製作
精心制造	精心製造
精心杰作	精心傑作
精悟玄鉴	精悟玄鑑
精明干练	精明幹練
精明强干	精明強幹
精明能干	精明能幹
精疲力尽	精疲力盡
精神焕发	精神煥發
精神药物	精神藥物
精虫冲脑	精蟲衝腦
精诚团结	精誠團結
精采绝伦	精采絕倫
精金百炼	精金百煉
精雕细刻	精雕細刻
精雕细琢	精雕細琢
精雕细镂	精雕細鏤
糊涂一时	糊塗一時
糊糊涂涂	糊糊塗塗
糊里糊涂	糊里糊塗
糖炒栗子	糖炒栗子
糖醋里脊	糖醋里脊
系于一发	繫於一髮
系出名门	系出名門
系统分析	系統分析
系统分类	系統分類
系统发育	系統發育
系统工程	系統工程
系统理论	系統理論
系统设计	系統設計
系统软体	系統軟體
系而不食	繫而不食
系臂之宠	繫臂之寵
系铃解铃	繫鈴解鈴
系颈阙庭	係頸闕庭
系风捕影	繫風捕影
系风捕景	繫風捕景
素未谋面	素未謀面
素面朝天	素面朝天
素餐尸位	素餐尸位
索价过高	索價過高
索克斯队	索克斯隊
索夫克郡	索夫克郡
索尽枯肠	索盡枯腸
索马里亚	索馬里亞
紧密配合	緊密配合
紧急制动	緊急制動
紧急集合	緊急集合
紧溜子里	緊溜子裏
紧追不舍	緊追不捨
紧随其后	緊隨其後
紫微斗数	紫微斗數
累块积苏	累塊積蘇
累瓦结绳	累瓦結繩
累积折耗	累積折耗
絣扒吊拷	絣扒吊拷
繁征博引	繁徵博引
繁殖系数	繁殖係數
纡朱怀金	紆朱懷金
红丝暗系	紅絲暗繫
红中白板	紅中白板
红光满面	紅光滿面
红发女郎	紅髮女郎
红叶之题	紅葉之題
红叶题诗	紅葉題詩
红尘万丈	紅塵萬丈
红得发紫	紅得發紫
红日当午	紅日當午
红杏出墙	紅杏出牆
红极一时	紅極一時
红紫乱朱	紅紫亂朱
红绳系足	紅繩繫足
红花绿叶	紅花綠葉
红运当头	紅運當頭
红面番鸭	紅面番鴨
红须绿眼	紅鬚綠眼
纤不盈握	纖不盈握
纤尘不染	纖塵不染
纤悉无遗	纖悉無遺
纤毛运动	纖毛運動
纤秾中度	纖穠中度
纤纤弱质	纖纖弱質
纤纤玉手	纖纖玉手
纤维光学	纖維光學
纤维工业	纖維工業
纤维植物	纖維植物
纤维细胞	纖維細胞
纤维肌痛	纖維肌痛
纤维蛋原	纖維蛋原
纤维蛋白	纖維蛋白
纤维长度	纖維長度
纤芥不遗	纖芥不遺
纤芯直径	纖芯直徑
约克夏猪	約克夏豬
约克维奇	約克維奇
约当现金	約當現金
约翰参书	約翰參書
纪录下来	紀錄下來
纪录片儿	紀錄片兒
纪录片奖	紀錄片獎
纯属巧合	純屬巧合
纯情蜡妹	純情蠟妹
纱布口罩	紗布口罩
纱布绷带	紗布繃帶
纳奇录异	納奇錄異
纳德阿里	納德阿里
纳斯达克	納斯達克
纳米技术	納米技術
纳莉台风	納莉颱風
纵情恣欲	縱情恣欲
纵情遂欲	縱情遂欲
纵曲枉直	縱曲枉直
纵横交布	縱橫交佈
纵欲主义	縱慾主義
纵欲无度	縱慾無度
纽几内亚	紐幾內亞
线上价目	綫上價目
线上出版	綫上出版
线上挂号	綫上掛號
线上游戏	綫上游戲
线上论坛	綫上論壇
线上评鉴	綫上評鑑
线性系统	綫性系統
线性规划	綫性規劃
组合数学	組合數學
组合服装	組合服裝
组合而成	組合而成
组合语言	組合語言
组合音响	組合音響
细不容发	細不容髮
细叶山茶	細葉山茶
细胞周期	細胞週期
细胞融合	細胞融合
细致入微	細緻入微
细针密缕	細針密縷
细雨蒙蒙	細雨濛濛
织当访婢	織當訪婢
织锦回文	織錦回文
终南别业	終南別業
终极杀阵	終極殺陣
终极目标	終極目標
终焉之志	終焉之志
终而复始	終而復始
终身有托	終身有托
经世之才	經世之才
经世致用	經世致用
经历风雨	經歷風雨
经合组织	經合組織
经国之才	經國之才
经济之才	經濟之才
经济体制	經濟體制
经济体系	經濟體系
经济制度	經濟制度
经济制裁	經濟制裁
经济发展	經濟發展
经济周期	經濟週期
经济困境	經濟困境
经济技术	經濟技術
经济槓杆	經濟槓桿
经济范畴	經濟範疇
经济落后	經濟落後
经济计划	經濟計劃
经营范围	經營範圍
经贸关系	經貿關係
经验丰富	經驗豐富
结伙抢劫	結夥搶劫
结伴同游	結伴同遊
结伴同行	結伴同行
结党聚羣	結黨聚羣
结党营私	結黨營私
结党连羣	結黨連羣
结发事师	結髮事師
结发夫妻	結髮夫妻
结合实际	結合實際
结合模型	結合模型
结合起来	結合起來
结合过程	結合過程
结合韵母	結合韻母
结扎手术	結紮手術
结核杆菌	結核桿菌
绕梁三日	繞樑三日
绕梁之音	繞樑之音
绕梁韵永	繞樑韻永
绘事后素	繪事後素
给我干脆	給我干脆
绚丽多彩	絢麗多彩
络绎于途	絡繹於途
络腮胡子	絡腮鬍子
绝不相同	絕不相同
绝世出尘	絕世出塵
绝后光前	絕後光前
绝对参照	絕對參照
绝望已极	絕望已極
绞尽脑汁	絞盡腦汁
统一发票	統一發票
统一规划	統一規劃
统一规范	統一規範
统一计划	統一計劃
统筹规划	統籌規劃
统计制图	統計製圖
统计图表	統計圖表
统计数据	統計數據
绣花针儿	繡花針兒
绣虎雕龙	繡虎雕龍
绣衣御史	繡衣御史
绣衣朱履	繡衣朱履
继天立极	繼天立極
继志述事	繼志述事
续借手续	續借手續
续发感染	續發感染
续后汉书	續後漢書
续西游记	續西遊記
绰绰有余	綽綽有餘
维几尼亚	維幾尼亞
维基数据	維基數據
维基物种	維基物種
维多里欧	維多里歐
维系人心	維繫人心
绵延不尽	綿延不盡
绵里藏针	綿里藏針
绷巴吊拷	繃巴吊拷
绷扒吊拷	繃扒吊拷
绷爬吊拷	繃爬吊拷
综合医院	綜合醫院
综合叙述	綜合敘述
综合存款	綜合存款
综合布线	綜合布綫
综合平衡	綜合平衡
综合所得	綜合所得
综合报导	綜合報導
综合报道	綜合報道
综合杂志	綜合雜誌
综合艺术	綜合藝術
综合银行	綜合銀行
综合防治	綜合防治
绿叶成荫	綠葉成蔭
绿叶成阴	綠葉成陰
绿暗红稀	綠暗紅稀
绿烟红雾	綠煙紅霧
绿衣黄里	綠衣黃裏
绿鬓朱颜	綠鬢朱顏
缆索吊椅	纜索吊椅
缓冲作用	緩衝作用
缓冲地区	緩衝地區
缓冲地带	緩衝地帶
缓冲溶液	緩衝溶液
缓发中子	緩發中子
编目表格	編目表格
编目记录	編目記錄
编码系统	編碼系統
缘分已尽	緣分已盡
缝针补线	縫針補綫
缣缃黄卷	縑緗黃卷
缩影微卷	縮影微捲
缩成一团	縮成一團
缪种流传	繆種流傳
缱绻难舍	繾綣難捨
缴不出来	繳不出來
缺课纪录	缺課紀錄
缾沉簪折	缾沉簪折
罂粟种子	罌粟種子
网上杂志	網上雜誌
网开一面	網開一面
网开三面	網開三面
网状系统	網狀系統
网管系统	網管系統
网络技术	網絡技術
网络游戏	網絡遊戲
网罗人才	網羅人才
网路型录	網路型錄
网路平台	網路平臺
网路搜寻	網路搜尋
网路杂志	網路雜誌
网路站台	網路站臺
网路系统	網路系統
网路论坛	網路論壇
网际电台	網際電臺
罔极之恩	罔極之恩
罗布林卡	羅布林卡
罗式几何	羅式幾何
罗拉巴克	羅拉巴克
罗斯托克	羅斯托克
罗斯托夫	羅斯托夫
罗曼带克	囉曼帶克
罗曼蒂克	羅曼蒂克
罗杰斯杯	羅傑斯杯
罗氏几何	羅氏幾何
罗素克洛	羅素克洛
罗致人材	羅致人材
罗蒙诺索	羅蒙諾索
罗西里尼	羅西里尼
罗马建筑	羅馬建築
罗马里奥	羅馬裏奧
罚不当罪	罰不當罪
罢于奔命	罷於奔命
罪大恶极	罪大惡極
罪当万死	罪當萬死
罪恶如山	罪惡如山
罪恶深重	罪惡深重
罪恶滔天	罪惡滔天
罪恶累累	罪惡累累
罪恶行径	罪惡行徑
罪恶贯盈	罪惡貫盈
罪证确凿	罪證確鑿
罪该万死	罪該萬死
置之脑后	置之腦後
置信系数	置信係數
置言成范	置言成範
羊瘙痒症	羊瘙痒症
羊角面包	羊角麵包
美不胜收	美不勝收
美仑美奂	美侖美奐
美女如云	美女如雲
美容手术	美容手術
美日关系	美日關係
美术大师	美術大師
美术电影	美術電影
美术设计	美術設計
美林集团	美林集團
美泽鉴人	美澤鑑人
美苏关系	美蘇關係
羚羊挂角	羚羊掛角
羞于启齿	羞於啓齒
羞以牛后	羞以牛後
羞恶之心	羞惡之心
羞愧难当	羞愧難當
羞面见人	羞面見人
羣众关系	羣眾關係
羣而不党	羣而不黨
羣谋咸同	羣謀咸同
羣轻折轴	羣輕折軸
群众团体	羣眾團體
羽毛丰满	羽毛豐滿
羽毛未丰	羽毛未豐
羽状复叶	羽狀複葉
羽翼丰满	羽翼豐滿
羽翼已丰	羽翼已豐
翁山苏姬	翁山蘇姬
翱游四海	翱遊四海
翻云复雨	翻雲覆雨
翻云覆雨	翻雲覆雨
翻复无常	翻覆無常
翻天复地	翻天覆地
翻手为云	翻手爲雲
翻来吊去	翻來吊去
翻来复去	翻來覆去
翻空出奇	翻空出奇
翻箱倒柜	翻箱倒櫃
翻过筋斗	翻過筋斗
翾风回雪	翾風迴雪
老于世故	老於世故
老八板儿	老八板兒
老医少卜	老醫少卜
老奸巨猾	老奸巨猾
老婆当军	老婆當軍
老少一同	老少一同
老少咸宜	老少咸宜
老幼咸宜	老幼咸宜
老当益壮	老當益壯
老态龙钟	老態龍鍾
老残游记	老殘遊記
老气横秋	老氣橫秋
老熊当道	老熊當道
老罴当道	老羆當道
老而弥坚	老而彌堅
老起面皮	老起面皮
老鹰星云	老鷹星雲
考前考后	考前考後
考虑不周	考慮不周
考虑周到	考慮周到
考试卷子	考試卷子
考试范围	考試範圍
而今而后	而今而後
而胜于蓝	而勝於藍
耐热合金	耐熱合金
耕九余三	耕九餘三
耕作制度	耕作制度
耕前耡后	耕前耡後
耕地面积	耕地面積
耕当问奴	耕當問奴
耳提面命	耳提面命
耳提面训	耳提面訓
耳朵里响	耳朵裏響
耳目之欲	耳目之欲
耳红面赤	耳紅面赤
耸了耸肩	聳了聳肩
耸入云霄	聳入雲霄
耻居王后	恥居王後
耿耿于心	耿耿於心
耿耿于怀	耿耿於懷
聊个痛快	聊個痛快
聊复备数	聊復備數
聊复尔尔	聊復爾爾
聊复尔耳	聊復爾耳
聊斋志异	聊齋志異
聊胜一筹	聊勝一籌
聊胜于无	聊勝於無
聊表寸心	聊表寸心
聊表心意	聊表心意
职业团体	職業團體
职业水准	職業水準
职权范围	職權範圍
职能范围	職能範圍
职责范围	職責範圍
联体别墅	聯體別墅
联合企业	聯合企業
联合作战	聯合作戰
联合促销	聯合促銷
联合內阁	聯合內閣
联合公报	聯合公報
联合军演	聯合軍演
联合利华	聯合利華
联合参谋	聯合參謀
联合发表	聯合發表
联合国日	聯合國日
联合国案	聯合國案
联合声明	聯合聲明
联合大学	聯合大學
联合工专	聯合工專
联合战线	聯合戰綫
联合报系	聯合報系
联合政府	聯合政府
联合文学	聯合文學
联合晚报	聯合晚報
联合演习	聯合演習
联合独占	聯合獨占
联合王国	聯合王國
联合目录	聯合目錄
联合组织	聯合組織
联合自强	聯合自強
联合舰队	聯合艦隊
联合行动	聯合行動
联合部队	聯合部隊
联想集团	聯想集團
联机游戏	聯機遊戲
联系实际	聯繫實際
联系方式	聯繫方式
联系汇率	聯繫匯率
联系羣众	聯繫羣眾
聚合作用	聚合作用
聚合反应	聚合反應
聚合起来	聚合起來
聚药雄蕊	聚葯雄蕊
聚酯纤维	聚酯纖維
聪明才智	聰明才智
肆奸植党	肆奸植黨
肉松罐头	肉鬆罐頭
肉欲主义	肉慾主義
肉毒杆菌	肉毒桿菌
肉穗花序	肉穗花序
肉袒面缚	肉袒面縛
肉重千斤	肉重千斤
肌原纤维	肌原纖維
肌理丰盈	肌理豐盈
肌纤蛋白	肌纖蛋白
肌肉发达	肌肉發達
肌肉注射	肌肉注射
肘手链足	肘手鍊足
肚里一轮	肚裏一輪
肚里寻思	肚裏尋思
肚里明白	肚裏明白
肚里踌躇	肚裏躊躇
肚里雷鸣	肚裏雷鳴
肝脑涂地	肝腦塗地
股价指数	股價指數
股栗肤粟	股栗膚粟
股票价值	股票價值
股票价格	股票價格
肢体冲突	肢體衝突
肥冬瘦年	肥冬瘦年
肥筑方言	肥筑方言
肮肮脏脏	骯骯髒髒
肯德瑞克	肯德瑞克
肺尘矽症	肺塵矽症
胆大于天	膽大於天
胆大如斗	膽大如斗
背前背后	背前背後
背回家去	背回家去
背城借一	背城借一
背山面水	背山面水
背暗投明	背暗投明
胚胎发生	胚胎發生
胜之不武	勝之不武
胜乐金刚	勝樂金剛
胜任愉快	勝任愉快
胜任能力	勝任能力
胜利在望	勝利在望
胜利归来	勝利歸來
胜利投手	勝利投手
胜利果实	勝利果實
胜券在握	勝券在握
胜残去杀	勝殘去殺
胜部冠军	勝部冠軍
胡二巴越	胡二巴越
胡作非为	胡作非爲
胡做乔为	胡做喬爲
胡克定律	胡克定律
胡吃海喝	胡吃海喝
胡吃闷睡	胡吃悶睡
胡吹乱捧	胡吹亂捧
胡吹乱滂	胡吹亂滂
胡吹乱诌	胡吹亂謅
胡吹大气	胡吹大氣
胡天胡地	胡天胡地
胡天胡帝	胡天胡帝
胡子工程	鬍子工程
胡子拉碴	鬍子拉碴
胡子阿姨	鬍子阿姨
胡志明市	胡志明市
胡思乱想	胡思亂想
胡思乱量	胡思亂量
胡打海摔	胡打海摔
胡扯八溜	胡扯八溜
胡抡混闹	胡掄混鬧
胡拉混扯	胡拉混扯
胡掳忙乱	胡擄忙亂
胡搅蛮缠	胡攪蠻纏
胡支扯叶	胡支扯葉
胡根班德	胡根班德
胡椒薄荷	胡椒薄荷
胡歌野调	胡歌野調
胡温新政	胡溫新政
胡编乱造	胡編亂造
胡胡卢卢	胡胡盧盧
胡萝卜汁	胡蘿蔔汁
胡萝卜素	胡蘿蔔素
胡蓝之狱	胡藍之獄
胡行乱作	胡行亂作
胡言乱语	胡言亂語
胡言汉语	胡言漢語
胡诌乱傍	胡謅亂傍
胡诌乱扯	胡謅亂扯
胡诌乱说	胡謅亂說
胡诌乱道	胡謅亂道
胡诌八扯	胡謅八扯
胡说乱语	胡說亂語
胡说乱道	胡說亂道
胡说八道	胡說八道
胡说散道	胡說散道
胡说白道	胡說白道
胡越一家	胡越一家
胡里胡涂	胡里胡塗
胰淀粉酶	胰澱粉酶
胶原纤维	膠原纖維
胶莱谷地	膠萊谷地
胸怀坦荡	胸懷坦蕩
胸怀大志	胸懷大志
胸无大志	胸無大志
胸罗万象	胸羅萬象
胸部手术	胸部手術
能力范围	能力範圍
能干巴巴	能乾巴巴
能干着急	能乾着急
能愿动词	能願動詞
脆快了当	脆快了當
脉不制肉	脈不制肉
脉冲雷达	脈衝雷達
脑前额叶	腦前額葉
脑力激荡	腦力激盪
脚底板儿	腳底板兒
脣似抹朱	脣似抹硃
脣如涂朱	脣如塗朱
脣若抹朱	脣若抹硃
脣若涂朱	脣若塗硃
脣若涂脂	脣若塗脂
脱不了身	脫不了身
脱出重围	脫出重圍
脱口而出	脫口而出
脱帽致敬	脫帽致敬
脱离不了	脫離不了
脱离关系	脫離關係
脱衣舞娘	脫衣舞娘
脱身而出	脫身而出
脱轨而出	脫軌而出
脱颎而出	脫熲而出
脱颖而出	脫穎而出
脸都绿了	臉都綠了
脸面之情	臉面之情
脸面无光	臉面無光
腊尽冬残	臘盡冬殘
腌里巴臜	腌裏巴臢
腐女军团	腐女軍團
腐肠之药	腐腸之藥
腕隧道症	腕隧道症
腥黑穗病	腥黑穗病
腰板脖硬	腰板脖硬
腰缠万贯	腰纏萬貫
腼颜事仇	靦顏事仇
腼颜借命	靦顏借命
腾云跨风	騰雲跨風
腾云驾雾	騰雲駕霧
腾捷飞升	騰捷飛升
腾格里山	騰格里山
腾格里湖	騰格里湖
膨胀系数	膨脹係數
臣服于心	臣服於心
臥狼当道	臥狼當道
臥薪尝胆	臥薪嘗膽
臧谷亡羊	臧穀亡羊
自主旅游	自主旅遊
自主系统	自主系統
自出一家	自出一家
自出机杼	自出機杼
自制一下	自制一下
自制下来	自制下來
自制之力	自制之力
自制之能	自制之能
自制炸弹	自製炸彈
自制的能	自制的能
自制能力	自制能力
自动恢复	自動恢復
自动挂挡	自動掛擋
自动控制	自動控制
自动离合	自動離合
自动自发	自動自發
自助旅游	自助旅遊
自卖自夸	自賣自誇
自发电位	自發電位
自发运动	自發運動
自同寒蝉	自同寒蟬
自学成才	自學成才
自我表现	自我表現
自我评价	自我評價
自来水厂	自來水廠
自此以后	自此以後
自此而后	自此而後
自然接种	自然接種
自由意志	自由意志
自由斗士	自由鬥士
自由组合	自由組合
自觉自愿	自覺自願
自诒伊戚	自詒伊戚
自贻伊戚	自貽伊戚
自食恶果	自食惡果
臭不可当	臭不可當
臭气冲天	臭氣衝天
臭气熏天	臭氣熏天
至愚极陋	至愚極陋
至矣尽矣	至矣盡矣
致使动词	致使動詞
致富之道	致富之道
致死剂量	致死劑量
致理商专	致理商專
致癌物质	致癌物質
致远任重	致遠任重
臻于完善	臻於完善
臻于郅治	臻於郅治
舌尖后音	舌尖後音
舌干唇焦	舌乾脣焦
舌干脣焦	舌乾脣焦
舌面元音	舌面元音
舌面前音	舌面前音
舌面后音	舌面後音
舌面如镜	舌面如鏡
舍利子塔	舍利子塔
舍命救人	捨命救人
舍安就危	捨安就危
舍实求虚	捨實求虛
舍己为人	捨己爲人
舍己为公	捨己爲公
舍己为国	捨己爲國
舍己从人	捨己從人
舍己就人	捨己就人
舍己成人	捨己成人
舍己救人	捨己救人
舍己芸人	捨己芸人
舍德主义	舍德主義
舍我其谁	捨我其誰
舍我复谁	捨我復誰
舍旧迎新	捨舊迎新
舍本事末	捨本事末
舍本逐末	捨本逐末
舍本问末	捨本問末
舍正从邪	捨正從邪
舍死忘生	捨死忘生
舍生取义	捨生取義
舍生存义	舍生存義
舍生忘死	捨生忘死
舍短从长	捨短從長
舍短取长	捨短取長
舍短录长	捨短錄長
舍短用长	捨短用長
舍身为国	捨身爲國
舍身图报	捨身圖報
舍身报国	捨身報國
舍身救人	捨身救人
舍身求法	捨身求法
舍车保帅	捨車保帥
舍近务远	捨近務遠
舍近即远	捨近即遠
舍近求远	捨近求遠
舍近谋远	捨近謀遠
舒卷自如	舒捲自如
舞台效果	舞臺效果
舞台艺术	舞臺藝術
舞台音乐	舞臺音樂
舞榭歌台	舞榭歌臺
舞水端里	舞水端里
舢板运动	舢板運動
航发中心	航發中心
航海历史	航海歷史
航海年表	航海年表
航海日志	航海日誌
舳舻千里	舳艫千里
良心发现	良心發現
良种繁育	良種繁育
良药苦口	良藥苦口
艰苦备尝	艱苦備嚐
艰苦奋斗	艱苦奮鬥
艰难困苦	艱難困苦
艰难曲折	艱難曲折
色彩缤纷	色彩繽紛
色彩艳丽	色彩豔麗
色彩鲜明	色彩鮮明
色彩鲜艳	色彩鮮豔
色情杂志	色情雜誌
艸木丰丰	艸木丰丰
艺压当行	藝壓當行
艺术体操	藝術體操
艺术学院	藝術學院
艺术指导	藝術指導
艺术歌曲	藝術歌曲
艾伦图克	艾倫圖克
艾力克斯	艾力克斯
艾希克罗	艾希克羅
艾德蒙斯	艾德蒙斯
艾德蒙顿	艾德矇頓
艾瑞克森	艾瑞克森
艾瑞斯托	艾瑞斯托
艾赛克斯	艾賽克斯
艾里亚森	艾里亞森
艾里赛宫	艾里賽宮
节制资本	節制資本
节流踏板	節流踏板
节节上升	節節上升
节节胜利	節節勝利
芙蓉出水	芙蓉出水
芦洲蟹舍	蘆洲蟹舍
芭丝克华	芭絲克華
芭蕾舞团	芭蕾舞團
芯慧同用	芯慧同用
花团锦簇	花團錦簇
花庵词选	花菴詞選
花心萝卜	花心蘿蔔
花招百出	花招百出
花拳绣腿	花拳繡腿
花明柳暗	花明柳暗
花样游泳	花樣游泳
花样百出	花樣百出
花红叶绿	花紅葉綠
花藜胡哨	花藜胡哨
花车游行	花車遊行
花里胡哨	花裏胡哨
花马吊嘴	花馬弔嘴
花魁娘子	花魁娘子
苇苕系巢	葦苕繫巢
苍松翠柏	蒼松翠柏
苍生涂炭	蒼生塗炭
苍翠欲滴	蒼翠欲滴
苍黄翻复	蒼黃翻覆
苏东启案	蘇東啓案
苏丹达佛	蘇丹達佛
苏伊士河	蘇伊士河
苏凡纳布	蘇凡納布
苏姆盖特	蘇姆蓋特
苏宁电器	蘇寧電器
苏家屯区	甦家屯區
苏州地区	蘇州地區
苏州大学	蘇州大學
苏州弹词	蘇州彈詞
苏州码子	蘇州碼子
苏州评弹	蘇州評彈
苏必略湖	蘇必略湖
苏打饼干	蘇打餅乾
苏拉威西	蘇拉威西
苏格兰人	蘇格蘭人
苏格兰场	蘇格蘭場
苏格兰帽	蘇格蘭帽
苏格兰王	蘇格蘭王
苏格兰裙	蘇格蘭裙
苏格兰队	蘇格蘭隊
苏格拉底	蘇格拉底
苏武牧羊	蘇武牧羊
苏比克湾	蘇比克灣
苏海韩潮	蘇海韓潮
苏秦刺股	蘇秦刺股
苏花公路	蘇花公路
苏菲玛索	蘇菲瑪索
苏达索诺	蘇達索諾
苏迪曼杯	蘇迪曼杯
苏迪约梭	蘇迪約梭
苏醒过来	甦醒過來
苏里南河	蘇裏南河
苏门答腊	蘇門答臘
苏门达腊	蘇門達臘
苏门长啸	蘇門長嘯
苏非主义	蘇非主義
苏非教派	蘇非教派
苟合取容	苟合取容
苟容曲从	苟容曲從
若出一辙	若出一轍
若合符节	若合符節
苦大仇深	苦大仇深
苦尽甘来	苦盡甘來
苦干实干	苦幹實幹
苦思恶想	苦思惡想
苦读出身	苦讀出身
苦酒满杯	苦酒滿杯
苯并噻吩	苯並噻吩
苯酮尿症	苯酮尿症
英克丝特	英克絲特
英姿焕发	英姿煥發
英才俊伟	英才俊偉
英日同盟	英日同盟
英气风发	英氣風發
英烈千秋	英烈千秋
英雄模范	英雄模範
英雄豪杰	英雄豪傑
苹果公司	蘋果公司
苹果手机	蘋果手機
苹果电脑	蘋果電腦
苹果蠹蛾	蘋果蠹蛾
苹果馅饼	蘋果餡餅
茂才异等	茂才異等
范伦铁诺	范倫鐵諾
范围之内	範圍之內
范围之外	範圍之外
范围之广	範圍之廣
范围属性	範圍屬性
范围很大	範圍很大
范围查询	範圍査詢
范围调整	範圍調整
范张鸡黍	范張雞黍
范德林特	范德林特
范德维德	范德維德
范性形变	範性形變
范文正公	范文正公
范文选读	範文選讀
范范之辈	范範之輩
茫茫荡荡	茫茫蕩蕩
茶叶末儿	茶葉末兒
茶馀酒后	茶餘酒後
茶馀饭后	茶餘飯後
荆钗布袄	荊釵布襖
荆钗布裙	荊釵布裙
荆钗裙布	荊釵裙布
草原千里	草原千里
草台班子	草臺班子
草草了事	草草了事
荑手纤纤	荑手纖纖
荒无人烟	荒無人煙
荒烟漫草	荒煙漫草
荒烟蔓草	荒煙蔓草
荒腔走板	荒腔走板
荡产倾家	蕩產傾家
荡垢涤汙	盪垢滌汙
荡来荡去	盪來盪去
荡析离居	蕩析離居
荡检逾闲	蕩檢逾閑
荡气回肠	蕩氣迴腸
荡气回阳	蕩氣迴陽
荡然无存	蕩然無存
荡瑕涤秽	蕩瑕滌穢
荡荡悠悠	盪盪悠悠
荣幸之至	榮幸之至
荣归故里	榮歸故里
荣登后座	榮登后座
荣获冠军	榮獲冠軍
药到命除	藥到命除
药到回春	藥到回春
药到病除	藥到病除
药医学系	藥醫學系
药发傀儡	藥發傀儡
药师如来	藥師如來
药效持久	藥效持久
药明康德	藥明康德
药物中毒	藥物中毒
药物学家	藥物學家
药物成瘾	藥物成癮
药物治疗	藥物治療
药王菩萨	藥王菩薩
药用价值	藥用價值
药用植物	藥用植物
药石之言	藥石之言
药石罔效	藥石罔效
药笼中物	藥籠中物
药裹关心	藥裹關心
药食同源	藥食同源
荷叶先师	荷葉先師
荷花出水	荷花出水
莫三比克	莫三比克
莫余毒也	莫余毒也
莫克姆湾	莫克姆灣
莫扎里拉	莫扎裏拉
莫折大提	莫折大提
莫报万一	莫報萬一
莫曼斯克	莫曼斯克
莫杰斯特	莫傑斯特
莫桑比克	莫桑比克
莫管闲事	莫管閒事
莫索里尼	莫索里尼
莫辨楮叶	莫辨楮葉
莫里尼奥	莫里尼奧
莱布尼兹	萊布尼茲
莱彩北堂	萊綵北堂
莲开并蒂	蓮開並蒂
获判无罪	獲判無罪
获利倍蓰	獲利倍蓰
获匪其丑	獲匪其醜
获得四坏	獲得四壞
获得胜利	獲得勝利
获暴利者	獲暴利者
获益不浅	獲益不淺
获益匪浅	獲益匪淺
获益良多	獲益良多
菅野美穗	菅野美穗
菩提流志	菩提流志
菲利克斯	菲利克斯
菲力克斯	菲力克斯
菲尼克斯	菲尼克斯
菲德烈克	菲德烈克
菲才寡学	菲才寡學
菲衣恶食	菲衣惡食
萤火虫儿	螢火蟲兒
营养价值	營養價值
营造出来	營造出來
营造厂商	營造廠商
萧行范篆	蕭行范篆
萨克司风	薩克司風
萨克斯管	薩克斯管
萨克斯风	薩克斯風
萨克森州	薩克森州
萨克森邦	薩克森邦
萨克洛夫	薩克洛夫
萨克逊人	薩克遜人
萨布里多	薩布里多
萨格勒布	薩格勒布
落于下风	落於下風
落发为僧	落髮爲僧
落叶乔木	落葉喬木
落叶归根	落葉歸根
落叶果树	落葉果樹
落叶植物	落葉植物
落叶知秋	落葉知秋
落后国家	落後國家
落在后面	落在後面
落地签证	落地簽證
落月屋梁	落月屋梁
落落寡合	落落寡合
落落难合	落落難合
葑菲之采	葑菲之采
著手回春	著手回春
著称于世	著稱於世
著重指出	著重指出
葛托维纳	葛托維納
葛拉斯里	葛拉斯里
葛斯范桑	葛斯范桑
葡萄干儿	葡萄乾兒
董氏封发	董氏封髮
葱葱郁郁	蔥蔥郁郁
蒋舍三径	蔣舍三徑
蒙主宠召	蒙主寵召
蒙古人种	蒙古人種
蒙古利亚	蒙古利亞
蒙古地方	蒙古地方
蒙古大夫	蒙古大夫
蒙古帝国	蒙古帝國
蒙古高原	蒙古高原
蒙台梭利	蒙臺梭利
蒙哥马利	蒙哥馬利
蒙在鼓里	矇在鼓裏
蒙地卡罗	蒙地卡羅
蒙塔尼斯	蒙塔尼斯
蒙大拿州	蒙大拿州
蒙头大睡	矇頭大睡
蒙头衲被	矇頭衲被
蒙头转向	矇頭轉向
蒙娜丽莎	蒙娜麗莎
蒙帕纳斯	蒙帕納斯
蒙彼利埃	蒙彼利埃
蒙恬造笔	蒙恬造筆
蒙托罗拉	蒙托羅拉
蒙昧不清	濛昧不清
蒙昧无知	矇昧無知
蒙混过关	矇混過關
蒙特利尔	蒙特利爾
蒙特卡洛	蒙特卡洛
蒙特卡罗	蒙特卡羅
蒙特维多	蒙特維多
蒙特贝娄	蒙特貝婁
蒙狄维欧	蒙狄維歐
蒙笼暗碧	蒙籠暗碧
蒙罗维亚	蒙羅維亞
蒙菲尔斯	蒙菲爾斯
蒙蒙懂懂	懞懞懂懂
蒙蒙眬眬	矇矇矓矓
蒙蒙细雨	濛濛細雨
蒙藏同胞	蒙藏同胞
蒙藏委员	蒙藏委員
蒲扇价增	蒲扇價增
蒸发空调	蒸發空調
蒸汽熨斗	蒸汽熨斗
蒸沤历澜	蒸漚歷瀾
蒸藜出妻	蒸藜出妻
蒸骨验尸	蒸骨驗屍
蓄势待发	蓄勢待發
蓄须明志	蓄鬚明志
蓝田出玉	藍田出玉
蓝田种玉	藍田種玉
蓟训历家	薊訓歷家
蓦然回首	驀然回首
蓬勃发展	蓬勃發展
蓬头垢面	蓬頭垢面
蓬蓬松松	蓬蓬鬆鬆
蓬门荆布	蓬門荊布
蓬首垢面	蓬首垢面
蕴借含蓄	蘊藉含蓄
蕴奇待价	蘊奇待價
薄海同仇	薄海同仇
薄面含嗔	薄面含嗔
薪尽火传	薪盡火傳
薰莸同器	薰蕕同器
藉资挹注	藉資挹注
藏南纵谷	藏南縱谷
藏蒙歌儿	藏矇歌兒
藏量丰富	藏量豐富
藜藿不采	藜藿不採
虎克定律	虎克定律
虎兕出柙	虎兕出柙
虎斗龙争	虎鬥龍爭
虎荡羊羣	虎蕩羊羣
虑周行果	慮周行果
虑无不周	慮無不周
虚云大师	虛雲大師
虚怀若谷	虛懷若谷
虚有其表	虛有其表
虞歌决别	虞歌決別
虫媒病毒	蟲媒病毒
虫字旁儿	蟲字旁兒
虫沙微类	蟲沙微類
虫沙猿鹤	蟲沙猿鶴
虫篆之技	蟲篆之技
虫臂鼠肝	蟲臂鼠肝
虫虫蚁蚁	蟲蟲蟻蟻
虫霜水旱	蟲霜水旱
虫鸟叫声	蟲鳥叫聲
虫鸣水沸	蟲鳴水沸
虮蝨相吊	蟣蝨相弔
虹彩流辉	虹彩流輝
虽复能复	雖覆能復
蚁斗蜗争	蟻鬥蝸爭
蚊动牛斗	蚊動牛鬥
蚊睫之虫	蚊睫之蟲
蚊虫叮咬	蚊蟲叮咬
蚵仔面线	蚵仔麵綫
蛇发女妖	蛇髮女妖
蛇口蜂针	蛇口蜂針
蛙鼓虫吟	蛙鼓蟲吟
蛮干到底	蠻幹到底
蛮针瞎灸	蠻針瞎灸
蜂午并起	蜂午並起
蜂涌而出	蜂涌而出
蜘蛛星云	蜘蛛星雲
蜜里调油	蜜裏調油
蜡笔小新	蠟筆小新
蝎蝎螫螫	蝎蝎螫螫
蝗虫过境	蝗蟲過境
蝼蚁得志	螻蟻得志
融合为一	融合爲一
螳臂当车	螳臂當車
螺旋曲面	螺旋曲面
螺旋杆菌	螺旋桿菌
螽斯之征	螽斯之徵
螾庐曲谈	螾廬曲談
蟠尾丝虫	蟠尾絲蟲
蟠桃胜会	蟠桃勝會
蟹状星云	蟹狀星雲
蟾宫折桂	蟾宮折桂
蠢蠢欲动	蠢蠢欲動
蠹众木折	蠹眾木折
血亲复仇	血親復仇
血克帮帮	血克幫幫
血吸虫病	血吸蟲病
血汗工厂	血汗工廠
血洗台湾	血洗臺灣
血流如注	血流如注
血浓于水	血濃於水
血海尸山	血海屍山
血海深仇	血海深仇
血缘关系	血緣關係
血肉淋漓	血肉淋漓
衅发萧墙	釁發蕭牆
行万里路	行萬里路
行不苟合	行不苟合
行业规范	行業規範
行个方便	行個方便
行为世范	行爲世範
行为准则	行爲準則
行为艺术	行爲藝術
行为规范	行爲規範
行事历史	行事歷史
行云流水	行雲流水
行伍出身	行伍出身
行兵布阵	行兵布陣
行凶杀人	行兇殺人
行动计划	行動計劃
行合趋同	行合趨同
行同狗彘	行同狗彘
行同狗豨	行同狗豨
行奸卖俏	行奸賣俏
行尸视肉	行屍視肉
行尸走肉	行屍走肉
行尸走骨	行屍走骨
行成于思	行成於思
行政区划	行政區劃
行政当局	行政當局
行政诉愿	行政訴願
行有余力	行有餘力
行短才乔	行短才喬
行短才高	行短才高
行针布线	行鍼布綫
行针步线	行針步綫
行针走线	行鍼走綫
行雨朝云	行雨朝雲
衍声复词	衍聲複詞
衍生出来	衍生出來
衔哀致诚	銜哀致誠
衔恨蒙枉	銜恨蒙枉
衔缺相当	銜缺相當
街坊邻舍	街坊鄰舍
街坊邻里	街坊鄰里
街里街坊	街里街坊
衣不兼采	衣不兼采
衣不完采	衣不完采
衣不布体	衣不布體
衣不重采	衣不重采
衣丰食足	衣豐食足
衣丰食饱	衣豐食飽
衣冠云集	衣冠雲集
衣物已干	衣物已乾
衣物渐干	衣物漸乾
衣绣昼行	衣繡晝行
衣衫已干	衣衫已乾
衣锦夜游	衣錦夜游
衣锦昼游	衣錦晝游
补挂朝珠	補掛朝珠
补气固表	補氣固表
表形文字	表形文字
表彰出来	表彰出來
表意文字	表意文字
表扬大会	表揚大會
表明心迹	表明心蹟
表演艺术	表演藝術
表演过火	表演過火
表现为费	表現爲費
表现主义	表現主義
表现出来	表現出來
表现对象	表現對象
表现自己	表現自己
表的历史	錶的歷史
表的嘀嗒	錶的嘀嗒
表示出来	表示出來
表示敬意	表示敬意
表记物件	表記物件
表达出来	表達出來
表达能力	表達能力
表里一致	表裏一致
表里不一	表裏不一
表里受敌	表裏受敵
表里如一	表裏如一
表里山河	表裏山河
表里相合	表裏相合
表里相应	表裏相應
表里相济	表裏相濟
表露无遗	表露無遺
表面信息	表面信息
表面光洁	表面光潔
表面外膜	表面外膜
表面工夫	表面工夫
表面张力	表面張力
表面质量	表面質量
表音文字	表音文字
衰变曲线	衰變曲綫
衲被蒙头	衲被蒙頭
袅娜纤巧	嫋娜纖巧
袅娜风流	嫋娜風流
袅袅上升	裊裊上升
袅袅娉娉	嫋嫋娉娉
袅袅娜娜	嫋嫋娜娜
袅袅婷婷	嫋嫋婷婷
袅袅炊烟	裊裊炊煙
袖里干坤	袖裏乾坤
被动吸烟	被動吸菸
被动挨打	被動挨打
被发佯狂	被髮佯狂
被发入山	被髮入山
被发左衽	被髮左衽
被发文身	被髮文身
被发缨冠	被髮纓冠
被发阳狂	被髮陽狂
被头散发	被頭散髮
被泽蒙庥	被澤蒙庥
被灾蒙祸	被災蒙禍
袭击战术	襲擊戰術
裁衣合帐	裁衣合帳
裂体吸虫	裂體吸蟲
装修门面	裝修門面
装点门面	裝點門面
装配工厂	裝配工廠
裘弊金尽	裘弊金盡
裙布荆钗	裙布荊釵
裙带关系	裙帶關係
裸体女尸	裸體女屍
裹尸马革	裹屍馬革
褒善贬恶	褒善貶惡
褒贤遏恶	褒賢遏惡
褒采一介	褒采一介
褪前擦后	褪前擦後
褶曲山脉	褶曲山脈
褶皱山系	褶皺山系
西利古里	西利古里
西历纪元	西曆紀元
西原借款	西原借款
西台古堡	西臺古堡
西台帝国	西臺帝國
西周时代	西周時代
西周时期	西周時期
西哈努克	西哈努克
西方极乐	西方極樂
西松建设	西松建設
西格蒙德	西格蒙德
西欧集团	西歐集團
西点面包	西點麵包
西西里岛	西西里島
西谷椰子	西谷椰子
西谷米冻	西谷米凍
西里西亚	西里西亞
西除东荡	西除東蕩
要价还价	要價還價
要千取万	要千取萬
覆水难收	覆水難收
覆盖范围	覆蓋範圍
覆雨翻云	覆雨翻雲
視如寇仇	視如寇讎
见不到面	見不到面
见几而作	見幾而作
见危致命	見危致命
见尧于墙	見堯於牆
见得多了	見得多了
见棱见角	見棱見角
见笑于人	見笑於人
见素抱朴	見素抱樸
见缝插针	見縫插針
见过世面	見過世面
见钟不打	見鐘不打
见马克思	見馬克思
观光签证	觀光簽證
观光胜地	觀光勝地
观叶植物	觀葉植物
观审制度	觀審制度
观察出来	觀察出來
观护制度	觀護制度
观者云集	觀者雲集
观者如云	觀者如雲
规划人员	規劃人員
规划范围	規劃範圍
规定价格	規定價格
规定出来	規定出來
规定地价	規定地價
规定范围	規定範圍
规矩准绳	規矩準繩
规章制度	規章制度
规范企业	規範企業
规范作用	規範作用
规范动作	規範動作
规范市场	規範市場
规范意见	規範意見
规范执法	規範執法
规范技术	規範技術
规范文件	規範文件
规范理论	規範理論
规范管理	規範管理
规范行为	規範行爲
规范语言	規範語言
视同儿戏	視同兒戲
视同具文	視同具文
视同手足	視同手足
视同秦越	視同秦越
视同陌路	視同陌路
视如寇仇	視如寇仇
视如己出	視如己出
视窗基准	視窗基準
视觉艺术	視覺藝術
视觉适应	視覺適應
视讯系统	視訊系統
视野范围	視野範圍
觊觎之志	覬覦之志
觑个意顺	覷個意順
角色冲突	角色衝突
角谷猜想	角谷猜想
解决不了	解決不了
解决困难	解決困難
解到县里	解到縣裏
解剑拜仇	解劍拜仇
解发佯狂	解髮佯狂
解放出来	解放出來
解救出来	解救出來
解析几何	解析幾何
解理方向	解理方向
解铃系铃	解鈴繫鈴
触事面墙	觸事面牆
触发引信	觸發引信
触发清单	觸發清單
触斗蛮争	觸鬥蠻爭
言不尽意	言不盡意
言且表过	言且表過
言之不尽	言之不盡
言之有据	言之有據
言出如山	言出如山
言出必行	言出必行
言出患入	言出患入
言出法随	言出法隨
言大而夸	言大而夸
言尽于此	言盡於此
言归于好	言歸於好
言必有据	言必有據
言文一致	言文一致
言无不尽	言無不盡
言无二价	言無二價
言行一致	言行一致
言行合一	言行合一
言辩而确	言辯而确
詹氏年鉴	詹氏年鑑
詹江布尔	詹江布爾
誓同生死	誓同生死
誓无二志	誓無二志
譆譆出出	譆譆出出
警察制度	警察制度
警报系统	警報系統
警民冲突	警民衝突
计出万全	計出萬全
计划生育	計劃生育
计划目标	計劃目標
计划经济	計劃經濟
计将安出	計將安出
计尽力穷	計盡力窮
计无所出	計無所出
计白当黑	計白當黑
计穷力尽	計窮力盡
计穷力极	計窮力極
计穷虑极	計窮慮極
计算出来	計算出來
认不出来	認不出來
讨个分晓	討個分曉
讨个吉利	討個吉利
讨价还价	討價還價
讨恶剪暴	討惡剪暴
讨没脸面	討沒臉面
让胡路区	讓胡路區
训练出来	訓練出來
议事纪录	議事紀錄
议价空间	議價空間
议会斗争	議會鬥爭
记录下来	記錄下來
讲信修睦	講信修睦
讳恶不悛	諱惡不悛
许下愿心	許下願心
许久以后	許久以後
许愿起经	許愿起經
论千论万	論千論萬
论据不足	論據不足
设坛祭拜	設壇祭拜
设朝升殿	設朝升殿
设言托意	設言托意
设计出来	設計出來
设计规范	設計規範
设鼓悬钟	設鼓懸鐘
访台之旅	訪臺之旅
证卷市场	證卷市场
证明出来	證明出來
评个分数	評個分數
评价分类	評價分類
评分标准	評分標準
评鉴报告	評鑑報告
识别信号	識別信號
识多才广	識多才廣
识微见几	識微見幾
识才尊贤	識才尊賢
识面台官	識面臺官
诈奸不及	詐奸不及
诉说出来	訴說出來
诊断出来	診斷出來
词干启动	詞幹啓動
词无枝叶	詞無枝葉
词汇分解	詞彙分解
词汇判断	詞彙判斷
词汇通路	詞彙通路
词穷理尽	詞窮理盡
诗云子曰	詩云子曰
诗以言志	詩以言志
诛凶殄逆	誅兇殄逆
诛凶讨逆	誅兇討逆
诛尽杀绝	誅盡殺絕
诛戮殆尽	誅戮殆盡
话剧表演	話劇表演
话说回来	話說回來
话里套话	話裏套話
话里有话	話裏有話
话里藏阄	話裏藏鬮
诡计百出	詭計百出
询于刍荛	詢於芻蕘
该当何罪	該當何罪
详尽无遗	詳盡無遺
详征博引	詳徵博引
语法术语	語法術語
语言规范	語言規範
语音合成	語音合成
语音识别	語音識別
误差范围	誤差範圍
诱掖后进	誘掖後進
诱敌战术	誘敵戰術
诱杀战术	誘殺戰術
诱降战术	誘降戰術
说不出口	說不出口
说不出来	說不出來
说了又说	說了又說
说出话来	說出話來
说千说万	說千說萬
说家克计	說家克計
说干便干	說幹便幹
说溜了嘴	說溜了嘴
说闲话儿	說閒話兒
说雨谈云	說雨談雲
请先登录	請先登錄
请别见怪	請別見怪
请勿吸烟	請勿吸菸
请君入瓮	請君入甕
请您回复	請您回復
诺福克岛	諾福克島
诺美克斯	諾美克斯
读万卷书	讀萬卷書
读不舍手	讀不捨手
读书三余	讀書三余
读书种子	讀書種子
读后心得	讀後心得
课前课后	課前課後
课后复习	課後複習
课后练习	課後練習
课后辅导	課後輔導
课程标准	課程標準
诿过于人	諉過於人
调整范围	調整範圍
调查范围	調査範圍
调频电台	調頻電臺
谈判代表	談判代表
谈判制度	談判制度
谈吐有致	談吐有致
谈辞如云	談辭如雲
谋取面试	謀取面試
谋定后动	謀定後動
谋定而后	謀定而後
谋而后动	謀而後動
谢安折屐	謝安折屐
谢尔托夫	謝爾托夫
谢绝参观	謝絕參觀
谣言止于	謠言止於
谦冲自牧	謙沖自牧
谨致谢意	謹致謝意
谬以千里	謬以千里
谬种流传	謬種流傳
谬误百出	謬誤百出
谬采虚声	謬採虛聲
谯周独笑	譙周獨笑
谷保家商	穀保家商
谷口耕岩	谷口耕岩
谷垣祯一	谷垣禎一
谷氨酰胺	谷氨醯胺
谷类作物	穀類作物
谷贱伤农	穀賤傷農
谷贵饿农	穀貴餓農
豁出命干	豁出命幹
豁起来干	豁起來幹
豆干肉丝	豆干肉絲
象征主义	象徵主義
象牙针尖	象牙針尖
象箸玉杯	象箸玉杯
豪厘千里	豪釐千里
豪情万丈	豪情萬丈
豪情壮志	豪情壯志
豪情逸致	豪情逸致
豪气万丈	豪氣萬丈
豪气万千	豪氣萬千
豪气干云	豪氣干雲
豺狼当涂	豺狼當塗
豺狼当路	豺狼當路
豺狼当道	豺狼當道
貌合心离	貌合心離
貌合情离	貌合情離
貌合神离	貌合神離
貌合行离	貌合行離
貌同实异	貌同實異
賸馀价值	賸餘價值
贝他系数	貝他係數
贝克休斯	貝克休斯
贝克勒耳	貝克勒耳
贝克汉姆	貝克漢姆
贝卡谷地	貝卡谷地
贝奇马克	貝奇馬克
贝尔托內	貝爾托內
贝那芬托	貝那芬托
贞卜文字	貞卜文字
负乘致寇	負乘致寇
负债累累	負債累累
负图之托	負圖之托
负心违愿	負心違願
负才任气	負才任氣
负才使气	負才使氣
负气斗狠	負氣鬥狠
负笈千里	負笈千里
负荷不了	負荷不了
负重致远	負重致遠
负鼎之愿	負鼎之願
财产价值	財產價值
财产关系	財產關係
财产目录	財產目錄
财务报表	財務報表
财团法人	財團法人
财政支出	財政支出
财殚力尽	財殫力盡
财竭力尽	財竭力盡
责任准备	責任準備
责任范围	責任範圍
贤奸倒置	賢奸倒置
败于垂成	敗於垂成
败兵折将	敗兵折將
败军折将	敗軍折將
败坏门面	敗壞門面
败子回头	敗子回頭
败部复活	敗部復活
货真价实	貨真價實
质量规范	質量規範
贪欲无艺	貪慾無藝
贪生恶死	貪生惡死
贪生舍义	貪生舍義
贫嘴恶舌	貧嘴惡舌
贫困人家	貧困人家
贫困地区	貧困地區
贫寒出身	貧寒出身
购销差价	購銷差價
贱价出售	賤價出售
贱敛贵出	賤斂貴出
贱敛贵发	賤斂貴發
贵极人臣	貴極人臣
贵游子弟	貴遊子弟
贵贱之别	貴賤之別
贸易伙伴	貿易伙伴
费利克斯	費利克斯
费尔干纳	費爾干納
费尽心思	費盡心思
费尽心机	費盡心機
费尽精神	費盡精神
费尽脣舌	費盡脣舌
费里克斯	費里克斯
费里斯特	費里斯特
贺后骂殿	賀后罵殿
贺尔蒙针	賀爾蒙針
贻笑万世	貽笑萬世
贻笑千古	貽笑千古
贻笑千秋	貽笑千秋
贻羞万年	貽羞萬年
贻范古今	貽範古今
贾可布斯	賈可布斯
贾第虫属	賈第蟲屬
贾第虫病	賈第蟲病
贿赂并行	賄賂並行
赃汙狼借	贓汙狼藉
资产价值	資產價值
资产组合	資產組合
资料介面	資料介面
资方代表	資方代表
资本周转	資本周轉
资本输出	資本輸出
资治通鉴	資治通鑑
资源回收	資源回收
资讯学系	資訊學系
资金占用	資金佔用
赋诗言志	賦詩言志
赋闲在家	賦閒在家
赌咒发愿	賭咒發願
赌身发誓	賭身發誓
赍志没地	齎志沒地
赍志而殁	齎志而歿
赏不当功	賞不當功
赏同罚异	賞同罰異
赏善罚恶	賞善罰惡
赏罚不当	賞罰不當
赒急扶困	賙急扶困
赔个不是	賠個不是
赔了夫人	賠了夫人
赛里木湖	賽里木湖
赛门铁克	賽門鐵克
赞不绝口	讚不絕口
赞伯拉诺	贊伯拉諾
赞佩不已	讚佩不已
赞叹不已	讚歎不已
赞布拉诺	贊布拉諾
赞美有加	讚美有加
赞赏不已	讚賞不已
赢奸卖俏	贏奸賣俏
赤地千里	赤地千里
赤留出律	赤留出律
赤绳系足	赤繩繫足
赫弗里希	赫弗里希
走了风声	走了風聲
走了马脚	走了馬腳
走向前去	走向前去
走向前来	走向前來
走向断层	走向斷層
走回头路	走回頭路
走肉行尸	走肉行屍
走马章台	走馬章臺
走骨行尸	走骨行屍
赶不出来	趕不出來
赶尽杀绝	趕盡殺絕
起承转合	起承轉合
起根发脚	起根發腳
起死回生	起死回生
起航出海	起航出海
趁哄打劫	趁哄打劫
超世之才	超世之才
超凡出世	超凡出世
超出范围	超出範圍
超前瞄准	超前瞄準
超前绝后	超前絕後
超基性岩	超基性岩
超尘出俗	超塵出俗
超手游廊	超手遊廊
超级台风	超級颱風
超级链接	超級鏈接
超羣出众	超羣出眾
超额录取	超額錄取
越冬作物	越冬作物
越出界线	越出界綫
越王尝蓼	越王嘗蓼
趋于平稳	趨於平穩
趋于稳定	趨於穩定
趋前退后	趨前退後
趋吉避凶	趨吉避凶
趋舍异路	趨舍異路
趋舍指凑	趨舍指湊
足不出户	足不出戶
足不出门	足不出門
足了十人	足了十人
足食丰衣	足食豐衣
趸售物价	躉售物價
趸批卖出	躉批賣出
趿拉板儿	趿拉板兒
跃跃欲试	躍躍欲試
跋前疐后	跋前疐後
跋前踬后	跋前躓後
跋涉千里	跋涉千里
跋胡疐尾	跋胡疐尾
跌至谷底	跌至谷底
跌荡不羁	跌蕩不羈
跌荡放言	跌蕩放言
跛鳖千里	跛鱉千里
跟他一斗	跟他一鬥
跟前跟后	跟前跟後
跨步向前	跨步向前
跨鹤西游	跨鶴西遊
跬步千里	跬步千里
路线斗争	路綫鬥爭
路透集团	路透集團
路面等级	路面等級
跳井自尽	跳井自盡
跳出火坑	跳出火坑
跳台滑雪	跳臺滑雪
跳墙出去	跳牆出去
跳梁小丑	跳樑小丑
跳楼自尽	跳樓自盡
跳河自尽	跳河自盡
跳海自尽	跳海自盡
跳脱出来	跳脫出來
踅门了户	踅門瞭戶
踊跃发言	踊躍發言
踌躇满志	躊躇滿志
踔厉风发	踔厲風發
踢到铁板	踢到鐵板
蹀里蹀斜	蹀里蹀斜
蹈厉之志	蹈厲之志
蹈厉奋发	蹈厲奮發
身价百倍	身價百倍
身价非凡	身價非凡
身体发肤	身體髮膚
身做身当	身做身當
身历其境	身歷其境
身后之事	身後之事
身后萧条	身後蕭條
身当其境	身當其境
身当矢石	身當矢石
身有同感	身有同感
身正为范	身正爲範
身系囹圄	身繫囹圄
躬先表率	躬先表率
车攻马同	車攻馬同
车无退表	車無退表
车载斗量	車載斗量
转动曲柄	轉動曲柄
转向信号	轉向信號
转向离合	轉向離合
转圜余地	轉圜餘地
转意回心	轉意回心
转战千里	轉戰千里
转换方向	轉換方向
转斗千里	轉鬥千里
转日回天	轉日回天
转胜为败	轉勝爲敗
转败为胜	轉敗爲勝
转面无情	轉面無情
轮作制度	輪作制度
轮台古城	輪臺古城
软不叮当	軟不叮噹
软件平台	軟件平臺
软件开发	軟件開發
软件技术	軟件技術
软件系统	軟件系統
软软松松	軟軟鬆鬆
轴承合金	軸承合金
轴舻千里	軸艫千里
轻于鸿毛	輕於鴻毛
轻度台风	輕度颱風
轻松愉快	輕鬆愉快
轻松自在	輕鬆自在
轻松自如	輕鬆自如
轻轻松松	輕輕鬆鬆
载浮载沈	載浮載沈
载舟复舟	載舟覆舟
较胜一筹	較勝一籌
辉格党人	輝格黨人
辑录出来	輯錄出來
输入系统	輸入系統
输出功率	輸出功率
输出变压	輸出變壓
输出阻抗	輸出阻抗
辛丑和约	辛丑和約
辛丑条约	辛丑條約
辞不获命	辭不獲命
辞丰意雄	辭豐意雄
辟人之士	辟人之士
辟历施鞭	辟歷施鞭
辟君三舍	辟君三舍
辟地开天	闢地開天
辟恶除患	辟惡除患
辟谷绝粒	辟穀絕粒
辟邪以律	闢邪以律
辨别出来	辨別出來
辨别是非	辨別是非
辨认出来	辨認出來
辩才无碍	辯才無礙
边境冲突	邊境衝突
边幅不修	邊幅不修
迁怒于人	遷怒於人
迁思回虑	遷思迴慮
迂回奔袭	迂回奔襲
迂回战术	迂迴戰術
迂回曲折	迂迴曲折
迂徊战术	迂徊戰術
迂迂曲曲	迂迂曲曲
迅即出发	迅即出發
迅速发展	迅速發展
过人才略	過人才略
过境签证	過境簽證
过失致死	過失致死
过当防卫	過當防衛
过桥抽板	過橋抽板
过河抽板	過河抽板
过滤出来	過濾出來
过眼云烟	過眼雲煙
过眼烟云	過眼煙雲
过耳秋风	過耳秋風
迎合人心	迎合人心
迎向前去	迎向前去
迎奸卖俏	迎奸賣俏
迎面而来	迎面而來
运出运费	運出運費
运筹决胜	運籌決勝
运筹千里	運籌千里
运输系统	運輸系統
近乎同步	近乎同步
近几年来	近幾年來
近日無仇	近日無讎
近朱者赤	近朱者赤
近朱近墨	近朱近墨
近水楼台	近水樓臺
返吟复吟	返吟復吟
返照回光	返照回光
返还占有	返還占有
返魂乏术	返魂乏術
还原熔炼	還原熔煉
还政于民	還政於民
还淳反朴	還淳反樸
还淳返朴	還淳返樸
还珠合浦	還珠合浦
这个当儿	這個當兒
这个挡口	這個擋口
这个那个	這個那個
这几个人	這幾個人
这几个月	這幾個月
这出好戏	這齣好戲
这出电影	這齣電影
这种方式	這種方式
这般干法	這般幹法
这还了得	這還了得
进了天堂	進了天堂
进出口商	進出口商
进士出身	進士出身
进德修业	進德修業
进货让价	進貨讓價
进货退出	進貨退出
进货退回	進貨退回
进进出出	進進出出
进退失据	進退失據
进退无据	進退無據
进退维谷	進退維谷
远亲近戚	遠親近戚
远县才至	遠縣纔至
远引曲喻	遠引曲喻
远房亲戚	遠房親戚
远打周折	遠打週折
远期外汇	遠期外匯
远程登录	遠程登錄
远端签入	遠端簽入
远远落后	遠遠落後
远隔千里	遠隔千里
违禁药品	違禁藥品
违章建筑	違章建築
违纪参选	違紀參選
连三并四	連三併四
连云叠嶂	連雲疊嶂
连云港市	連雲港市
连台好戏	連臺好戲
连台本戏	連臺本戲
连哄带骗	連哄帶騙
连城之价	連城之價
连带关系	連帶關係
连年丰收	連年豐收
连战连胜	連戰連勝
连杆机构	連桿機構
连枝分叶	連枝分葉
连枝带叶	連枝帶葉
连根拔出	連根拔出
连珠合璧	連珠合璧
连登云路	連登雲路
连系起来	連繫起來
连镳并轸	連鑣並軫
连须胡子	連鬚鬍子
连鬓胡子	連鬢鬍子
迟回观望	遲回觀望
迢迢千里	迢迢千里
迥不相同	迥不相同
迥乎不同	迥乎不同
迥然不同	迥然不同
迥然回异	迥然迴異
迥然有别	迥然有別
迦叶尊者	迦葉尊者
迪吉苏斯	迪吉蘇斯
迪雅巴克	迪雅巴克
迪黑苏斯	迪黑蘇斯
迫于形势	迫於形勢
迫于眉睫	迫於眉睫
迭出迭入	迭出迭入
迭有发现	迭有發現
迭有斩获	迭有斬獲
迭见杂出	迭見雜出
迷了心窍	迷了心竅
迷迷蒙蒙	迷迷濛濛
追思弥撒	追思彌撒
追求幸福	追求幸福
退出运行	退出運行
退前缩后	退前縮後
退居幕后	退居幕後
退徙三舍	退徙三舍
退有后言	退有後言
退藏于密	退藏於密
退避三舍	退避三舍
送客出门	送客出門
适不适合	適不適合
适中下怀	適中下懷
适可而止	適可而止
适婚年龄	適婚年齡
适应环境	適應環境
适度微调	適度微調
适当范围	適當範圍
适得其反	適得其反
适得其所	適得其所
适材适用	適材適用
适用范围	適用範圍
适者生存	適者生存
适航指令	適航指令
适逢其会	適逢其會
适销对路	適銷對路
逃出生天	逃出生天
逃出虎口	逃出虎口
逆入平出	逆入平出
逆向公车	逆向公車
逆向思考	逆向思考
逆向整合	逆向整合
逆向行驶	逆向行駛
逆转录酶	逆轉錄酶
选举人团	選舉人團
选举制度	選舉制度
选修科目	選修科目
选手表决	選手表決
选手表明	選手表明
选手表现	選手表現
选手表示	選手表示
选手表达	選手表達
选拔干部	選拔幹部
选择范围	選擇範圍
选民代表	選民代表
选派代表	選派代表
选美皇后	選美皇后
逊志时敏	遜志時敏
逐出门墙	逐出門牆
逐末舍本	逐末捨本
逐步升级	逐步升級
递推关系	遞推關係
递解出境	遞解出境
逗人发笑	逗人發笑
通事舍人	通事舍人
通人达才	通人達才
通信技术	通信技術
通信系统	通信系統
通力合作	通力合作
通合一气	通合一氣
通同一气	通同一氣
通才教育	通才教育
通才练识	通才練識
通盘计划	通盤計劃
通联记录	通聯記錄
通讯系统	通訊系統
通过事后	通過事後
逞凶斗狠	逞兇鬥狠
逞凶鬥狠	逞兇鬥狠
逞异夸能	逞異誇能
速去速回	速去速回
造型艺术	造型藝術
造天立极	造天立極
造就人才	造就人才
造岩矿物	造岩礦物
造形艺术	造形藝術
造极登峰	造極登峰
造福万民	造福萬民
逢低卖出	逢低賣出
逢凶化吉	逢凶化吉
逢君之恶	逢君之惡
逢高卖出	逢高賣出
逮个正著	逮個正著
逸游自恣	逸游自恣
逸羣之才	逸羣之才
逼上梁山	逼上梁山
逾闲荡检	逾閑蕩檢
遂其所愿	遂其所願
遏恶扬善	遏惡揚善
道合志同	道合志同
道同志合	道同志合
道听涂说	道聽塗說
道尔顿制	道爾頓制
道尽涂殚	道盡塗殫
道尽途穷	道盡途窮
道德发展	道德發展
道德困境	道德困境
道德规范	道德規範
道范长昭	道範長昭
遗害万年	遺害萬年
遗恨千古	遺恨千古
遗臭万代	遺臭萬代
遗臭万年	遺臭萬年
遗臭万载	遺臭萬載
遗臭千年	遺臭千年
遗葑菲采	遺葑菲采
遣送出境	遣送出境
遣送回国	遣送回國
遥测技术	遙測技術
遨游四海	遨遊四海
遨游天下	遨遊天下
遭人暗算	遭人暗算
遮前掩后	遮前掩後
遮头盖面	遮頭蓋面
遮道挽留	遮道挽留
遴选出来	遴選出來
避不见面	避不見面
避凶就吉	避凶就吉
避凶趋吉	避凶趨吉
避暑胜地	避暑勝地
邀天之幸	邀天之幸
邋里邋遢	邋里邋遢
邢台地区	邢臺地區
那出好戏	那齣好戲
那出电影	那齣電影
那斯达克	那斯達克
那曲地区	那曲地區
邪不干正	邪不干正
邪不胜正	邪不勝正
邪恶轴心	邪惡軸心
邮政划拨	郵政劃撥
邮政汇票	郵政匯票
邮购价格	郵購價格
邮购目录	郵購目錄
邻里乡党	鄰里鄉黨
郁堙不偶	鬱堙不偶
郁郁不乐	鬱鬱不樂
郁郁不平	鬱鬱不平
郁郁寡欢	鬱鬱寡歡
郁郁而终	鬱鬱而終
郁郁菲菲	郁郁菲菲
郁郁葱葱	鬱鬱蔥蔥
郁郁青青	郁郁青青
郁闷不乐	鬱悶不樂
郊坛下窑	郊壇下窯
郎才女姿	郎才女姿
郎才女貌	郎才女貌
郎潜白发	郎潛白髮
郑卫之曲	鄭衛之曲
郑重宣布	鄭重宣佈
郡县制度	郡縣制度
部落同盟	部落同盟
都俞吁咈	都俞吁咈
都发局长	都發局長
都市计划	都市計劃
鄂托克旗	鄂托克旗
鄂温克族	鄂溫克族
鄂温克语	鄂溫克語
酋长制度	酋長制度
酌古御今	酌古御今
配享千秋	配享千秋
配件挂勾	配件掛勾
配制饲料	配制飼料
配合禁忌	配合禁忌
配合起来	配合起來
配水干管	配水幹管
配水系统	配水系統
配种季节	配種季節
配给制度	配給制度
配送范围	配送範圍
酒入舌出	酒入舌出
酒后失态	酒後失態
酒后失言	酒後失言
酒后驾车	酒後駕車
酒后驾驶	酒後駕駛
酒有别肠	酒有別腸
酒气冲天	酒氣衝天
酒气熏人	酒氣熏人
酒醴曲蘖	酒醴麴櫱
酒食征逐	酒食徵逐
酣嬉淋漓	酣嬉淋漓
酣畅淋漓	酣暢淋漓
酥松可口	酥鬆可口
酥松油脂	酥鬆油脂
酷刑折磨	酷刑折磨
酸酸咸咸	酸酸鹹鹹
酿造出来	釀造出來
醋酸纤维	醋酸纖維
醯鸡甕里	醯雞甕裏
采光剖璞	采光剖璞
采兰赠芍	采蘭贈芍
采兰赠药	採蘭贈藥
采及葑菲	采及葑菲
采取措施	採取措施
采取行动	採取行動
采椽不斲	采椽不斲
采生折割	採生折割
采石之役	采石之役
采石之战	采石之戰
采石之戰	采石之戰
采矿工业	採礦工業
采矿工程	採礦工程
采矿方法	採礦方法
采空采穗	採空採穗
采薪之忧	采薪之憂
采薪之疾	采薪之疾
采访新闻	採訪新聞
采访编辑	採訪編輯
采访记者	採訪記者
采购供应	採購供應
采购规则	採購規則
采集起来	採集起來
采风问俗	採風問俗
释放出来	釋放出來
释放出狱	釋放出獄
里仁为美	里仁爲美
里出外进	裏出外進
里勾外连	裏勾外連
里外发烧	裏外發燒
里外受敌	裏外受敵
里应外合	裏應外合
里弗赛德	里弗賽德
里急后重	裏急後重
里氏震级	里氏震級
里民大会	里民大會
里瓦尔多	裏瓦爾多
里程碑式	里程碑式
里蒙诺夫	里蒙諾夫
里谈巷议	里談巷議
里进外出	裏進外出
里通外国	裏通外國
里通外敌	裏通外敵
里里外外	裏裏外外
重于泰山	重於泰山
重修旧好	重修舊好
重历旧游	重歷舊遊
重复使用	重複使用
重复记录	重複記錄
重复语境	重複語境
重复课税	重複課稅
重岩叠嶂	重巖疊嶂
重新装修	重新裝修
重新评价	重新評價
重游旧地	重遊舊地
重点采访	重點採訪
重生爷娘	重生爺孃
重置价格	重置價格
重见复出	重見複出
重蹈复辙	重蹈覆轍
重重困难	重重困難
野外定向	野外定向
野无遗才	野無遺才
野胡萝卜	野胡蘿蔔
野草闲花	野草閒花
野鹤闲云	野鶴閒雲
量入为出	量入爲出
量出制入	量出制入
量才录用	量才錄用
量材录用	量材錄用
金伯利岩	金伯利岩
金印如斗	金印如斗
金发女郎	金髮女郎
金发碧眼	金髮碧眼
金头银面	金頭銀面
金本位制	金本位制
金枝玉叶	金枝玉葉
金柜石室	金櫃石室
金榜挂名	金榜掛名
金氏纪录	金氏紀錄
金盏银台	金盞銀臺
金粉楼台	金粉樓臺
金融杠杆	金融槓桿
金融系统	金融系統
金装玉里	金裝玉裏
金谷堕楼	金谷墮樓
金谷酒数	金谷酒數
金针度人	金針度人
金钱万能	金錢萬能
金钱挂帅	金錢掛帥
金钱游戏	金錢遊戲
金铜合铸	金銅合鑄
金马仑道	金馬崙道
釜底游魂	釜底遊魂
釜底游鱼	釜底游魚
釜里之鱼	釜裏之魚
鉴别能力	鑑別能力
鉴古推今	鑑古推今
鉴定考试	鑑定考試
鉴往知来	鑑往知來
鉴核备査	鑑核備査
鉴毛辨色	鑑毛辨色
鉴湖女侠	鑑湖女俠
鉴真和尚	鑑真和尚
鉴貌辨色	鑑貌辨色
鉴赏能力	鑑賞能力
针刺麻醉	針刺麻醉
针叶植物	針葉植物
针头线脑	針頭綫腦
针孔照像	針孔照像
针孔现象	針孔現象
针挑刀挖	針挑刀挖
针灸铜人	鍼灸銅人
针灸麻醉	鍼灸麻醉
针线活儿	針綫活兒
针线活计	針綫活計
针线箔篱	針綫箔籬
针芥相投	鍼芥相投
针针见血	針針見血
针锋相对	針鋒相對
针锋相投	針鋒相投
针饵莫减	針餌莫減
针黹纺绩	針黹紡績
钓游旧地	釣遊舊地
钟在寺里	鐘在寺裏
钟楼怪人	鐘樓怪人
钟表历史	鐘錶歷史
钟鸣漏尽	鐘鳴漏盡
钟鸣鼎食	鐘鳴鼎食
钟鼎之家	鐘鼎之家
钟鼎人家	鐘鼎人家
钟鼎山林	鐘鼎山林
钟鼎款识	鐘鼎款識
钟鼎高门	鐘鼎高門
钟鼓齐鸣	鐘鼓齊鳴
钩心斗角	鉤心鬥角
钩深致远	鉤深致遠
钩花点叶	鉤花點葉
钱柜杂志	錢櫃雜誌
钱过北斗	錢過北斗
钻井平台	鑽井平臺
钻懒帮闲	鑽懶幫閒
钻皮出羽	鑽皮出羽
钻石项链	鑽石項鍊
钿头云篦	鈿頭雲篦
铁云藏龟	鐵雲藏龜
铁杵磨针	鐵杵磨針
铁板大鼓	鐵板大鼓
铁板快书	鐵板快書
铁板注脚	鐵板註腳
铁板牛柳	鐵板牛柳
铁板牛肉	鐵板牛肉
铁板茄子	鐵板茄子
铁索郎当	鐵索郎當
铁路干线	鐵路幹綫
铁面判官	鐵面判官
铁面御史	鐵面御史
铁面无情	鐵面無情
铁面无私	鐵面無私
铅字合金	鉛字合金
铜斗家私	銅斗家私
铜斗家计	銅斗家計
铜琵铁板	銅琵鐵板
银发产业	銀髮產業
银本位制	銀本位制
银杯羽化	銀杯羽化
银河星云	銀河星雲
银行借款	銀行借款
银行存折	銀行存摺
铺盖卷儿	鋪蓋捲兒
铺眉蒙眼	鋪眉蒙眼
铺锦列绣	鋪錦列繡
链式反应	鏈式反應
链锁反应	鏈鎖反應
销售价格	銷售價格
销货折扣	銷貨折扣
锋发韵流	鋒發韻流
锋芒所向	鋒芒所向
锐不可当	銳不可當
锐未可当	銳未可當
锕系元素	錒系元素
错了又错	錯了又錯
错化合物	錯化合物
错彩镂金	錯彩鏤金
错综复杂	錯綜複雜
错落有致	錯落有致
错觉结合	錯覺結合
错误百出	錯誤百出
锦囊佳制	錦囊佳製
锦绣花园	錦繡花園
锲而不舍	鍥而不捨
镂冰雕朽	鏤冰雕朽
镂彩摛文	鏤彩摛文
镂月裁云	鏤月裁雲
镂金错采	鏤金錯采
镜框舞台	鏡框舞臺
镜里孤鸾	鏡裏孤鸞
镧系元素	镧系元素
长吁短叹	長吁短嘆
长君之恶	長君之惡
长恶不悛	長惡不悛
长期借款	長期借款
长林丰草	長林豐草
长歌当哭	長歌當哭
长江后浪	長江後浪
长烟一空	長煙一空
长程计划	長程計劃
长绳系日	長繩繫日
长绳系景	長繩繫景
长辔远御	長轡遠御
长风万里	長風萬里
開發周期	開發周期
门前门后	門前門後
门当户对	門當戶對
门殚户尽	門殫戶盡
门里出身	門裏出身
门里安心	門裏安心
门里门外	門裏門外
闪了一下	閃了一下
闪含语系	閃含語系
闪电战术	閃電戰術
闪闪发光	閃閃發光
闭一只眼	閉一隻眼
闭卷考试	閉卷考試
闭合电路	閉合電路
问个问题	問個問題
问卷调査	問卷調査
问政于民	問政於民
问舍求田	問舍求田
问道于盲	問道於盲
闯荡江湖	闖蕩江湖
闯进闯出	闖進闖出
闲云孤鹤	閒雲孤鶴
闲云野鹤	閒雲野鶴
闲人免进	閒人免進
闲庭信步	閒庭信步
闲情逸致	閒情逸致
闲情逸趣	閒情逸趣
闲打牙儿	閒打牙兒
闲是闲非	閒是閒非
闲杂人员	閒雜人員
闲杂人等	閒雜人等
闲来无事	閒來無事
闲置不用	閒置不用
闲花野草	閒花野草
闲茶浪酒	閒茶浪酒
闲言乱语	閒言亂語
闲言碎语	閒言碎語
闲言长语	閒言長語
闲言闲事	閒言閒事
闲言闲语	閒言閒語
闲话家常	閒話家常
闲话少说	閒話少說
闲邪存诚	閒邪存誠
间不容发	間不容髮
间接证据	間接證據
闷在心里	悶在心裏
闹出笑话	鬧出笑話
闹铃时钟	鬧鈴時鐘
闻名于世	聞名於世
闽台地区	閩臺地區
闾党姻娅	閭黨姻婭
阔别多年	闊別多年
防不胜防	防不勝防
防卫过当	防衛過當
防守战术	防守戰術
防御工事	防禦工事
防御率王	防禦率王
防护面具	防護面具
防毒斗篷	防毒斗篷
防毒面具	防毒面具
防火系统	防火系統
防范体系	防範體系
防范得宜	防範得宜
防范意识	防範意識
防范控制	防範控制
防范措施	防範措施
防范未然	防範未然
阳台云雨	陽臺雲雨
阳台春梦	陽臺春夢
阳极射线	陽極射綫
阳虚发热	陽虛發熱
阴山背后	陰山背後
阴极射线	陰極射綫
阴胜则寒	陰勝則寒
阴虚发热	陰虛發熱
阴阳合历	陰陽合曆
阴阴暗暗	陰陰暗暗
阴阴沈沈	陰陰沈沈
阶梯计价	階梯計價
阶级斗争	階級鬥爭
阻挡不了	阻擋不了
阻止不了	阻止不了
阿什克隆	阿什克隆
阿修罗道	阿修羅道
阿克伦河	阿克倫河
阿克塞县	阿克塞縣
阿克苏市	阿克蘇市
阿克苏河	阿克蘇河
阿克赛钦	阿克賽欽
阿克陶县	阿克陶縣
阿卜杜拉	阿卜杜拉
阿卡提里	阿卡提里
阿历山大	阿歷山大
阿合奇县	阿合奇縣
阿奇里斯	阿奇里斯
阿布叔醇	阿布叔醇
阿布哈兹	阿布哈茲
阿布扎比	阿布扎比
阿布杜拉	阿布杜拉
阿布瑞尤	阿布瑞尤
阿布贝卡	阿布貝卡
阿布达比	阿布達比
阿布雷尤	阿布雷尤
阿弥陀佛	阿彌陀佛
阿弥陀经	阿彌陀經
阿意曲从	阿意曲從
阿扎伦卡	阿紮倫卡
阿扎尼亚	阿扎尼亞
阿旺曲培	阿旺曲培
阿旺曲沛	阿旺曲沛
阿松森岛	阿松森島
阿森松岛	阿森松島
阿瓦里德	阿瓦里德
阿苏火山	阿蘇火山
阿谀苟合	阿諛苟合
阿贾克斯	阿賈克斯
阿里亚斯	阿里亞斯
阿里地区	阿里地區
阿里山乡	阿里山鄉
阿里山区	阿里山區
阿里巴巴	阿里巴巴
阿里桑那	阿里桑那
附会假借	附會假借
附加价值	附加價值
际会风云	際會風雲
陆讋水栗	陸讋水慄
陈三五娘	陳三五娘
陈鼎击钟	陳鼎擊鐘
降价出售	降價出售
降价求售	降價求售
降志辱身	降志辱身
降血压药	降血壓藥
降血脂药	降血脂藥
限制住居	限制住居
限制选举	限制選舉
陕飞集团	陝飛集團
陡然升高	陡然升高
除了之外	除了之外
除凶去害	除凶去害
除恶务尽	除惡務盡
除恶务本	除惡務本
除恶扶善	除惡扶善
除旧布新	除舊佈新
陪审制度	陪審制度
陵土未干	陵土未乾
陶土制品	陶土製品
陶庵梦忆	陶庵夢憶
陷入困境	陷入困境
隆乳手术	隆乳手術
隆河谷地	隆河谷地
随之而后	隨之而後
随口胡诌	隨口胡謅
随后就到	隨後就到
随后就去	隨後就去
随后就来	隨後就來
随心所欲	隨心所欲
随才器使	隨才器使
随时制宜	隨時制宜
隐名合伙	隱名合夥
隐形涂料	隱形塗料
隐恶扬善	隱惡揚善
隔年皇历	隔年皇曆
隔房同辈	隔房同輩
难于上天	難於上天
难于接近	難於接近
难于登天	難於登天
难以出口	難以出口
难偿所愿	難償所願
难出手心	難出手心
难分难舍	難分難捨
难割难舍	難割難捨
难当重任	難當重任
难得糊涂	難得糊塗
难施面目	難施面目
难易适中	難易適中
难舍难分	難捨難分
难舍难离	難捨難離
雄师百万	雄師百萬
雄心万丈	雄心萬丈
雄心壮志	雄心壯志
雄才大略	雄才大略
雄据一方	雄據一方
雅人深致	雅人深致
雅库次克	雅庫次克
雅鲁藏布	雅魯藏布
集中托运	集中托運
集于一身	集於一身
集体强奸	集體強姦
集合名词	集合名詞
集合地点	集合地點
集合时间	集合時間
集合起来	集合起來
集团主义	集團主義
集团结婚	集團結婚
集资合建	集資合建
雌雄同体	雌雄同體
雌雄同株	雌雄同株
雍容闲雅	雍容閒雅
雕心雁爪	鵰心雁爪
雕梁画柱	雕樑畫柱
雕梁画栋	雕樑畫棟
雕楹碧槛	雕楹碧檻
雕版印刷	雕版印刷
雕章缋句	雕章繢句
雕章镂句	雕章鏤句
雕肝琢肾	雕肝琢腎
雕肝琢膂	雕肝琢膂
雕肝镂肾	雕肝鏤腎
雕花漆彩	雕花漆彩
雕虫小技	雕蟲小技
雕虫小艺	雕蟲小藝
雕虫篆刻	雕蟲篆刻
雕蚶镂蛤	雕蚶鏤蛤
雨后春笋	雨後春筍
雨散云收	雨散雲收
雨村曲话	雨村曲話
雨泽下注	雨澤下注
雨约云期	雨約雲期
雨花台区	雨花臺區
雨魄云魂	雨魄雲魂
雪窗萤几	雪窗螢几
雪耻复国	雪恥復國
雪耻报仇	雪恥報仇
雪里送炭	雪裏送炭
零售价格	零售價格
雷克萨斯	雷克薩斯
雷扎耶湖	雷扎耶湖
雷文克劳	雷文克勞
雷蒙德电	雷蒙德電
雷达搜索	雷達搜索
雷霆万钧	雷霆萬鈞
雾里看花	霧裏看花
雾锁云埋	霧鎖雲埋
需才孔亟	需才孔亟
霁范永存	霽範永存
霄壤之别	霄壤之別
震天价响	震天價響
震旦方向	震旦方向
震波曲线	震波曲綫
震源机制	震源機制
震耳欲聋	震耳欲聾
震荡不安	震盪不安
霉气冲天	黴氣衝天
霉运当头	黴運當頭
霍乱杆菌	霍亂桿菌
霍克海姆	霍克海姆
霍普曼杯	霍普曼杯
霑体涂足	霑體塗足
露出原形	露出原形
露出破绽	露出破綻
露出马脚	露出馬腳
露台弟子	露臺弟子
露天开采	露天開採
露才扬己	露才揚己
露面抛头	露面拋頭
霸王别姬	霸王別姬
霸陵折柳	霸陵折柳
霹雳游侠	霹靂遊俠
青云之器	青雲之器
青云之士	青雲之士
青云直上	青雲直上
青云谱区	青雲譜區
青出于蓝	青出於藍
青少年团	青少年團
青山一发	青山一髮
青灯黄卷	青燈黃卷
青蝇吊客	青蠅弔客
青过于蓝	青過於藍
青钱万选	青錢萬選
青面獠牙	青面獠牙
青鞋布袜	青鞋布襪
靖康要录	靖康要錄
静以制动	靜以制動
静极思动	靜極思動
静脉曲张	靜脈曲張
静脉注入	靜脈注入
静脉注射	靜脈注射
静默致哀	靜默致哀
非借不可	非借不可
非党人士	非黨人士
非出不可	非出不可
非占不可	非佔不可
非发不可	非發不可
非发光体	非發光體
非同儿戏	非同兒戲
非同容易	非同容易
非同寻常	非同尋常
非同小可	非同小可
非师范类	非師範類
非当不可	非當不可
非意相干	非意相干
非杠杆化	非槓桿化
非欧几何	非歐幾何
非法勾当	非法勾當
非涂不可	非塗不可
非确定性	非確定性
非签不可	非簽不可
靠外面走	靠外面走
靠里面走	靠裏面走
靡然向风	靡然向風
面上无光	面上無光
面不改容	面不改容
面不改色	面不改色
面临困难	面臨困難
面包师傅	麵包師傅
面北眉南	面北眉南
面向连接	面向連接
面命耳提	面命耳提
面善心恶	面善心惡
面善心狠	面善心狠
面圆耳大	面圓耳大
面墙而立	面牆而立
面壁下帷	面壁下帷
面壁功深	面壁功深
面壁坐禅	面壁坐禪
面壁思过	面壁思過
面如傅粉	面如傅粉
面如冠玉	面如冠玉
面如噀血	面如噀血
面如土色	面如土色
面如敷粉	面如敷粉
面如桃花	面如桃花
面如槁木	面如槁木
面如死灰	面如死灰
面如灰土	面如灰土
面如白纸	面如白紙
面如白蜡	面如白蠟
面如美玉	面如美玉
面如重枣	面如重棗
面如金纸	面如金紙
面如铁色	面如鐵色
面子情儿	面子情兒
面对现实	面對現實
面带微笑	面帶微笑
面带忧容	面帶憂容
面带愁容	面帶愁容
面带病容	面帶病容
面带笑容	面帶笑容
面恶心善	面惡心善
面折廷争	面折廷爭
面授机宜	面授機宜
面方口阔	面方口闊
面无人色	面無人色
面无血色	面無血色
面无表情	面無表情
面月印记	面月印記
面有喜色	面有喜色
面有忧色	面有憂色
面有菜色	面有菜色
面有难色	面有難色
面杖吹火	麵杖吹火
面生不熟	面生不熟
面白无须	面白無鬚
面皮失色	面皮失色
面皮焦黄	面皮焦黃
面皮铁青	面皮鐵青
面目一新	面目一新
面目全非	面目全非
面目可憎	面目可憎
面目清秀	面目清秀
面目狰狞	面目猙獰
面目黄瘦	面目黃瘦
面红耳热	面紅耳熱
面红耳赤	面紅耳赤
面红过耳	面紅過耳
面红面赤	面紅面赤
面缚舆榇	面縛輿櫬
面缚衔璧	面縛銜璧
面色发白	面色發白
面色如土	面色如土
面色如生	面色如生
面色苍白	面色蒼白
面若春花	面若春花
面薄腰纤	面薄腰纖
面见江东	面見江東
面誉背毁	面譽背毀
面试工作	面試工作
面貌一新	面貌一新
面貌全非	面貌全非
面部表情	面部表情
面阔口方	面闊口方
面露不悦	面露不悅
面青脣白	面青脣白
面面俱全	面面俱全
面面俱到	面面俱到
面面俱圆	面面俱圓
面面厮觑	面面廝覷
面面相窥	面面相窺
面面相觑	面面相覷
面黄肌瘦	面黃肌瘦
面黄肌闳	面黃肌閎
面黄脣白	面黃脣白
革出山门	革出山門
革出教门	革出教門
革命党人	革命黨人
革命发展	革命發展
革命干劲	革命幹勁
革命意志	革命意志
革命斗志	革命鬥志
革命积极	革命積極
革面洗心	革面洗心
鞠躬尽力	鞠躬盡力
鞠躬尽悴	鞠躬盡悴
鞠躬尽瘁	鞠躬盡瘁
鞭辟入里	鞭辟入裏
鞭辟近里	鞭辟近裏
韦布匹夫	韋布匹夫
韦布斯特	韋布斯特
韦陟朵云	韋陟朵雲
韧皮纤维	韌皮纖維
韩信登坛	韓信登壇
韩干画马	韓幹畫馬
韩康卖药	韓康賣藥
韩海苏潮	韓海蘇潮
韫椟待价	韞櫝待價
韬戈卷甲	韜戈卷甲
音像制品	音像製品
音声如钟	音聲如鐘
韶钢松山	韶鋼松山
顶针挨住	頂針捱住
须发皆白	鬚髮皆白
须髯如戟	鬚髯如戟
顽筑舞笈	頑筑舞笈
顾前顾后	顧前顧後
顾后瞻前	顧後瞻前
顾复之恩	顧復之恩
顾曲周郎	顧曲周郎
顿涅斯克	頓涅斯克
顿涅茨克	頓涅茨克
颁发奖品	頒發獎品
颁发奖杯	頒發獎盃
颁发奖牌	頒發獎牌
颁发奖状	頒發獎狀
颁发奖金	頒發獎金
预制构件	預製構件
预托证券	預託證券
预警系统	預警系統
预防接种	預防接種
预防注射	預防注射
领导制度	領導制度
领导干部	領導幹部
频危物种	頻危物種
频数分布	頻數分佈
频率合成	頻率合成
频率调制	頻率調製
颖脱而出	穎脫而出
题库系统	題庫系統
题材范围	題材範圍
颜面扫地	顏面掃地
颜面神经	顏面神經
额我略历	額我略曆
颟里颟顸	顢里顢頇
颠倒干坤	顛倒乾坤
颠干倒坤	顛乾倒坤
颠番面皮	顛番面皮
颠连困苦	顛連困苦
颠颠仆仆	顛顛仆仆
风举云摇	風舉雲搖
风云不测	風雲不測
风云之志	風雲之志
风云人物	風雲人物
风云变幻	風雲變幻
风云变态	風雲變態
风云变色	風雲變色
风云叱咤	風雲叱吒
风云开阖	風雲開闔
风云感会	風雲感會
风云月露	風雲月露
风云气候	風雲氣候
风云突变	風雲突變
风云际会	風雲際會
风兴云蒸	風興雲蒸
风力发电	風力發電
风卷残云	風捲殘雲
风尘仆仆	風塵僕僕
风尘恶俗	風塵惡俗
风尘表物	風塵表物
风情万种	風情萬種
风成砂岩	風成砂岩
风扫落叶	風掃落葉
风月宝鉴	風月寶鑑
风流云散	風流雲散
风流别致	風流別致
风流千古	風流千古
风流才子	風流才子
风流标致	風流標致
风流蕴借	風流蘊藉
风流酝借	風流醞藉
风虎云龙	風虎雲龍
风起云布	風起雲布
风起云涌	風起雲涌
风起云蒸	風起雲蒸
风轻云淡	風輕雲淡
风轻云淨	風輕雲淨
风采堂堂	風采堂堂
风里杨花	風裏楊花
风险防范	風險防範
风雨同舟	風雨同舟
风雨欲来	風雨欲來
风靡云涌	風靡雲涌
风靡云蒸	風靡雲蒸
风飞云会	風飛雲會
风马云车	風馬雲車
风驰电卷	風馳電卷
飘游四海	飄遊四海
飘然出世	飄然出世
飘飘欲仙	飄飄欲仙
飘飘荡荡	飄飄蕩蕩
飙发电举	飆發電舉
飞云掣电	飛雲掣電
飞刍挽粒	飛芻輓粒
飞刍挽粟	飛芻輓粟
飞刍挽粮	飛芻輓糧
飞必冲天	飛必沖天
飞燕游龙	飛燕游龍
飞粮挽秣	飛糧輓秣
飞腾之药	飛騰之藥
飞行甲板	飛行甲板
飞行记录	飛行記錄
飞针走线	飛針走綫
飞龙乘云	飛龍乘雲
食不充饥	食不充飢
食日万钱	食日萬錢
食欲不佳	食慾不佳
食欲不振	食慾不振
食虫植物	食蟲植物
食野之苹	食野之苹
餍于游乐	饜於游樂
餐松啖柏	餐松啖柏
餐松食柏	餐松食柏
餐松饮涧	餐松飲澗
饥不择食	飢不擇食
饥冻交切	飢凍交切
饥寒交切	飢寒交切
饥寒交迫	飢寒交迫
饥渴交攻	飢渴交攻
饥渴交迫	飢渴交迫
饥火中焚	飢火中焚
饥火烧肠	飢火燒腸
饥肠辘辘	飢腸轆轆
饥虎扑食	飢虎撲食
饥附饱飏	飢附飽颺
饥餐渴饮	飢餐渴飲
饥饿三十	飢餓三十
饥馑之岁	饑饉之歲
饥馑荐臻	饑饉薦臻
饥鹰饿虎	飢鷹餓虎
饭后服用	飯後服用
饭后漱口	飯後漱口
饭店回葱	飯店回蔥
饮弹自尽	飲彈自盡
饮水曲肱	飲水曲肱
饱学秀才	飽學秀才
饲养标准	飼養標準
饶舌歌曲	饒舌歌曲
饿殍枕借	餓殍枕藉
饿虎饥鹰	餓虎飢鷹
馀响绕梁	餘響繞梁
馀妙绕梁	餘妙繞梁
馀杯冷炙	餘杯冷炙
馀波荡漾	餘波盪漾
馀烬复然	餘燼復然
馀音绕梁	餘音繞樑
馀音袅绕	餘音嫋繞
馀音袅袅	餘音嫋嫋
馆际互借	館際互借
馋涎欲垂	饞涎欲垂
馋涎欲滴	饞涎欲滴
首丘夙愿	首丘夙願
首席代表	首席代表
首度来台	首度來臺
首开纪录	首開紀錄
首当其冲	首當其衝
首次来台	首次來臺
香格里拉	香格里拉
香榭丽舍	香榭麗舍
香港电台	香港電臺
香烟不绝	香煙不絕
香烟后代	香煙後代
香熏疗法	香燻療法
香蜡纸马	香蠟紙馬
馬格里布	馬格里布
马丁尼克	馬丁尼克
马修连恩	馬修連恩
马克吐温	馬克吐溫
马克安诺	馬克安諾
马后练服	馬后練服
马头星云	馬頭星雲
马尔扎赫	馬爾扎赫
马尼托巴	馬尼托巴
马德里队	馬德里隊
马戏表演	馬戲表演
马扎尔语	馬扎爾語
马拉巴栗	馬拉巴栗
马拉松式	馬拉松式
马拉松组	馬拉松組
马拉松赛	馬拉松賽
马提尼克	馬提尼克
马斯垂克	馬斯垂剋
马格里布	馬格里布
马苏里拉	馬蘇裏拉
马蹄星云	馬蹄星雲
马里亚纳	馬里亞納
马里兰州	馬里蘭州
马面战棚	馬面戰棚
马革裹尸	馬革裹屍
驭夫有术	馭夫有術
驱恶向善	驅惡向善
驱虫效率	驅蟲效率
驱逐出境	驅逐出境
驴前马后	驢前馬後
驴蒙虎皮	驢蒙虎皮
驻车制动	駐車制動
驻颜有术	駐顏有術
驽马十舍	駑馬十舍
驾雾腾云	駕霧騰雲
驾鹤西游	駕鶴西遊
骋凶骋势	騁兇騁勢
验收规范	驗收規範
骏业宏发	駿業宏發
骏豪集团	駿豪集團
骏马雕鞍	駿馬雕鞍
骗术奇谭	騙術奇譚
骨子里头	骨子裏頭
骨干分子	骨幹分子
骨干网路	骨幹網路
骨肉团圆	骨肉團圓
骨肉团聚	骨肉團聚
骨肉团𪢮	骨肉團圞
骨质疏松	骨質疏鬆
骨里骨碌	骨裏骨碌
骺软骨板	骺軟骨板
髀肉复生	髀肉復生
高唱入云	高唱入雲
高尔察克	高爾察克
高层建筑	高層建築
高岸深谷	高岸深谷
高度自制	高度自制
高手如云	高手如雲
高抬身价	高擡身價
高歌一曲	高歌一曲
高步云衢	高步雲衢
高票当选	高票當選
高等师范	高等師範
高筋面粉	高筋麵粉
高耸入云	高聳入雲
高脂血症	高脂血症
高致病性	高致病性
高血压症	高血壓症
高血压药	高血壓藥
高血脂症	高血脂症
鬓发如银	鬢髮如銀
鬓发皆白	鬢髮皆白
鬓发皓然	鬢髮皓然
鬼出电入	鬼出電入
鬼怕恶人	鬼怕惡人
鬼气冲天	鬼氣衝天
鬼片当道	鬼片當道
魁北克市	魁北克市
魁北克省	魁北克省
魂不守舍	魂不守舍
魂牵梦系	魂牽夢繫
魏克菲尔	魏克菲爾
魔术数字	魔術數字
魔术方块	魔術方塊
鱼丸粗面	魚丸粗麵
鱼头参政	魚頭參政
鱼沈雁杳	魚沈雁杳
鱼游釜中	魚游釜中
鱼游釜底	魚游釜底
鱼篮宝卷	魚籃寶卷
鱼肉乡里	魚肉鄉里
鱼贯而出	魚貫而出
鱼鼓简板	魚鼓簡板
鲍德里亚	鮑德里亞
鲜明个性	鮮明個性
鲜血淋漓	鮮血淋漓
鳌头独占	鰲頭獨占
鳌里夺尊	鰲裏奪尊
鸟尽弓藏	鳥盡弓藏
鸟里鸟气	鳥裏鳥氣
鸟面鹄形	鳥面鵠形
鸠占鹊巢	鳩佔鵲巢
鸠形鹄面	鳩形鵠面
鸡争鹅斗	雞爭鵝鬥
鸡兔同笼	雞兔同籠
鸡口牛后	雞口牛後
鸡同鸭讲	雞同鴨講
鸡吵鹅斗	雞吵鵝鬥
鸡尸牛从	雞尸牛從
鸡犬俱升	雞犬俱升
鸡犬升天	雞犬升天
鸡皮栗子	雞皮栗子
鸡皮鹤发	雞皮鶴髮
鸡肤鹤发	雞膚鶴髮
鸡虫得失	雞蟲得失
鸣钟列鼎	鳴鐘列鼎
鸭子划水	鴨子划水
鸳鸯折颈	鴛鴦折頸
鸿案相庄	鴻案相莊
鸿篇巨制	鴻篇鉅製
鸿篇巨著	鴻篇鉅著
鸿运当头	鴻運當頭
鸿鹄之志	鴻鵠之志
鸿鹄大志	鴻鵠大志
鹄候回音	鵠候回音
鹄面鸟形	鵠面鳥形
鹄面鸠形	鵠面鳩形
鹊巢鸠占	鵲巢鳩佔
鹏程万里	鵬程萬里
鹘仑吞枣	鶻崙吞棗
鹤发童颜	鶴髮童顏
鹤发鸡皮	鶴髮雞皮
鹤骨松姿	鶴骨松姿
鹰扬万里	鷹揚萬里
鹰架栈台	鷹架棧臺
鹰状星云	鷹狀星雲
鹿车共挽	鹿車共挽
鹿门采药	鹿門采藥
麦克伦堡	麥克倫堡
麦克尼尔	麥克尼爾
麦克拉伦	麥克拉倫
麦克斯韦	麥克斯韋
麦克林登	麥克林登
麦克米兰	麥克米蘭
麦克阿瑟	麥克阿瑟
麦克雷兰	麥克雷蘭
麦可维克	麥可維克
麦特戴蒙	麥特戴蒙
麦穗两歧	麥穗兩歧
麦考马克	麥考馬克
麦达克斯	麥達克斯
麸皮面包	麩皮麵包
麻了花儿	麻了花兒
麻做一团	麻做一團
麻吉死党	麻吉死黨
麻栗坡县	麻栗坡縣
麻痹不了	麻痹不了
麻痺不了	麻痺不了
麻醉药品	麻醉藥品
麻雀在后	麻雀在後
黄卷青灯	黃卷青燈
黄发儿齿	黃髮兒齒
黄发垂髫	黃髮垂髫
黄发鲐背	黃髮鮐背
黄干黑瘦	黃乾黑瘦
黄曲毒素	黃麴毒素
黄曲霉菌	黃麴黴菌
黄梁美梦	黃樑美夢
黄毛团儿	黃毛團兒
黄沙盖面	黃沙蓋面
黄白之术	黃白之術
黄石瀑布	黃石瀑布
黄老治术	黃老治術
黄色人种	黃色人種
黄色炸药	黃色炸藥
黄花后生	黃花後生
黄莺出谷	黃鶯出谷
黄蝶翠谷	黃蝶翠谷
黄金入柜	黃金入櫃
黄金存折	黃金存摺
黄钟大吕	黃鐘大呂
黄钟毁弃	黃鐘毀棄
黄钟长弃	黃鐘長棄
黄雀在后	黃雀在後
黍谷生春	黍谷生春
黎曼几何	黎曼幾何
黎曼曲面	黎曼曲面
黑不溜秋	黑不溜秋
黑克索斯	黑克索斯
黑暗世界	黑暗世界
黑暗大陆	黑暗大陸
黑暗时代	黑暗時代
黑松汽水	黑松汽水
黑松沙士	黑松沙士
黑气冲天	黑氣沖天
黑漆一团	黑漆一團
黑漆板凳	黑漆板凳
黑色火药	黑色火藥
黑面琵鹭	黑面琵鷺
默哀致意	默哀致意
黯然欲绝	黯然欲絕
鼇头独占	鼇頭獨占
鼎食鸣钟	鼎食鳴鐘
鼓盆之戚	鼓盆之戚
鼓腹而游	鼓腹而遊
鼓足干劲	鼓足幹勁
鼠疫杆菌	鼠疫桿菌
鼠肝虫臂	鼠肝蟲臂
鼻中出火	鼻中出火
鼻头出火	鼻頭出火
鼻子里笑	鼻子裏笑
鼻无梁柱	鼻無梁柱
鼻针疗法	鼻針療法
齐名并价	齊名並價
齐后破环	齊后破環
齐头并进	齊頭並進
齐心合力	齊心合力
齐心同力	齊心同力
齐心并力	齊心併力
齐打伙儿	齊打夥兒
齐梁世界	齊梁世界
齐民要术	齊民要術
齐烟九点	齊煙九點
齐王舍牛	齊王捨牛
齐足并驰	齊足並馳
齐足并驱	齊足並驅
齐驱并驾	齊驅並駕
齐驱并骤	齊驅並驟
齧蘗吞针	齧蘗吞針
齿危发秀	齒危髮秀
齿落发白	齒落髮白
龙争虎斗	龍爭虎鬥
龙凤之表	龍鳳之表
龙困浅滩	龍困淺灘
龙岩地区	龍巖地區
龙斗虎伤	龍鬥虎傷
龙烟铁矿	龍煙鐵礦
龙虎并伏	龍虎並伏
龙龛手鉴	龍龕手鑑
龚胜不屈	龔勝不屈
龟鹤同春	龜鶴同春