〇余	〇餘
〇只	〇隻
㓦划	㓦劃
㔩叶	㔩葉
䜣合	訢合
一万	一萬
一个	一個
一个准	一個準
一了	一了
一争两丑	一爭兩醜
一伙	一夥
一余	一餘
一克	一克
一党	一黨
一冲	一衝
一准	一準
一出	一齣
一出子	一齣子
一划	一劃
一别	一別
一别头	一彆頭
一千	一千
一发	一發
一发千钧	一髮千鈞
一只	一隻
一台	一臺
一叶	一葉
一吊	一吊
一同	一同
一向	一向
一周	一週
一哄	一鬨
一哄而散	一鬨而散
一回	一回
一团	一團
一地里	一地裏
一天钟	一天鐘
一干	一干
一干二净	一乾二淨
一并	一併
一当	一當
一扎	一紮
一折	一折
一挂	一掛
一搜	一搜
一曲	一曲
一杆	一杆
一板	一板
一柜	一櫃
一树百获	一樹百穫
一涂	一塗
一物克一物	一物剋一物
一种	一種
一签	一簽
一系	一系
一致	一致
一表	一表
一里	一里
一针	一針
一锅面	一鍋麵
一面	一面
丁丑	丁丑
丁当	丁當
丁种	丁種
七万	七萬
七个	七個
七余	七餘
七出	七出
七划	七劃
七千	七千
七发	七發
七只	七隻
七回	七回
七团	七團
七彩	七彩
七情六欲	七情六慾
七扎	七紮
七折	七折
七种	七種
万	萬
万一	萬一
万万	萬萬
万丈	萬丈
万世	萬世
万个	萬個
万丹	萬丹
万乘	萬乘
万事	萬事
万人	萬人
万仞	萬仞
万代	萬代
万份	萬份
万众	萬眾
万位	萬位
万余	萬餘
万俟	万俟
万倍	萬倍
万儿	萬兒
万元	萬元
万全	萬全
万几	萬幾
万分	萬分
万劫	萬劫
万千	萬千
万华	萬華
万卷	萬卷
万历	萬曆
万县	萬縣
万古	萬古
万只	萬隻
万叶	萬葉
万名	萬名
万国	萬國
万圆	萬圓
万壑	萬壑
万夫	萬夫
万姓	萬姓
万字	萬字
万安	萬安
万家	萬家
万寿	萬壽
万山	萬山
万岁	萬歲
万峦	萬巒
万年	萬年
万年历表	萬年曆錶
万幸	萬幸
万急	萬急
万恶	萬惡
万户	萬戶
万扎	萬紮
万把	萬把
万斤	萬斤
万方	萬方
万旗	万旗
万无	萬無
万有	萬有
万望	萬望
万机	萬機
万桶	萬桶
万步	萬步
万死	萬死
万段	萬段
万点	萬點
万物	萬物
万状	萬狀
万用	萬用
万盛	萬盛
万石	萬石
万福	萬福
万种	萬種
万窍	萬竅
万端	萬端
万签插架	萬籤插架
万箱	萬箱
万籁	萬籟
万米	萬米
万缘	萬緣
万能	萬能
万般	萬般
万言	萬言
万象	萬象
万贯	萬貫
万道	萬道
万邦	萬邦
万部	萬部
万里	萬里
万重	萬重
万金	萬金
万钧	萬鈞
万锺	萬鍾
万难	萬難
万顷	萬頃
万馀	萬餘
万马	萬馬
三万	三萬
三个	三個
三余	三餘
三克	三克
三党	三黨
三冬	三冬
三准	三準
三千	三千
三只	三隻
三台	三臺
三合	三合
三同	三同
三向	三向
三周	三週
三复	三複
三尸	三尸
三征七辟	三徵七辟
三才	三才
三扎	三紮
三杆	三杆
三板	三板
三极	三極
三涂	三塗
三秋	三秋
三统历	三統曆
三舍	三舍
三苏	三蘇
三表	三表
三辟	三辟
三针	三針
三面	三面
上万	上萬
上了	上了
上党	上黨
上千	上千
上升	上升
上台	上臺
上叶	上葉
上吊	上吊
上周	上週
上回	上回
上复	上覆
上当	上當
上彩	上彩
上搜	上搜
上柜	上櫃
上梁	上樑
上游	上游
上签	上籤
上舍	上舍
上药	上藥
上蜡	上蠟
上表	上表
上课钟	上課鐘
上面	上面
下了	下了
下于	下於
下仑路	下崙路
下出	下出
下厂	下廠
下发	下發
下台	下臺
下叶	下葉
下同	下同
下周	下週
下回	下回
下彩	下彩
下才	下才
下摆	下襬
下梁	下樑
下注	下注
下游	下游
下种	下種
下签	下籤
下药	下藥
下表	下表
下课钟	下課鐘
下采	下采
下里	下里
下面	下面 下麵
不丑	不醜
不了	不了
不修	不修
不借	不借
不克	不克
不克制	不剋制
不准	不准 不準
不出	不出
不升	不升
不占	不佔
不只	不只
不合	不合
不吊	不弔
不同	不同
不向	不向
不周	不周
不复	不復
不寒而栗	不寒而慄
不尽	不盡
不干	不幹
不干不净	不乾不淨
不幸	不幸
不当	不當
不彩	不彩
不愿	不願
不才	不才
不托	不託
不折	不折
不挂	不掛
不斗	不鬭
不极	不極
不欲	不欲
不涂	不塗
不确	不確
不胜	不勝
不致	不致
不舍	不捨
不药而愈	不藥而癒
不获	不獲
不表	不表
不谷	不穀
不适	不適
不通吊庆	不通弔慶
不采	不採
不锈钢	不鏽鋼
不须	不須
不食干腊	不食乾腊
与	與
与克制	與剋制
与党	與黨
丑三	丑三
丑丑	醜醜
丑丫头	醜丫頭
丑事	醜事
丑于	醜於
丑人	醜人
丑侪	醜儕
丑八怪	醜八怪
丑剌剌	醜剌剌
丑剧	醜劇
丑化	醜化
丑史	醜史
丑名	醜名
丑咤	醜吒
丑地	醜地
丑声	醜聲
丑头怪脸	醜頭怪臉
丑夷	醜夷
丑女	醜女
丑奴儿	醜奴兒
丑妇	醜婦
丑媳	醜媳
丑小鸭	醜小鴨
丑巴怪	醜巴怪
丑年	丑年
丑徒	醜徒
丑态	醜態
丑恶	醜惡
丑日	丑日
丑旦	丑旦
丑时	丑時
丑月	丑月
丑末	醜末
丑杂	醜雜
丑样	醜樣
丑死	醜死
丑比	醜比
丑毙了	醜斃了
丑沮	醜沮
丑生	醜生
丑男	醜男
丑类	醜類
丑脸	醜臉
丑虏	醜虜
丑行	醜行
丑角	丑角
丑言	醜言
丑诋	醜詆
丑话	醜話
丑语	醜語
丑贼生	醜賊生
丑辞	醜辭
丑辱	醜辱
丑逆	醜逆
丑闻	醜聞
丑陋	醜陋
专	專
专修	專修
专制	專制
专向	專向
专征	專征
专才	專才
专摆	專擺
专柜	專櫃
专注	專注
专辑里	專輯裏
且于	且於
世仇	世仇
世台	世臺
世界杯	世界杯
世界里	世界裏
世系	世系
世纪钟	世紀鐘
世表	世表
世面	世面
丙种	丙種
丙舍	丙舍
业	業
业余	業餘
业种	業種
丛	叢
东	東
东伙	東夥
东冲西突	東衝西突
东升	東昇
东厂	東廠
东向	東向
东周	東周
东周钟	東周鐘
东岳	東嶽
东干	東干
东征	東征
东游	東遊
东胡	東胡
东蒙	東蒙
东面	東面
丝	絲
丝发	絲髮
丝布	絲布
丝恩发怨	絲恩髮怨
丝杆	絲桿
丝板	絲板
丝线	絲綫
丝虫	絲蟲
丢	丟
丢丑	丟醜
丢了	丟了
两	兩
两万	兩萬
两个	兩個
两余	兩餘
两克	兩克
两党	兩黨
两千	兩千
两只	兩隻
两台	兩臺
两叶	兩葉
两周	兩週
两回	兩回
两天晒网	兩天曬網
两扎	兩紮
两杆	兩杆
两板	兩板
两极	兩極
两种	兩種
两虎共斗	兩虎共鬭
两面	兩面
两鼠斗穴	兩鼠鬭穴
严	嚴
严于	嚴於
严冬	嚴冬
严制	嚴制
严复	嚴復
严恶	嚴惡
丧	喪
丧志	喪志
丧钟	喪鐘
个	個
个个	個個
个中	箇中
个中原因	箇中原因
个中奥妙	箇中奧妙
个中奥秘	箇中奧祕
个中好手	箇中好手
个中强手	箇中強手
个中消息	箇中消息
个中滋味	箇中滋味
个中玄机	箇中玄機
个中理由	箇中理由
个中讯息	箇中訊息
个中资讯	箇中資訊
个中高手	箇中高手
个事	個事
个人	個人
个位	個位
个体	個體
个例	個例
个儿	個兒
个别	個別
个头	個頭
个子	個子
个展	個展
个性	個性
个把	個把
个数	個數
个旧	個舊
个样	個樣
个案	個案
个里	個裏
个钟	個鐘
个钟表	個鐘錶
中于	中於
中云	中雲
中仑	中崙
中叶	中葉
中型钟	中型鐘
中岳	中嶽
中彩	中彩
中恶	中惡
中才	中才
中搜	中搜
中文里	中文裏
中板	中板
中极	中極
中涂	中塗
中游	中游
中秋	中秋
中签	中籤
中胡	中胡
中药	中藥
中表	中表
丰	豐
丰下	豐下
丰业	豐業
丰乐	豐樂
丰产	豐產
丰仪	丰儀
丰伟	豐偉
丰儀	丰儀
丰功	豐功
丰华	豐華
丰南	丰南
丰厚	豐厚
丰原	豐原
丰台	丰台
丰壤	豐壤
丰奢	豐奢
丰妍	豐妍
丰姿	丰姿
丰实	豐實
丰容	丰容
丰富	豐富
丰年	豐年
丰度	丰度
丰悴	豐悴
丰情	丰情
丰收	豐收
丰本	豐本
丰杀	豐殺
丰标	丰標
丰標不凡	丰標不凡
丰歉	豐歉
丰殖	豐殖
丰沛	豐沛
丰注	豐注
丰润	豐潤
丰满	豐滿
丰滨	豐濱
丰炽	豐熾
丰熟	豐熟
丰田	豐田
丰登	豐登
丰盈	豐盈
丰盛	豐盛
丰硕	豐碩
丰碑	豐碑
丰神	丰神
丰稔	豐稔
丰穰	豐穰
丰美	豐美
丰耗	豐耗
丰肌	豐肌
丰胸	豐胸
丰腆	豐腆
丰腴	豐腴
丰茂	豐茂
丰茸	丰茸
丰草	豐草
丰蔚	豐蔚
丰衍	豐衍
丰裕	豐裕
丰赡	豐贍
丰足	豐足
丰采	丰采
丰镐	豐鎬
丰隆	豐隆
丰韵	丰韻
丰韻	丰韻
丰颊	豐頰
丰饶	豐饒
串同	串同
串哄	串哄
串游	串游
临	臨
临了	臨了
临别	臨別
临制	臨制
临幸	臨幸
临潼斗宝	臨潼鬭寶
丸药	丸藥
丹参	丹參
丹台	丹臺
丹干	丹干
丹朱	丹朱
丹药	丹藥
为	爲
为准	爲準
为着	爲着
为鉴	爲鑒
主仆	主僕
主修	主修
主干	主幹
主钟曲线	主鐘曲綫
丽	麗
丽于	麗於
举	舉
举了	舉了
举出	舉出
举发	舉發
久别	久別
么么小丑	么麼小丑
么娘	麼娘
义	義
义仆	義僕
义占	義佔
义庄	義莊
之于	之於
之余	之餘
之后	之後
之征	之徵
之托	之託
之秋	之秋
之鉴	之鑒
之钟	之鐘
乌	烏
乌云	烏雲
乌发	烏髮
乌合	烏合
乌松	烏松
乌涂	烏塗
乌苏	烏蘇
乌药	烏藥
乌获	烏獲
乌龙面	烏龍麵
乏困	乏困
乐	樂
乐于	樂於
乐器钟	樂器鐘
乐团	樂團
乐坛	樂壇
乐曲	樂曲
乔	喬
乔岳	喬嶽
乔志	喬志
乔才	喬才
乔松	喬松
乖别	乖別
乘了	乘了
乘云	乘雲
乘胜	乘勝
乙丑	乙丑
乙种	乙種
九万	九萬
九世之仇	九世之讎
九个	九個
九余	九餘
九冬	九冬
九划	九劃
九千	九千
九只	九隻
九合	九合
九扎	九紮
九折	九折
九秋	九秋
九谷	九穀
九针	九針
也克制	也剋制
也向	也向
也须	也須
习	習
习于	習於
乡	鄉
乡党	鄉黨
乡团	鄉團
乡愿	鄉愿
乡曲	鄉曲
乡里	鄉里
乡面	鄉面
书	書
书卷	書卷
书后	書後
书录	書錄
书柜	書櫃
书种	書種
书签	書籤
书虫	書蟲
书面	書面
乩坛	乩壇
买	買
买了	買了
买价	買價
买凶	買兇
买回	買回
乱	亂
乱了	亂了
乱党	亂黨
乱发	亂髮
乱哄	亂鬨
乱涂	亂塗
乳娘	乳孃
乾象历	乾象曆
了了	了了
了事	了事
了亮	瞭亮
了债	了債
了儿	了兒
了克制	了剋制
了决	了決
了劣	了劣
了却	了卻
了如	瞭如
了局	了局
了帐	了帳
了当	了當
了得	了得
了悟	了悟
了愿	了願
了手	了手
了收	了收
了断	了斷
了无	了無
了望	瞭望
了案	了案
了毕	了畢
了清	了清
了然	瞭然
了纳	了納
了结	了結
了若指掌	瞭若指掌
了落	了落
了解	瞭解
了讫	了訖
了话	了話
了语	了語
了账	了賬
了鸟	了鳥
争	爭
争了	爭了
争出	爭出
争奇斗妍	爭奇鬭妍
争奇斗异	爭奇鬭異
争妍斗奇	爭妍鬭奇
争斗	爭鬭
争红斗紫	爭紅鬭紫
争胜	爭勝
事发	事發
事后	事後
事迹	事蹟
二万	二萬
二个	二個
二仑	二崙
二价	二價
二余	二餘
二划	二劃
二千	二千
二只	二隻
二周	二周
二回	二回
二娘	二孃 二娘
二志	二志
二板	二板
二极	二極
二柜	二櫃
二种	二種
二缶钟惑	二缶鐘惑
二胡	二胡
二致	二致
二苏	二蘇
二里	二里
于	於
于一	於一
于七	於七
于三	於三
于丑	於醜
于世	於世
于丹	于丹
于之	於之
于乎	於乎
于乐	於樂
于九	於九
于事	於事
于二	於二
于于	于于
于五	於五
于人	於人
于仁泰	于仁泰
于今	於今
于从濂	于從濂
于他	於他
于伏	於伏
于会泳	于會泳
于伟国	于偉國
于何	於何
于余曲折	于餘曲折
于你	於你
于佳卉	于佳卉
于偉國	于偉國
于光远	于光遠
于光遠	于光遠
于克制	於剋制
于克勒	于克勒
于八	於八
于六	於六
于冕	于冕
于军	于軍
于农	於農
于凌奎	于凌奎
于凤桐	于鳳桐
于凤至	于鳳至
于前	於前
于劣	於劣
于勒	于勒
于勤	於勤
于化虎	于化虎
于十	於十
于半	於半
于占元	于占元
于双戈	于雙戈
于台烟	于台煙
于台煙	于台煙
于右任	于右任
于吉	于吉
于后	於後
于品海	于品海
于嗟	于嗟
于四	於四
于国	於國
于国桢	于國楨
于國楨	于國楨
于坏	於坏
于坚	于堅
于垂	於垂
于堅	于堅
于墙	於牆
于大宝	于大寶
于大寶	于大寶
于天仁	于天仁
于奇库杜克	于奇庫杜克
于奇庫杜克	于奇庫杜克
于她	於她
于好	於好
于始	於始
于姓	于姓
于娜	于娜
于娟	于娟
于子千	于子千
于孔兼	于孔兼
于学忠	于學忠
于學忠	于學忠
于它	於它
于家	於家
于家堡	于家堡
于密	於密
于寘	于寘
于小伟	于小偉
于小偉	于小偉
于小彤	于小彤
于尔岑	于爾岑
于尔根	于爾根
于尔里克	于爾里克
于尽	於盡
于山	于山
于左	於左
于差	於差
于己	於己
于市	於市
于帅	于帥
于帥	于帥
于幕	於幕
于幼军	于幼軍
于幼軍	于幼軍
于广洲	于廣洲
于康震	于康震
于廣洲	于廣洲
于式枚	于式枚
于弱	於弱
于强	於強
于归	于歸
于征	於徵
于徐	于徐
于從濂	于從濂
于德海	于德海
于心	於心
于志宁	于志寧
于志寧	于志寧
于怀	於懷
于思	于思
于慎行	于慎行
于慧	于慧
于戏	於戲
于成龍	于成龍
于成龙	于成龍
于我	於我
于振	于振
于敏	于敏
于敝	於敝
于斌	于斌
于斯	於斯
于斯塔德	于斯塔德
于斯达尔	于斯達爾
于斯達爾	于斯達爾
于时	於時
于明涛	于明濤
于明濤	于明濤
于是	於是
于是之	于是之
于晨楠	于晨楠
于晴	于晴
于會泳	于會泳
于树洁	于樹潔
于根伟	于根偉
于根偉	于根偉
于格	于格
于樂	于樂
于樹潔	于樹潔
于欣源	于欣源
于正升	于正昇
于正昇	于正昇
于正昌	于正昌
于此	於此
于毕	於畢
于民	於民
于水	於水
于永波	于永波
于汉超	于漢超
于江震	于江震
于法	於法
于波	于波
于泽尔	于澤爾
于洪区	于洪區
于洪區	于洪區
于浩威	于浩威
于海洋	于海洋
于涛	于濤
于湘兰	于湘蘭
于湘蘭	于湘蘭
于漢超	于漢超
于澤爾	于澤爾
于濤	于濤
于火	於火
于焉	於焉
于爾岑	于爾岑
于爾根	于爾根
于爾里克	于爾里克
于物	於物
于特森	于特森
于玉立	于玉立
于田	于田
于盲	於盲
于祂	於祂
于禁	于禁
于秀敏	于秀敏
于穆	於穆
于素秋	于素秋
于终	於終
于美	於美
于美人	于美人
于色	於色
于若木	于若木
于荫霖	于蔭霖
于菟	於菟
于蓝	於藍
于蔭霖	于蔭霖
于行	於行
于衡	于衡
于衷	於衷
于西翰	于西翰
于謙	于謙
于该	於該
于谦	于謙
于貝爾	于貝爾
于贈	于贈
于贝尔	于貝爾
于赠	于贈
于越	于越
于軍	于軍
于过	於過
于远伟	于遠偉
于途	於途
于道泉	于道泉
于遠偉	于遠偉
于邑	於邑
于都县	于都縣
于都縣	于都縣
于里察	于里察
于野	於野
于阗	于闐
于陆	於陸
于雙戈	于雙戈
于震寰	于震寰
于震环	于震環
于震環	于震環
于靖	于靖
于非闇	于非闇
于韋斯屈萊	于韋斯屈萊
于韦斯屈莱	于韋斯屈萊
于風政	于風政
于风政	于風政
于飞	于飛
于鳳桐	于鳳桐
于鳳至	于鳳至
于默奥	于默奧
于默奧	于默奧
亏	虧
亏了	虧了
亏折	虧折
云	雲
云中	雲中
云为	云爲
云乎	云乎
云云	云云
云何	云何
云冈	雲岡
云华	雲華
云南	雲南
云南白药	雲南白藥
云吞	雲吞
云天	雲天
云头	雲頭
云子	雲子
云孙	雲孫
云实	雲實
云室	雲室
云尔	云爾
云层	雲層
云屏	雲屏
云山	雲山
云岭	雲嶺
云峰	雲峰
云师	雲師
云帚	雲帚
云彩	雲彩
云影	雲影
云房	雲房
云手	雲手
云扰	雲擾
云散	雲散
云景	雲景
云朵	雲朵
云杉	雲杉
云板	雲板
云林	雲林
云栈	雲棧
云根	雲根
云梢	雲梢
云梯	雲梯
云步	雲步
云母	雲母
云气	雲氣
云水	雲水
云汉	雲漢
云河	雲河
云泥	雲泥
云海	雲海
云涛	雲濤
云液	雲液
云游	雲遊
云烟	雲煙
云然	云然
云版	雲版
云物	雲物
云石	雲石
云章	雲章
云端	雲端
云笈七签	雲笈七籤
云篦	雲篦
云精	雲精
云翳	雲翳
云肩	雲肩
云腿	雲腿
云芝	雲芝
云英	雲英
云表	雲表
云谷	雲谷
云豆	雲豆
云贵	雲貴
云路	雲路
云车	雲車
云量	雲量
云锣	雲鑼
云锦	雲錦
云门	雲門
云阳	雲陽
云际	雲際
云雀	雲雀
云集	雲集
云雨	雲雨
云雾	雲霧
云霄	雲霄
云霓	雲霓
云霞	雲霞
云顶	雲頂
云须	雲鬚
云髻	雲髻
云鬓	雲鬢
云鬟	雲鬟
云龙	雲龍
互于	互於
互制	互制
互发	互發
互向	互向
互鉴	互鑒
五万	五萬
五个	五個
五余	五餘
五克	五克
五党	五黨
五出	五齣
五划	五劃
五千	五千
五发	五發
五只	五隻
五台	五臺
五叶	五葉
五周	五週
五岳	五嶽
五彩	五彩
五扎	五紮
五折	五折
五板	五板
五种	五種
五胡	五胡
五脏	五臟
五虫	五蟲
五行生克	五行生剋
五谷	五穀
五辟	五辟
五采	五采
五里	五里
五面	五面
井台	井臺
井干	井榦
井干摧败	井榦摧敗
井里	井裏
亚	亞
亚于	亞於
亚当	亞當
亚美尼亚历	亞美尼亞曆
些个	些個
些须	些須
亟欲	亟欲
亟须	亟須
亡了	亡了
交个	交個
交了	交了
交于	交於
交出	交出
交卷	交卷
交发	交發
交合	交合
交哄	交鬨
交回	交回
交困	交困
交恶	交惡
交托	交託
交游	交遊
交面	交面
亦云	亦云
亦同	亦同
亦庄亦谐	亦莊亦諧
亦当	亦當
亦须	亦須
产	產
产出	產出
产后	產後
亩	畝
享御	享御
京胡	京胡
亭台	亭臺
亭彩	亭彩
亮丑	亮醜
亮了	亮了
亮钟	亮鐘
亲	親
亲历	親歷
亲娘	親孃
亲幸	親倖
亲征	親征
亲戚	親戚
亲系	親系
亵	褻
人云	人云
人参	人蔘
人后	人後
人才	人才
人杰	人傑
人极	人極
人欲	人慾
人烟	人煙
人物志	人物誌
人种	人種
人链	人鏈
人面	人面
亿	億
亿万	億萬
亿个	億個
亿余	億餘
亿只	億隻
什么	什麼
什锦面	什錦麵
什面	什面
仁术	仁術
仅	僅
仅只	僅只
仆人	僕人
仆仆	僕僕
仆从	僕從
仆使	僕使
仆倒	仆倒
仆僮	僕僮
仆吏	僕吏
仆固怀恩	僕固懷恩
仆地	仆地
仆夫	僕夫
仆妇	僕婦
仆姑	僕姑
仆婢	僕婢
仆射	僕射
仆少	僕少
仆役	僕役
仆憎	僕憎
仆欧	僕歐
仆然	仆然
仆程	僕程
仆虽罢驽	僕雖罷駑
仇人	仇人
仇仇	仇讎
仇偶	仇偶
仇問	讎問
仇夷	讎夷
仇家	仇家
仇怨	仇怨
仇恨	仇恨
仇敌	仇敵
仇杀	仇殺
仇校	讎校
仇正	讎正
仇英	仇英
仇视	仇視
仇隙	讎隙
仇香	仇香
今冬	今冬
今后	今後
介于	介於
介虫	介蟲
介面	介面
仍复	仍復
从	從
从于	從於
从里到外	從裏到外
从里向外	從裏向外
仑	侖
仑琴	侖琴
仑背	崙背
仓	倉
他了	他了
他克制	他剋制
他出	他出
他志	他志
他种	他種
他钟	他鐘
仗托	仗托
付了	付了
付出	付出
付合	付合
付托	付託
仙后	仙后
仙坛	仙壇
仙岩	仙岩
仙才	仙才
仙术	仙術
仙游	仙遊
仙药	仙藥
仟克	仟克
仡栗	仡栗
代价	代價
代出	代出
代录	代錄
代签	代簽
代表	代表
以后	以後
以致	以致
仪	儀
仪制	儀制
仪注	儀注
仪范	儀範
仪表	儀表 儀錶
们	們
们克制	們剋制
仰药	仰藥
仰面	仰面
仲冬	仲冬
仲秋	仲秋
件钟	件鐘
价	價
价位	價位
价值	價值
价单	價單
价差	價差
价格	價格
价款	價款
价比	價比
价目	價目
价码	價碼
价钱	價錢
任于	任於
任何表	任何錶
任何钟	任何鐘
仿佛	彷彿
仿制	仿製
企划	企劃
伊于湖底	伊于湖底
伊周	伊周
伊府面	伊府麵
伊斯兰历	伊斯蘭曆
伊斯兰教历	伊斯蘭教曆
伊郁	伊鬱
伏几	伏几
伏尸	伏屍
伏愿	伏願
伏胜	伏勝
休克	休克
休征	休徵
休戚	休戚
休致	休致
众	眾
优	優
优于	優於
优游	優遊
优胜	優勝
伙伕	伙伕
伙众	夥眾
伙伴	夥伴
伙办	夥辦
伙友	夥友
伙同	夥同
伙够	夥够
伙夫	伙夫
伙头	伙頭
伙房	伙房
伙计	夥計
伙食	伙食
会	會
会个	會個
会了	會了
会于	會於
会党	會黨
会出	會出
会升	會升
会占	會佔
会发	會發
会合	會合
会吊	會弔
会同	會同
会后	會後
会尽	會盡
会干	會幹
会当	會當
会种	會種
会里	會裏
会面	會面
会须	會須
伛	傴
伞	傘
伟	偉
传	傳
传于	傳於
传位于四太子	傳位于四太子
传出	傳出
传发	傳發
传回	傳回
传布	傳布
传板	傳板
传种	傳種
传舍	傳舍
传赞	傳贊
伤	傷
伤了	傷了
伤痕累累	傷痕累累
伤药	傷藥
伥	倀
伦	倫
伧	傖
伪	僞
伪药	僞藥
伫	佇
伯余	伯余
伯克	伯克
伯娘	伯孃
估价	估價
伴娘	伴娘
伴游	伴遊
伸出	伸出
伸向	伸向
伸回	伸回
伸志	伸志
似于	似於
但云	但云
但愿	但願
但曲	但曲
但须	但須
位于	位於
位准	位準
低了	低了
低于	低於
低价	低價
低回	低迴
低洼	低洼
低荡	低盪
低谷	低谷
住个	住個
住扎	住紮
体	體
体制	體制
体坛	體壇
体系	體系
体范	體範
体表	體表
体面	體面
何尝	何嘗
何干	何干
何当	何當
何极	何極
何种	何種
何须	何須
余〇	餘〇
余一	餘一
余七	餘七
余三	餘三
余下	餘下
余业	餘業
余九	餘九
余事	餘事
余二	餘二
余五	餘五
余人	餘人
余众	餘眾
余余	余余
余俗	餘俗
余倍	餘倍
余僇	餘僇
余光	餘光
余党	餘黨
余八	餘八
余六	餘六
余兴	餘興
余刃	餘刃
余切	餘切
余利	餘利
余割	餘割
余力	餘力
余勇	餘勇
余十	餘十
余味	餘味
余响	餘響
余喘	餘喘
余四	餘四
余地	餘地
余墨	餘墨
余声	餘聲
余外	餘外
余妙	餘妙
余姓	余姓
余姚	餘姚
余威	餘威
余子	餘子
余存	餘存
余孽	餘孽
余庆	餘慶
余弦	餘弦
余思	餘思
余悸	餘悸
余数	餘數
余明	餘明
余映	餘映
余晖	餘暉
余暇	餘暇
余月	余月
余杭	餘杭
余杯	餘杯
余桃	餘桃
余桶	餘桶
余款	餘款
余步	餘步
余殃	餘殃
余毒	餘毒
余气	餘氣
余沥	餘瀝
余波	餘波
余波荡漾	餘波盪漾
余泽	餘澤
余温	餘溫
余烈	餘烈
余烬	餘燼
余热	餘熱
余珍	餘珍
余生	餘生
余窍	餘竅
余粮	餘糧
余绪	餘緒
余缺	餘缺
余罪	餘罪
余羡	餘羨
余膏	餘膏
余荫	餘蔭
余蓄	餘蓄
余裕	餘裕
余角	餘角
余论	餘論
余貾	餘貾
余责	餘責
余车	余車
余辉	餘輝
余辜	餘辜
余酲	餘酲
余闰	餘閏
余闲	餘閒
余零	餘零
余震	餘震
余霞	餘霞
余音	餘音
余音绕梁	餘音繞梁
余韵	餘韻
余额	餘額
余风	餘風
余食	餘食
佚游	佚遊
佚荡	佚蕩
佛曲	佛曲
佛罗棱萨	佛羅棱薩
佛钟	佛鐘
作了	作了
作价	作價
作准	作準
作出	作出
作别	作別
作品里	作品裏
作奸犯科	作姦犯科
作幸	作倖
作庄	作莊
作恶	作惡
作曲	作曲
佞幸	佞幸
你克制	你剋制
你才子发昏	你纔子發昏
你搜	你搜
佣中佼佼	傭中佼佼
佣书	傭書
佣人	傭人
佣仆	傭僕
佣作	傭作
佣保	傭保
佣兵	傭兵
佣工	傭工
佣懒	傭懶
佣给	傭給
佣耕	傭耕
佣金	佣金
佣钱	佣錢
佣钿	佣鈿
佥	僉
佥同	僉同
佩挂	佩掛
佳冬	佳冬
佳肴	佳肴
佳致	佳致
佳里	佳里
使其斗	使其鬭
使出	使出
使团	使團
侍仆	侍僕
侍御	侍御
供出	供出
供制	供製
依依不舍	依依不捨
依托	依託
依据	依據
依赞	依贊
侠	俠
侣	侶
侥	僥
侥幸	僥倖
侦	偵
侧	側
侧向	側向
侧录	側錄
侧面	側面
侨	僑
侨团	僑團
侨汇	僑匯
侩	儈
侪	儕
侬	儂
侮蔑	侮蔑
侵占	侵佔
侵哄	侵哄
侵并	侵併
便了	便了
便于	便於
便当	便當
便药	便藥
便辟	便辟
便面	便面
便须	便須
促发	促發
俄占	俄佔
俊刮	俊刮
俊杰	俊傑
俊游	俊遊
俘获	俘獲
俚曲	俚曲
保准	保准
保险柜	保險柜
信个	信個
信托	信託
信据	信據
信汇	信匯
俣	俁
俦	儔
俨	儼
俩	倆
俪	儷
俪采	儷采
俭	儉
俭仆	儉僕
俭朴	儉樸
俭确之教	儉确之教
修业	修業
修习	修習
修书	修書
修仙	修仙
修修	修修
修养	修養
修函	修函
修到	修到
修剪	修剪
修史	修史
修名	脩名
修和	修和
修墓	修墓
修士	修士
修复	修復
修女	修女
修好	修好
修学	修學
修定	修定
修宪	修憲
修容	修容
修己	修己
修建	修建
修得	修得
修成	修成
修护	修護
修持	修持
修撰	修撰
修改	修改
修敬	脩敬
修整	修整
修文	修文
修斋	修齋
修明	修明
修杰楷	修杰楷
修枝	修枝
修樾	脩樾
修正	修正
修水	修水
修治	修治
修润	脩潤
修濬	修濬
修炼	修煉
修版	修版
修理	修理
修的	修的
修盖	修蓋
修省	修省
修眉	修眉
修睦	修睦
修短	修短
修竹	修竹
修筑	修築
修练	修練
修缮	修繕
修罗	修羅
修耕	修耕
修胡刀	修鬍刀
修脚	修腳
修脯	脩脯
修葺	修葺
修行	修行
修补	修補
修褉	修褉
修订	修訂
修课	修課
修谱	修譜
修起	修起
修路	修路
修蹄	修蹄
修身	修身
修辞	修辭
修边	修邊
修造	修造
修道	修道
修配	修配
修金	脩金
修链	修鍊
修长	修長
修阻	修阻
修面	修面
修饰	修飾
修齐	修齊
修龄	修齡
俯冲	俯衝
俯曲	俯曲
俱发	俱發
倒了	倒了
倒价	倒價
倒出	倒出
倒台	倒臺
倒吊	倒吊
倒向	倒向
倒回	倒回
倒彩	倒彩
倒挂	倒掛
倒板	倒板
倒绷孩儿	倒繃孩兒
候虫	候蟲
倚托	倚托
倛丑	倛醜
借个	借個
借主	借主
借书	借書
借了	借了
借人	借人
借代	借代
借令	借令
借以	藉以
借位	借位
借住	借住
借作	借作
借使	借使
借借	藉藉
借债	借債
借光	借光
借典	借典
借出	借出
借到	借到
借券	借券
借助	藉助
借势	借勢
借卉	藉卉
借单	借單
借去	借去
借口	藉口
借名	借名
借唱	借唱
借喻	借喻
借回	借回
借地	借地
借坐	借坐
借契	借契
借好	借好
借妻	借妻
借字	借字
借完	借完
借宿	借宿
借寇兵	藉寇兵
借对	借對
借寿	借壽
借弹	借彈
借得	借得
借手	藉手
借托	借托
借抄	借抄
借抽	借抽
借招	借招
借据	借據
借提	借提
借支	借支
借放	借放
借故	藉故
借方	借方
借有	借有
借机	藉機
借条	借條
借来	借來
借槁	藉槁
借款	借款
借此	藉此
借满	借滿
借火	借火
借点	借點
借球	借球
借甚	藉甚
借用	借用
借由	藉由
借的	借的
借看	借看
借着	藉着
借穿	借穿
借端	藉端
借箸	借箸
借箸代筹	藉箸代籌
借约	借約
借给	借給
借让	借讓
借讬	借託
借词	藉詞 借詞
借读	借讀
借调	借調
借贷	借貸
借资	藉資
借走	借走
借过	借過
借道	借道
借重	借重
借鉴	借鑒
借鑑	借鑑
借钱	借錢
借镜	借鏡
借问	借問
借阅	借閱
借韵	借韻
借题	借題
倦游	倦遊
倮虫	倮蟲
债	債
倾	傾
倾出	傾出
倾向	傾向
倾复	傾複
倾注	傾注
偃仆	偃仆
偃松	偃松
假借	假借
假发	假髮
假叶	假葉
假托	假託
假药	假藥
假面	假面
偎干	偎乾
偏了	偏了
偏于	偏於
偏出	偏出
偏后	偏後
偏向	偏向
偏回	偏回
偏幸	偏倖
偏才	偏才
偏暗	偏暗
偕同	偕同
做了	做了
做出	做出
做庄	做莊
停了	停了
停云	停雲
停制	停製
停尸	停屍
停当	停當
停征	停徵
停摆	停擺
停板	停板
停表	停表
偢采	偢采
偬	傯
偶发	偶發
偶合	偶合
偷了	偷了
偷出	偷出
偷发	偷發
偷回	偷回
偷种	偷種
偷鸡不着	偷雞不着
偻	僂
偾	僨
偿	償
偿回	償回
偿愿	償願
傅岩	傅巖
傅彩	傅彩
傍系	傍系
傒幸	傒倖
傢伙	傢伙
傥	儻
傥荡	儻蕩
傧	儐
储	儲
傩	儺
催并	催併
傲霜斗雪	傲霜鬭雪
傻里傻气	傻裏傻氣
像赞	像贊
僦舍	僦舍
僮仆	僮僕
僮御	僮御
僵事	僵事
僵仆	僵仆
僵住	僵住
僵冷	僵冷
僵化	僵化
僵固	僵固
僵尸	殭屍
僵局	僵局
僵持	僵持
僵掉	僵掉
僵死	僵死
僵直	僵直
僵硬	僵硬
僵立	僵立
僵臥	僵臥
僵蚕	殭蠶
儌幸	儌倖
儒术	儒術
儒略历	儒略曆
儒略改革历	儒略改革曆
儿	兒
兀术	兀朮
允准	允准
允当	允當
元凶	元兇
元后	元后
元恶	元惡
元曲	元曲
兄台	兄臺
充发	充發
充当	充當
充饥	充飢
兆个	兆個
兆余	兆餘
先了	先了
先于	先於
先借	先借
先出	先出
先占	先佔
先发	先發
先后	先後 先后
先向	先向
先回	先回
先尝	先嚐
先签	先簽
先采	先採
光了	光了
光价	光價
光合	光合
光向	光向
光复	光復
光彩	光彩
光杆	光桿
光纤	光纖
光致致	光緻緻
光表	光表
光采	光采
光面	光面
克俭	克儉
克利	克利
克制	克制
克制不了	剋制不了
克制不住	剋制不住
克剥	剋剝
克勤	克勤
克化	剋化
克啬	剋嗇
克复	克復
克夫	剋夫
克宁	克寧
克定	克定
克家	克家
克尔	克爾
克尽	克盡
克己	克己
克强	克強
克意	剋意
克扣	剋扣
克拉	克拉
克捷	克捷
克敌	克敵
克日	剋日
克明	克明
克星	剋星
克服	克服
克期	剋期
克柔	克柔
克核	剋核
克死	剋死
克汗	克汗
克药	克藥
克莱	克萊
克落	剋落
克薄	剋薄
克让	克讓
克谐	克諧
克郎	克郎
克里	克里
克难	克難
克食	克食
免于	免於
免参	免參
免征	免徵
兑	兌
兖	兗
党	黨
党义	黨義
党争	黨爭
党产	黨產
党人	黨人
党伍	黨伍
党內	黨內
党军	黨軍
党刊	黨刊
党务	黨務
党参	黨蔘
党友	黨友
党史	黨史
党名	黨名
党员	黨員
党团	黨團
党国	黨國
党外	黨外
党太尉	党太尉
党委	黨委
党工	黨工
党徒	黨徒
党徽	黨徽
党怀英	党懷英
党性	黨性
党报	黨報
党政	黨政
党旗	黨旗
党校	黨校
党格	黨格
党棍	黨棍
党歌	黨歌
党法	黨法
党派	黨派
党祸	黨禍
党禁	黨禁
党章	黨章
党籍	黨籍
党纪	黨紀
党纲	黨綱
党组	黨組
党羽	黨羽
党职	黨職
党营	黨營
党见	黨見
党言	黨言
党论	黨論
党证	黨證
党课	黨課
党费	黨費
党进	党進
党部	黨部
党锢	黨錮
党阀	黨閥
党鞭	黨鞭
党項	党項
党项	党項
党风	黨風
党魁	黨魁
党龄	黨齡
入伙	入夥
入党	入黨
入冬	入冬
入团	入團
入帘	入簾
入托	入托
入秋	入秋
入舍	入舍
入药	入藥
內出	內出
內制	內製
內参	內參
內台	內臺
內向	內向
內哄	內鬨
內奸	內奸
內戚	內戚
內才	內才
內斗	內鬭
內纤	內縴
內脏	內臟
內蒙	內蒙
內里	內裏
內面	內面
全党	全黨
全出	全出
全台	全臺
全向	全向
全尸	全屍
全干	全乾
全当	全當
全录	全錄
全彩	全綵
全才	全才
全胜	全勝
全面	全面
八万	八萬
八个	八個
八余	八餘
八克	八克
八千	八千
八厂	八廠
八只	八隻
八台	八臺
八周	八週
八字胡	八字鬍
八扎	八紮
八折	八折
八极	八極
八蜡	八蜡
八表	八表
八辟	八辟
八里	八里
八面	八面
公了	公了
公仆	公僕
公仔面	公仔麵
公价	公價
公余	公餘
公克	公克
公出	公出
公制	公制
公升	公升
公历	公曆
公厘	公釐
公合	公合
公同	公同
公布	公布
公干	公幹
公据	公據
公斗	公斗
公里	公里
六万	六萬
六个	六個
六余	六餘
六冲	六衝
六出	六齣
六划	六劃
六千	六千
六厂	六廠
六发	六發
六只	六隻
六合	六合
六周	六週
六回	六回
六彩	六彩
六扎	六紮
六折	六折
六曲	六曲
六极	六極
六欲	六欲
六种	六種
六谷	六穀
六面	六面
兰	蘭
兰台	蘭臺
兰秋	蘭秋
共价	共價
共党	共黨
共出	共出
共同	共同
共和历	共和曆
共摆	共擺
共获	共獲
关	關
关个	關個
关了	關了
关于	關於
关出	關出
关合	關合
关同	關同
关回	關回
关弓与我确	關弓與我确
关征	關征
关注	關注
关系	關係
关系着	關係着
兴	興
兴修	興修
兴复	興復
兴尽	興盡
兴筑	興築
兴致	興致
兵制	兵制
兵团	兵團
兵种	兵種
其余	其餘
其后	其後
典借	典借
典制	典制
典当	典當
典据	典據
典范	典範
兹	茲
养	養
养了	養了
养娘	養娘
养志	養志
兼了	兼了
兼修	兼修
兼并	兼併
兽	獸
兽欲	獸慾
冁	囅
内	內
内制	內製
内哄	內鬨
内斗	內鬭
冈	岡
冊叶	冊葉
册	冊
再于	再於
再借	再借
再出	再出
再向	再向
再回	再回
再种	再種
冒了	冒了
冒出	冒出
冒升	冒升
冒烟	冒煙
冗余	冗餘
写	寫
写个	寫個
写了	寫了
写出	寫出
写回	寫回
写字台	寫字檯
军	軍
军制	軍制
军团	軍團
军种	軍種
军队克制	軍隊剋制
农	農
农历	農曆
农庄	農莊
农民历	農民曆
农舍	農舍
农药	農藥
冤仇	冤讎
冥蒙	冥濛
冬事	冬事
冬令	冬令
冬储	冬儲
冬冬	鼕鼕
冬冬鼓	鼕鼕鼓
冬凌	冬凌
冬初	冬初
冬天	冬天
冬天里	冬天裏
冬季	冬季
冬学	冬學
冬山	冬山
冬心	冬心
冬日	冬日
冬日里	冬日裏
冬暖	冬暖
冬月	冬月
冬游	冬遊
冬灌	冬灌
冬烘	冬烘
冬狩	冬狩
冬瓜	冬瓜
冬眠	冬眠
冬笋	冬筍
冬粉	冬粉
冬耕	冬耕
冬至	冬至
冬节	冬節
冬菇	冬菇
冬藏	冬藏
冬衣	冬衣
冬装	冬裝
冬赈	冬賑
冬闲	冬閒
冬防	冬防
冬雨	冬雨
冬雪	冬雪
冬雾	冬霧
冬青	冬青
冬风	冬風
冬麦	冬麥
冯	馮
冰了	冰了
冰厂	冰廠
冰岩	冰岩
冰斗	冰斗
冰柜	冰櫃
冰雕	冰雕
冲	沖
冲上	衝上
冲下	衝下
冲人	沖人
冲倒	衝倒
冲克	衝剋
冲冠	衝冠
冲冠发怒	沖冠髮怒
冲冲	沖沖
冲决	衝決
冲凉	沖涼
冲出	衝出
冲击	衝擊
冲到	衝到
冲刷	沖刷
冲刺	衝刺
冲力	衝力
冲动	衝動
冲劲	衝勁
冲印	沖印
冲压	衝壓
冲去	衝去
冲口	衝口
冲和	沖和
冲喜	沖喜
冲坏	沖壞
冲坚陷阵	衝堅陷陣
冲垮	衝垮
冲堂	衝堂
冲天	衝天
冲头阵	衝頭陣
冲州撞府	衝州撞府
冲帐	沖帳
冲年	沖年
冲床	沖床
冲开	衝開
冲弱	沖弱
冲心	衝心
冲怀	沖懷
冲扩	沖擴
冲掉	衝掉
冲撞	衝撞
冲散	衝散
冲昧	沖昧
冲服	沖服
冲末	沖末
冲杀	衝殺
冲来	衝來
冲模	沖模
冲沟	沖溝
冲泡	沖泡
冲波	衝波
冲泻	沖瀉
冲洗	沖洗
冲流	沖流
冲浪	衝浪
冲涤	沖滌
冲淡	沖淡
冲澡	沖澡
冲激	衝激
冲然	衝然
冲犯	衝犯
冲盹	衝盹
冲着	衝着
冲破	衝破
冲积	沖積
冲程	衝程
冲税	沖稅
冲突	衝突
冲线	衝綫
冲绳	沖繩
冲茶	沖茶
冲虚	沖虛
冲蚀	沖蝕
冲襟	沖襟
冲要	衝要
冲走	沖走
冲起	衝起
冲车	衝車
冲过	衝過
冲进	衝進
冲退	沖退
冲量	衝量
冲销	沖銷
冲锋	衝鋒
冲陷	衝陷
冲霄	沖霄
冲风	衝風
冲默	沖默
冲鼻	沖鼻
冲龄	沖齡
决	決
决了	決了
决志	決志
决斗	決鬭
决胜	決勝
况	況
冶游	冶遊
冶炼	冶煉
冶荡	冶蕩
冷布	冷布
冷面	冷麵
冻	凍
冻僵	凍僵
净	凈
净余	淨餘
净发	淨髮
准三后	准三后
准不准	準不準
准予	准予
准伏	准伏
准会	準會
准例	準例
准保	準保
准信	准信
准假	准假
准儿	準兒
准决赛	準決賽
准分子	準分子
准则	準則
准噶尔	準噶爾
准备	準備
准头	準頭
准奏	准奏
准定	準定
准将	准將
准尉	准尉
准平原	準平原
准度	準度
准式	準式
准得	準得
准折	准折
准拟	準擬
准拿督	準拿督
准据	準據
准新娘	準新娘
准新郎	準新郎
准时	準時
准星	準星
准是	準是
准此	准此
准点	準點
准的	準的
准确	準確
准算	准算
准线	準綫
准绳	準繩
准许	准許
准话	準話
准谱	準譜
准货币	準貨幣
凉	涼
凉了	涼了
凉台	涼臺
凉药	涼藥
凉面	涼麵
凌云	凌雲
凌借	凌藉
凌蒙初	凌濛初
减	減
减个	減個
减了	減了
减价	減價
减肥药	減肥藥
凑	湊
凑出	湊出
凑合	湊合
凛	凜
凛栗	凜慄
凝合	凝合
凝炼	凝鍊
凝链	凝鍊
几	幾
几万	幾萬
几上	几上
几下	幾下
几世	幾世
几丝	几絲
几两	幾兩
几个	幾個
几乎	幾乎
几事	幾事
几于	幾於
几人	幾人
几亿	幾億
几付	幾付
几代	幾代
几令	幾令
几件	幾件
几任	幾任
几份	幾份
几伍	幾伍
几众	幾眾
几位	幾位
几何	幾何
几倍	幾倍
几儿	幾兒
几元	幾元
几克	幾克
几党	幾黨
几关	幾關
几具	幾具
几冊	幾冊
几净窗明	几淨窗明
几几	几几
几凳	几凳
几出	幾齣
几刀	幾刀
几分	幾分
几划	幾劃
几列	幾列
几副	幾副
几动	幾動
几化	幾化
几匹	幾匹
几区	幾區
几十	幾十
几千	幾千
几发	幾發
几句	幾句
几只	幾隻
几台	幾臺
几号	幾號
几吋	幾吋
几名	幾名
几员	幾員
几回	幾回
几因	幾因
几团	幾團
几国	幾國
几圆	幾圓
几圈	幾圈
几场	幾場
几块	幾塊
几垒	幾壘
几声	幾聲
几壷	幾壷
几处	幾處
几多	幾多
几大	幾大
几天	幾天
几头	幾頭
几子	几子
几孔	幾孔
几字	幾字
几季	幾季
几客	幾客
几家	幾家
几寸	幾寸
几封	幾封
几尾	幾尾
几局	幾局
几层	幾層
几届	幾屆
几岁	幾歲
几巷	幾巷
几师	幾師
几希	幾希
几席	几席
几幅	幾幅
几年	幾年
几床	幾床
几度	幾度
几座	幾座
几开	幾開
几弄	幾弄
几张	幾張
几弹	幾彈
几微	幾微
几成	幾成
几截	幾截
几户	幾戶
几所	幾所
几手	幾手
几打	幾打
几批	幾批
几拳	幾拳
几支	幾支
几斤	幾斤
几旁	几旁
几旅	幾旅
几日	幾日
几时	幾時
几星	幾星
几晚	幾晚
几曾	幾曾
几月	幾月
几期	幾期
几本	幾本
几杆	幾桿
几杖	几杖
几板	幾板
几枚	幾枚
几枝	幾枝
几枪	幾槍
几架	幾架
几栋	幾棟
几株	幾株
几样	幾樣
几格	幾格
几案	几案
几档	幾檔
几桶	幾桶
几棵	幾棵
几椅	几椅
几榻	几榻
几次	幾次
几步	幾步
几殆	幾殆
几段	幾段
几毛	幾毛
几洞	幾洞
几滴	幾滴
几点	幾點
几版	幾版
几率	幾率
几环	幾環
几班	幾班
几番	幾番
几百	幾百
几盏	幾盞
几盒	幾盒
几眼	幾眼
几碗	幾碗
几社	幾社
几票	幾票
几种	幾種
几科	幾科
几秒	幾秒
几稀	幾稀
几窝	幾窩
几站	幾站
几章	幾章
几竿	幾竿
几笔	幾筆
几笼	幾籠
几筒	幾筒
几筵	几筵
几箱	幾箱
几米	幾米
几类	幾類
几粒	幾粒
几级	幾級
几线	幾綫
几组	幾組
几经	幾經
几缕	幾縷
几罐	幾罐
几股	幾股
几胎	幾胎
几能	幾能
几脚	幾腳
几般	幾般
几节	幾節
几街	幾街
几袋	幾袋
几角	幾角
几许	幾許
几课	幾課
几谏	幾諫
几起	幾起
几趟	幾趟
几路	幾路
几车	幾車
几转	幾轉
几辆	幾輛
几近	幾近
几通	幾通
几道	幾道
几部	幾部
几针	幾針
几门	幾門
几间	幾間
几集	幾集
几面上	几面上
几页	幾頁
几顶	幾頂
几项	幾項
几顿	幾頓
几颗	幾顆
几题	幾題
几首	幾首
凡于	凡於
凡才	凡才
凡须	凡須
凤	鳳
凤占	鳳占
凫	鳧
凭	憑
凭借	憑藉
凭借着	憑藉着
凭准	憑準
凭几	憑几
凭吊	憑弔
凭折	憑摺
凭据	憑據
凯	凱
凯复	凱復
凶事	凶事
凶人	兇人
凶仪	凶儀
凶侠	凶俠
凶信	凶信
凶兆	凶兆
凶党	凶黨
凶具	兇具
凶凶	兇兇
凶刀	兇刀
凶器	兇器
凶地	凶地
凶嫌	兇嫌
凶宅	凶宅
凶岁	凶歲
凶巴巴	兇巴巴
凶年	凶年
凶徒	兇徒
凶得	兇得
凶德	凶德
凶怪	凶怪
凶恶	兇惡
凶悍	兇悍
凶惧	兇懼
凶手	兇手
凶日	凶日
凶暴	兇暴
凶服	凶服
凶杀	兇殺
凶枪	兇槍
凶案	兇案
凶横	兇橫
凶死	凶死
凶残	兇殘
凶殘	兇殘
凶殴	凶毆
凶殺	兇殺
凶气	凶氣
凶焰	兇焰
凶煞	凶煞
凶燄	凶燄
凶犯	兇犯
凶狠	兇狠
凶猛	兇猛
凶疑	兇疑
凶的	兇的
凶相	兇相
凶礼	凶禮
凶神	凶神
凶竖	凶豎
凶耗	凶耗
凶肆	凶肆
凶荒	凶荒
凶虐	兇虐
凶讯	凶訊
凶身	凶身
凶逆	凶逆
凶门	凶門
凶险	兇險
凸出	凸出
凸面	凸面
凹洞里	凹洞裏
凹面	凹面
出上	出上
出下	出下
出丑	出醜
出世	出世
出丧	出喪
出个	出個
出乎	出乎
出乘	出乘
出书	出書
出了	出了
出事	出事
出于	出於
出亡	出亡
出产	出產
出人	出人
出仕	出仕
出价	出價
出任	出任
出众	出眾
出使	出使
出倒	出倒
出借	出借
出儿	齣兒
出入	出入
出关	出關
出兵	出兵
出典	出典
出军	出軍
出出	出出
出击	出擊
出刊	出刊
出列	出列
出到	出到
出剧	齣劇
出力	出力
出动	出動
出动画	齣動畫
出勤	出勤
出卖	出賣
出卡通	齣卡通
出厂	出廠
出去	出去
出发	出發
出口	出口
出台	出臺
出号	出號
出名	出名
出品	出品
出售	出售
出国	出國
出土	出土
出在	出在
出场	出場
出堂	出堂
出塞	出塞
出境	出境
出声	出聲
出处	出處
出外	出外
出头	出頭
出奇	出奇
出奔	出奔
出好	出好
出妇	出婦
出妻	出妻
出姓	出姓
出嫁	出嫁
出子	齣子
出官	出官
出定	出定
出宰	出宰
出家	出家
出尖	出尖
出尘	出塵
出局	出局
出山	出山
出岔	出岔
出巡	出巡
出工	出工
出差	出差
出师	出師
出席	出席
出幼	出幼
出店	出店
出庭	出庭
出彩	出彩
出征	出征
出得	出得
出心	出心
出恭	出恭
出息	出息
出戏	齣戲
出战	出戰
出户	出戶
出手	出手
出招	出招
出挑	出挑
出掌	出掌
出操	出操
出教	出教
出文	出文
出斩	出斬
出景	出景
出月	出月
出有	出有
出材	出材
出来	出來
出校	出校
出格	出格
出梅	出梅
出榜	出榜
出橐	出橐
出殃	出殃
出殡	出殯
出气	出氣
出水	出水
出汗	出汗
出江	出江
出没	出沒
出油	出油
出注	出注
出洋	出洋
出活	出活
出浴	出浴
出海	出海
出涕	出涕
出清	出清
出港	出港
出游	出遊
出溜	出溜
出火	出火
出炉	出爐
出点	出點
出热	出熱
出版	出版
出牌	出牌
出狱	出獄
出猎	出獵
出现	出現
出球	出球
出生	出生
出电影	齣電影
出电视	齣電視
出界	出界
出的	出的
出监	出監
出盘	出盤
出示	出示
出神	出神
出科	出科
出租	出租
出稿	出稿
出窍	出竅
出站	出站
出笏	出笏
出笼	出籠
出籍	出籍
出粗	出粗
出粜	出糶
出粮	出糧
出糗	出糗
出纳	出納
出线	出綫
出结	出結
出给	出給
出继	出繼
出缺	出缺
出群	出群
出脱	出脫
出自	出自
出航	出航
出色	出色
出节目	齣節目
出芽	出芽
出苗	出苗
出草	出草
出落	出落
出蛰	出蟄
出血	出血
出行	出行
出言	出言
出让	出讓
出记	出記
出访	出訪
出诉	出訴
出诊	出診
出调	出調
出谋划策	出謀劃策
出豁	出豁
出货	出貨
出费	出費
出资	出資
出赘	出贅
出赛	出賽
出走	出走
出起	出起
出超	出超
出路	出路
出跳	出跳
出身	出身
出车	出車
出轨	出軌
出过	出過
出迎	出迎
出逃	出逃
出道	出道
出量	出量
出金	出金
出钱	出錢
出铁	出鐵
出错	出錯
出锤	出錘
出门	出門
出阁	出閣
出阵	出陣
出院	出院
出险	出險
出面	出面
出韵	出韻
出顶	出頂
出项	出項
出题	出題
出饭	出飯
出首	出首
出马	出馬
出齐	出齊
击	擊
击出	擊出
击发	擊發
击向	擊向
击扑	擊扑
击板	擊板
击沈	擊沈
击筑	擊築
击钟	擊鐘
凿	鑿
凿出	鑿出
凿岩	鑿巖
刀布	刀布
刀板	刀板
刀面	刀面
刁奸	刁姦
刁恶	刁惡
刁斗	刁斗
分个	分個
分了	分了
分伙	分夥
分党	分黨
分出	分出
分别	分別
分别致	分别致
分半钟	分半鐘
分占	分佔
分厂	分廠
分发	分發
分合	分合
分多钟	分多鐘
分子钟	分子鐘
分尸	分屍
分布	分布
分当	分當
分录	分錄
分摆	分擺
分种	分種
分针	分針
分钟	分鐘
切个	切個
切云	切雲
切出	切出
切合	切合
切当	切當
切面	切面
刊了	刊了
刊出	刊出
刊布	刊布
刊板	刊板
刍	芻
刑于	刑于
刑余	刑餘
刑克	刑剋
刑辟	刑辟
划一	劃一
划上	劃上
划下	劃下
划为	劃爲
划了	劃了
划入	劃入
划具	划具
划出	劃出
划分	劃分
划划	劃劃
划到	劃到
划动	划動
划去	劃去
划在	劃在
划地	劃地
划子	划子
划定	劃定
划开	劃開
划归	劃歸
划得	劃得
划成	劃成
划拉	劃拉
划拨	劃撥
划拳	划拳
划掉	劃掉
划时代	劃時代
划桨	划槳
划款	劃款
划水	划水
划法	劃法
划清	劃清
划然	劃然
划界	劃界
划着	划着
划破	劃破
划策	劃策
划算	划算
划线	劃綫
划船	划船
划艇	划艇
划行	划行
划走	划走
划起	划起
划足	劃足
划过	劃過
划进	划進
刓团	刓團
列了	列了
列出	列出
列布	列布
列当	列當
列表	列表
刘	劉
刘克庄	劉克莊
刘向	劉向
刘复	劉復
刘表	劉表
刘鉴	劉鑒
则	則
则个	則個
刚	剛
刚出	剛出
刚回	剛回
刚干	剛乾
刚才	剛纔
刚才一载	剛纔一載
刚雇	剛雇
创	創
创出	創出
创制	創製
创汇	創匯
创获	創穫
创面	創面
初冬	初冬
初发	初發
初征	初征
初志	初志
初愿	初願
初秋	初秋
删	刪
判别	判別
利于	利於
利欲	利慾
别	別
别上	別上
别下	別下
别业	別業
别个	別個
别义	別義
别乡	別鄉
别了	別了
别人	別人
别从	別從
别传	別傳
别体	別體
别使	別使
别倒	別倒
别傻	別傻
别像	別像
别党	別黨
别关	別關
别具	別具
别再	別再
别出	別出
别到	別到
别刻	別刻
别办	別辦
别加	別加
别动	別動
别劲	別勁
别区	別區
别去	別去
别县	別縣
别又	別又
别受	別受
别变	別變
别口气	彆口氣
别句	別句
别只	別隻
别叫	別叫
别史	別史
别号	別號
别名	別名
别后	別後
别向	別向
别吓	別嚇
别哭	別哭
别国	別國
别在	別在
别墅	別墅
别墨	別墨
别处	別處
别套	別套
别子	別子
别字	別字
别守	別守
别室	別室
别家	別家
别寄	別寄
别对	別對
别将	別將
别局	別局
别岁	別歲
别巷	別巷
别师	別師
别庄	別莊
别开	別開
别异	別異
别弹	別彈
别强	彆強
别当	別當
别得	別得
别忙	別忙
别急	別急
别怪	別怪
别情	別情
别想	別想
别意	別意
别成	別成
别房	別房
别手	別手
别扭	彆扭
别把	別把
别拍	別拍
别拔	別拔
别拗	彆拗
别拿	別拿
别挤	別擠
别排	別排
别提	別提
别搬	別搬
别支	別支
别收	別收
别教	別教
别数	別數
别族	別族
别无	別無
别是	別是
别替	別替
别有	別有
别本	別本
别杀	別殺
别材	別材
别束	別束
别来	別來
别枝	別枝
别架	別架
别栋	別棟
别校	別校
别样	別樣
别棵	別棵
别殿	別殿
别气	彆氣
别法	別法
别派	別派
别爲	別爲
别现	別現
别班	別班
别理	別理
别生	別生
别用	別用
别由	別由
别白	別白
别的	別的
别省	別省
别看	別看
别着	別着
别离	別離
别种	別種
别科	別科
别称	別稱
别笑	別笑
别第	別第
别答	別答
别筵	別筵
别管	別管
别箱	別箱
别线	別綫
别组	別組
别给	別給
别绪	別緒
别罐	別罐
别脚	別腳
别致	別緻
别被	別被
别裁	別裁
别解	別解
别讨	別討
别让	別讓
别记	別記
别讲	別講
别论	別論
别试	別試
别话	別話
别说	別說
别请	別請
别课	別課
别调	別調
别谈	別談
别赋	別賦
别赏	別賞
别走	別走
别起	別起
别趣	別趣
别跑	別跑
别踢	別踢
别转	別轉
别输	別輸
别辟	別闢
别过	別過
别逃	別逃
别针	別針
别队	別隊
别院	別院
别集	別集
别项	別項
别颗	別顆
别题	別題
别馆	別館
别首	別首
别驾	別駕
别骑	別騎
别鹤	別鶴
刭	剄
刮上	刮上
刮下	刮下
刮了	颳了
刮伤	刮傷
刮倒	颳倒
刮刀	刮刀
刮刮	刮刮
刮到	刮到
刮削	刮削
刮剌	刮剌
刮去	颳去
刮取	刮取
刮喇	刮喇
刮在	刮在
刮垢	刮垢
刮头	刮頭
刮好	刮好
刮子	刮子
刮得	颳得
刮打	刮打
刮拉	刮拉
刮掉	刮掉
刮摩	刮摩
刮毒	刮毒
刮涎	刮涎
刮痕	刮痕
刮痧	刮痧
刮的	刮的
刮着	刮着
刮研	刮研
刮破	刮破
刮胡	刮鬍
刮脸	刮臉
刮舌	刮舌
刮补	刮補
刮言	刮言
刮走	颳走
刮起	颳起
刮躁	刮躁
刮过	刮過
刮雪	颳雪
刮风	颳風
刮骨	刮骨
到了	到了
制中	制中
制为	製爲
制举	制舉
制义	制義
制书	制書
制件	製件
制伏	制伏
制住	制住
制作	製作
制做	製做
制军	制軍
制冰	製冰
制冷	製冷
制剂	製劑
制动	制動
制勘	制勘
制取	製取
制变	制變
制台	制臺
制命	制命
制品	製品
制图	製圖
制坯	製坯
制备	製備
制定	制定
制宪	制憲
制导	制導
制币	制幣
制度	制度
制式	制式
制得	製得
制成	製成
制服	制服
制材	製材
制梃	制梃
制止	制止
制法	製法
制浆	製漿
制海	制海
制爲	製爲
制片	製片
制版	製版
制盐	製鹽
制礼	制禮
制科	制科
制程	製程
制空	制空
制策	制策
制签	制籤
制糖	製糖
制约	制約
制纸	製紙
制胜	制勝
制艺	制藝
制药	製藥
制衡	制衡
制表	製表
制裁	制裁
制订	制訂
制诰	制誥
制造	製造
制醣	制醣
制钟	制鐘
制钱	制錢
制限	制限
制面	制面
制革	製革
制鞋	製鞋
刷卷	刷卷
刹	剎
刺出	刺出
刺参	刺蔘
刺干	刺干
刺绣	刺繡
刺针	刺針
刻个	刻個
刻了	刻了
刻于	刻於
刻出	刻出
刻划	刻劃
刻半钟	刻半鐘
刻多钟	刻多鐘
刻板	刻板
刻钟	刻鐘
刽	劊
刿	劌
剀	剴
剂	劑
剃了	剃了
剃发	剃髮
剃胡	剃鬍
剃须	剃鬚
剉折	剉折
削了	削了
削价	削價
削发	削髮
削面	削麵
前仇	前仇
前修	前修
前厂	前廠
前台	前臺
前叶	前葉
前后	前後
前回	前回
前志	前志
前面	前面
剐	剮
剑	劍
剑叶	劍葉
剑术	劍術
剑杆	劍桿
剔了	剔了
剔出	剔出
剔庄货	剔莊貨
剖别	剖別
剖面	剖面
剥	剝
剥制	剝製
剥尽	剝盡
剥挽	剝挽
剧	劇
剧团	劇團
剧曲	劇曲
剧种	劇種
剧药	劇藥
剩个	剩個
剩了	剩了
剩余	剩餘
剪个	剪個
剪了	剪了
剪其发	剪其髮
剪出	剪出
剪发	剪髮
剪彩	剪綵
副曲	副曲
割了	割了
割出	割出
割回	割回
割据	割據
割舍	割捨
剺面	剺面
剿获	剿獲
劈划	劈劃
劈面	劈面
力争上游	力爭上遊
力克	力克
力克制	力剋制
力尽	力盡
力征	力征
力拼	力拚
力求克制	力求剋制
力系	力系
力胜	力勝
劝	勸
劝出	勸出
劝回	勸回
办	辦
办伙	辦伙
办公台	辦公檯
功布	功布
功致	功緻
加个	加個
加了	加了
加于	加於
加仑	加侖
加价	加價
加出	加出
加升	加升
加卷	加捲
加发	加發
加回	加回
加布	加布
加当	加當
加挂	加掛
加注	加註
加涂	加塗
加签	加簽
加药	加藥
务	務
务须	務須
劢	勱
劣于	劣於
劣种	劣種
劣药	劣藥
动	動
动了	動了
动向	動向
动荡	動盪
助于	助於
助恶	助惡
劫余	劫餘
劫制	劫制
励	勵
励志	勵志
劲	勁
劲秋	勁秋
劳	勞
劳力士表	勞力士錶
劳发	勞發
劳困	勞困
劾系	劾繫
势	勢
勃发	勃發
勃郁	勃鬱
勇于	勇於
勋	勛
勋章	勳章
勒借	勒借
勘合	勘合
勤仆	勤僕
勤朴	勤樸
勺药	勺藥
勾了	勾了
勾出	勾出
勾干	勾幹
勾当	勾當
勾心斗角	勾心鬭角
勾魂荡魄	勾魂蕩魄
勿药	勿藥
匀	勻
匀出	勻出
匀面	勻面
包伙	包伙
包准	包準
包占	包占
包干	包干
包庄	包莊
包扎	包紮
包括	包括
包谷	包穀
匏系	匏繫
化了	化了
化合	化合
化纤	化纖
北周	北周
北回	北迴
北回线	北迴綫
北回铁路	北迴鐵路
北岳	北嶽
北征	北征
北斗	北斗
北曲	北曲
北极	北極
北里	北里
北面	北面
匡合	匡合
匡复	匡複
匡当	匡當
匦	匭
匪党	匪黨
匪干	匪幹
匮	匱
匹面	匹面
区	區
区划	區劃
区别	區別
医	醫
医术	醫術
医药	醫藥
医院里	醫院裏
匾扎	匾扎
匿于	匿於
十万	十萬
十个	十個
十余	十餘
十克	十克
十几	十幾
十出	十齣
十划	十劃
十卷	十卷 十捲
十发	十發
十只	十隻
十台	十臺
十叶	十葉
十周	十週
十回	十回
十团	十團
十干	十干
十恶	十惡
十扎	十紮
十曲	十曲
十种	十種
十里	十里
十针	十針
十面	十面
千万	千萬
千个	千個
千乘	千乘
千乞	千乞
千亩	千畝
千亿	千億
千仞	千仞
千伏	千伏
千余	千餘
千克	千克
千分	千分
千千	千千
千卡	千卡
千古	千古
千只	千隻
千叶	千葉
千回百折	千迴百折
千回百转	千迴百轉
千夫	千夫
千寻	千尋
千岁	千歲
千嶂	千嶂
千年	千年
千总	千總
千户	千戶
千扎	千紮
千斤	千斤
千步	千步
千牛	千牛
千瓦	千瓦
千石	千石
千禧	千禧
千秋	千秋
千章	千章
千米	千米
千般	千般
千言	千言
千赫	千赫
千载	千載
千里	千里
千金	千金
千钧	千鈞
千钧一发	千鈞一髮
千门	千門
千鸟	千鳥
升上	升上
升了	升了
升仙	昇仙
升任	升任
升值	升值
升入	升入
升出	升出
升到	升到
升力	升力
升势	升勢
升升	升升
升华	昇華
升压	升壓
升号	升號
升回	升回
升在	升在
升坐	升坐
升堂	升堂
升天	昇天
升好	升好
升学	升學
升官	升官
升帐	升帳
升幂	升冪
升平	昇平
升引	升引
升得	升得
升成	升成
升斗	升斗
升旗	升旗
升来	升來
升格	升格
升水	升水
升汞	昇汞
升沉	升沉
升火	升火
升点	升點
升爲	升爲
升班	升班
升的	升的
升科	升科
升空	升空
升等	升等
升级	升級
升腾	升騰
升至	升至
升调	升調
升起	升起
升迁	升遷
升过	升過
升速	升速
升遐	升遐
升阳	昇陽
升阶	升階
升降	升降
升限	升限
升高	升高
午后	午後
半个	半個
半于	半於
半价	半價
半只	半隻
半板	半板
半里	半里
半面	半面
华	華
华严钟	華嚴鐘
华发	華髮
华志	華志
华表	華表
华里	華里
协	協
协合	協合
协同	協同
单	單
单于	單于
单价	單價
单只	單隻
单向	單向
单干	單幹
单打独斗	單打獨鬭
单据	單據
单摆	單擺
单曲	單曲
单板	單板
单系	單系
单面	單面
卖	賣
卖了	賣了
卖价	賣價
卖出	賣出
卖卜	賣卜
卖呆	賣呆
卖奸	賣姦
卖恶	賣惡
南京钟	南京鐘
南出	南出
南台	南臺
南向	南向
南回	南迴
南回线	南迴綫
南回铁路	南迴鐵路
南宫适	南宮适
南岳	南嶽
南征	南征
南曲	南曲
南极	南極
南汇	南匯
南游	南遊
南筑	南筑
南胡	南胡
南针	南針
南面	南面
博汇	博彙
博采	博採
卜人	卜人
卜儿	卜兒
卜卜	卜卜
卜卦	卜卦
卜吉	卜吉
卜商	卜商
卜婿	卜婿
卜宅	卜宅
卜居	卜居
卜年	卜年
卜度	卜度
卜式	卜式
卜征	卜征
卜日	卜日
卜易	卜易
卜珓	卜珓
卜祝	卜祝
卜筑	卜築
卜筮	卜筮
卜算	卜算
卜老	卜老
卜者	卜者
卜课	卜課
卜辞	卜辭
卜邻	卜鄰
卜骨	卜骨
卞庄	卞莊
卞梁	卞梁
占〇	佔〇
占一	佔一
占七	佔七
占万	佔万
占三	佔三
占上	占上
占上风	佔上風
占下	佔下
占不占	佔不佔
占不足	佔不足
占世界	佔世界
占东	佔東
占两	佔兩
占个	佔個
占中	佔中
占为	佔爲
占主	佔主
占九	佔九
占了	佔了
占二	佔二
占五	佔五
占亲	占親
占人	占人
占人便宜	佔人便宜
占亿	佔億
占优	佔優
占位	佔位
占住	佔住
占便宜	佔便宜
占便宜的是呆	占便宜的是呆
占俄	佔俄
占候	占候
占停车	佔停車
占先	佔先
占光	佔光
占全	佔全
占八	佔八
占六	佔六
占凤	占鳳
占分	佔分
占到	佔到
占加	佔加
占劣	佔劣
占北	佔北
占十	佔十
占千	佔千
占半	佔半
占南	佔南
占卜	占卜
占占	佔佔
占卦	占卦
占印	佔印
占压	佔壓
占去	佔去
占取	佔取
占台	佔臺
占后	佔後
占哺乳	佔哺乳
占嗫	佔囁
占四	佔四
占国内	佔國內
占在	佔在
占地	佔地
占场	佔場
占城	占城 佔城
占多	佔多
占大	佔大
占头	佔頭
占好	佔好
占射	占射
占小	佔小
占少	佔少
占尽	佔盡
占局部	佔局部
占屋	佔屋
占山	佔山
占市场	佔市場
占平均	佔平均
占床	佔床
占座	佔座
占强	占強
占得	佔得
占德	佔德
占总	佔總
占房	占房
占拜	占拜
占据	佔據
占掉	佔掉
占整体	佔整體
占断	占斷
占新	佔新
占星	占星
占有	佔有
占有欲	佔有慾
占查	佔査
占梦	占夢
占次	佔次
占比	佔比
占毕	佔畢
占法	佔法
占满	佔滿
占澳	佔澳
占爲	佔爲
占率	佔率
占用	佔用
占百	佔百
占着	佔着
占稳	佔穩
占筮	占筮
占线	佔綫
占缺	佔缺
占网	佔網
占美	佔美
占耕	佔耕
占至多	佔至多
占至少	佔至少
占苏	佔蘇
占英	佔英
占葡	佔葡
占西	佔西
占课	占課 佔課
占资源	佔資源
占起	佔起
占超过	佔超過
占身	占身
占过	佔過
占道	佔道
占零	佔零
占領	佔領
占领	佔領
占饭	佔飯
占香	佔香
占马	佔馬
占验	占驗
占高枝儿	佔高枝兒
卡里	卡里
卢	盧
卢同	盧同
卢布	盧布
卢棱伽	盧棱伽
卢胡	盧胡
卤	鹵
卤人	鹵人
卤制	滷製
卤化	鹵化
卤味	滷味
卤地	鹵地
卤族	鹵族
卤水	滷水
卤汁	滷汁
卤湖	滷湖
卤煮	滷煮
卤簿	鹵簿
卤素	鹵素
卤肉	滷肉
卤莽	鹵莽
卤菜	滷菜
卤虾	滷蝦
卤蛋	滷蛋
卤钝	鹵鈍
卤面	滷麵
卤鸡	滷雞
卧游	臥遊
卫	衛
卫星钟	衛星鐘
印出	印出
印制	印製
印发	印發
印台	印臺
印合	印合
印累绶若	印累綬若
印表	印表
印鉴	印鑑
危于	危於
却	卻
却后	卻後
却才	卻纔
卵与石斗	卵與石鬭
卷云	捲雲
卷住	捲住
卷儿	捲兒
卷入	捲入
卷动	捲動
卷包	捲包
卷卷	卷卷
卷去	捲去
卷发	捲髮
卷取	卷取
卷图	捲圖
卷土重来	捲土重來
卷娄	卷婁
卷子	卷子
卷宗	卷宗
卷尺	捲尺
卷帘	捲簾
卷帙	卷帙
卷帻	卷幘
卷心菜	捲心菜
卷怀	卷懷
卷成	捲成
卷曲	捲曲
卷来	捲來
卷柏	卷柏
卷染	卷染
卷棚	捲棚
卷款	捲款
卷毛	捲毛
卷烟	捲菸
卷甲	卷甲
卷筒	捲筒
卷纬	卷緯
卷纸	捲紙
卷绕	卷繞
卷缩	捲縮
卷耳	卷耳
卷舌	捲舌
卷舒	卷舒
卷舖盖	捲舖蓋
卷菸	捲菸
卷袖	捲袖
卷装	卷裝
卷走	捲走
卷起	捲起
卷轴	卷軸
卷进	捲進
卷逃	捲逃
卷铺盖	捲鋪蓋
卷阿	卷阿
卷须	卷鬚
卷领	卷領
卷风	捲風
卸了	卸了
卺	巹
卿云	卿雲
厂	廠
厂主	廠主
厂卫	廠衛
厂名	廠名
厂商	廠商
厂地	廠地
厂址	廠址
厂外	廠外
厂子	廠子
厂家	廠家
厂容	廠容
厂房	廠房
厂方	廠方
厂棚	廠棚
厂牌	廠牌
厂矿	廠礦
厂税	廠稅
厂衣	廠衣
厂规	廠規
厂部	厂部
厂长	廠長
厄台	厄臺
厅	廳
厅舍	廳舍
历	歷
历下	歷下
历久	歷久
历书	曆書
历乱	歷亂
历代	歷代
历任	歷任
历元	曆元
历劫	歷劫
历历	歷歷
历史	歷史
历史里	歷史裏
历命	曆命
历头	曆頭
历始	曆始
历审	歷審
历室	曆室
历尽	歷盡
历尾	曆尾
历届	歷屆
历山	歷山
历年	歷年
历数	歷數
历日	歷日
历时	歷時
历月	歷月
历朝	歷朝
历本	曆本
历来	歷來
历次	歷次
历正	歷正
历沴	歷沴
历法	曆法
历澜	歷瀾
历物之意	厤物之意
历狱	曆獄
历碌	歷碌
历程	歷程
历纪	曆紀
历线	歷綫
历练	歷練
历经	歷經
历落	歷落
历象	曆象
历遍	歷遍
历险	歷險
历齿	歷齒
厉	厲
压	壓
压价	壓價
压出	壓出
压制	壓制 壓製
压卷	壓卷
压回	壓回
压杆	壓桿
厌	厭
厌恶	厭惡
厍	厙
厓谷	厓谷
厕	廁
厘出	釐出
厘升	釐升
厘定	釐定
厘改	釐改
厘整	釐整
厘正	釐正
厘清	釐清
厘米	釐米
厘订	釐訂
厘金	厘金
厘革	釐革
厚朴	厚朴
厚板	厚板
原于	原於
原价	原價
原厂	原廠
原子钟	原子鐘
原板	原板
原种	原種
原虫	原蟲
原钟	原鐘
原须	原須
厢	廂
厣	厴
厥后	厥後
厦	廈
厨	廚
厨余	廚餘
厨娘	廚娘
厨柜	廚櫃
厩	廄
厮	廝
厮斗	廝鬭
厮舍	廝舍
去了	去了
去借	去借
去后	去後
去向	去向
去搜	去搜
县	縣
县志	縣誌
县里	縣裏
参	參
参与	參與
参事	參事
参伍	參伍
参佐	參佐
参假	參假
参军	參軍
参加	參加
参劾	參劾
参半	參半
参合	參合
参商	參商
参场	參場
参堂	參堂
参天	參天
参头	參頭
参奏	參奏
参孙	參孫
参将	參將
参展	參展
参差	參差
参度	參度
参悟	參悟
参战	參戰
参拜	參拜
参政	參政
参数	參數
参朝	參朝
参本	參本
参杂	參雜
参校	參校
参汤	蔘湯
参灵	參靈
参照	參照
参看	參看
参破	參破
参禅	參禪
参绥	蔘綏
参综	參綜
参考	參考
参见	參見
参观	參觀
参订	參訂
参议	參議
参访	參訪
参请	參請
参谋	參謀
参谒	參謁
参谭	參譚
参赛	參賽
参赞	參贊
参辰	參辰
参选	參選
参透	參透
参道	參道
参酌	參酌
参量	參量
参错	參錯
参阅	參閱
参院	參院
参革	參革
参预	參預
参验	參驗
及于	及於
友于	友于
友党	友黨
友台	友臺
双	雙
双丰	雙豐
双叶	雙葉
双向	雙向
双周	雙週
双折	雙摺
双胜类	雙胜類
双雕	雙鵰
双面	雙面
反个	反個
反了	反了
反于	反於
反修	反修
反冲	反衝
反制	反制
反向	反向
反复	反覆 反復
反复制	反複製
反朴	反樸
反烟	反煙
反覆	反覆
反面	反面
发	發
发上	發上
发上冲冠	髮上沖冠
发上指冠	髮上指冠
发下	發下
发业	發業
发丝	髮絲
发丧	發喪
发个	發個
发为血之本	髮爲血之本
发乔	發喬
发书	發書
发乳	髮乳
发了	發了
发予	發予
发于	發於
发些	發些
发亮	發亮
发人	發人
发付	發付
发令	發令
发作	發作
发信	發信
发僵	發僵
发兆	發兆
发光	發光
发光可鉴	髮光可鑑
发兵	發兵
发冢	發冢
发冷	發冷
发凡	發凡
发出	發出
发函	發函
发刊	發刊
发到	發到
发动	發動
发包	發包
发匪	髮匪
发匮	發匱
发单	發單
发卖	發賣
发卷	髮捲
发去	發去
发发	發發
发叶	發葉
发向	發向
发呆	發呆
发呕	發嘔
发咒	發咒
发响	發響
发哑	發啞
发售	發售
发喘	發喘
发噱	發噱
发回	發回
发型	髮型
发墨	發墨
发声	發聲
发复	發覆
发头	發頭
发夹	髮夾
发奉	發奉
发奋	發奮
发奖	發獎
发好	發好
发妻	髮妻
发姐	髮姐
发威	發威
发嫁	發嫁
发家	發家
发封	發封
发射	發射
发屋	髮屋
发展	發展
发岁	發歲
发已霜白	髮已霜白
发市	發市
发布	發布
发带	髮帶
发干	發乾
发庄	發莊
发廊	髮廊
发廪	發廩
发开	發開
发式	髮式
发引	發引
发引千钧	髮引千鈞
发往	發往
发得	發得
发心	發心
发忿	發忿
发怒	發怒
发怔	發怔
发急	發急
发性	發性
发怵	發怵
发恨	發恨
发息	發息
发恼	發惱
发悲	發悲
发悸	發悸
发情	發情
发想	發想
发愁	發愁
发意	發意
发愣	發愣
发愤	發憤
发愿	發願
发慌	發慌
发懒	發懶
发成	發成
发扬	發揚
发抒	發抒
发抖	發抖
发报	發報
发指	髮指
发挥	發揮
发掉	發掉
发排	發排
发掘	發掘
发摃	發摃
发擂	發擂
发擿	發擿
发收	發收
发放	發放
发散	發散
发文	發文
发明	發明
发昏	發昏
发春	發春
发晕	發暈
发暗	發暗
发有	發有
发木	發木
发村	發村
发条	發條
发来	發來
发松	發鬆
发极	發極
发标	發標
发样	發樣
发根	髮根
发棠	發棠
发楞	發楞
发榜	發榜
发横	發橫
发款	發款
发毛	發毛
发气	發氣
发水	發水
发汗	發汗
发汗药	發汗藥
发油	髮油
发泄	發泄
发洩	發泄
发洪	發洪
发派	發派
发源	發源
发漂	髮漂
发潮	發潮
发火	發火
发炎	發炎
发炮	發炮
发点	發點
发烛	發燭
发烟	發煙
发烦	發煩
发烧	發燒
发烫	發燙
发热	發熱
发爲	發爲
发片	發片
发牌	發牌
发牒	發牒
发物	發物
发状	髮狀
发狂	發狂
发狠	發狠
发现	發現
发球	發球
发生	發生
发甲	發甲
发电	發電
发疯	發瘋
发疹	發疹
发病	發病
发痒	發癢
发痛	發痛
发痧	發痧
发痴	發痴
发癡	發癡
发癣	髮癬
发癫	發癲
发白	發白
发的	發的
发皇	發皇
发监	發監
发直	發直
发眩	發眩
发着	發着
发矢	發矢
发短心长	髮短心長
发砲	發砲
发硎	發硎
发硬	發硬
发祥	發祥
发票	發票
发禁	髮禁
发福	發福
发科	發科
发积	發積
发稿	發稿
发窘	發窘
发端	發端
发笑	發笑
发笔	發筆
发笺	髮箋
发策	發策
发签	發籤
发箧	發篋
发箭	發箭
发簪	髮簪
发籤	發籤
发粉	發粉
发糕	發糕
发紫	發紫
发红	發紅
发纱	髮紗
发绀	發紺
发结	髮結
发给	發給
发绿	發綠
发网	髮網
发肤	髮膚
发育	發育
发肿	發腫
发胀	發脹
发背	發背
发胖	發胖
发胡	發胡
发胶	髮膠
发脚	髮腳
发脱	發脫
发自	發自
发臭	發臭
发船	發船
发花	發花
发芽	發芽
发草	發草
发菜	髮菜
发落	發落
发蒙	發矇
发蓝	發藍
发薪	發薪
发虚	發虛
发蜡	髮蠟
发行	發行
发表	發表
发见	發見
发觉	發覺
发解	發解
发言	發言
发誓	發誓
发讪	發訕
发话	發話
发课	發課
发财	發財
发货	發貨
发质	髮質
发起	發起
发越	發越
发足	發足
发踊冲冠	髮踊沖冠
发蹙	發蹙
发蹟	發蹟
发躁	發躁
发身	發身
发车	發車
发轫	發軔
发软	發軟
发轿	發轎
发辫	髮辮
发达	發達
发过	發過
发运	發運
发还	發還
发进	發進
发送	發送
发遣	發遣
发配	發配
发酵	發酵
发酸	發酸
发野	發野
发针	髮針
发钗	髮釵
发长	髮長
发问	發問
发闷	發悶
发闹	發鬧
发际	髮際
发难	發難
发雕	髮雕
发霜	髮霜
发露	發露
发青	發青
发面	發麵
发鞍	發鞍
发音	發音
发颤	發顫
发风	發風
发飘	發飄
发飙	發飆
发饰	髮飾
发饷	發餉
发马	發馬
发骚	發騷
发髻	髮髻
发鬓	髮鬢
发麻	發麻
发黄	發黃
发黏	發黏
发黑	發黑
取了	取了
取出	取出
取向	取向
取回	取回
取才	取才
取胜	取勝
取舍	取捨
取药	取藥
受了	受了
受制	受制
受困	受困
受尽	受盡
受托	受託
变	變
变丑	變醜
变个	變個
变了	變了
变价	變價
变修	變修
变出	變出
变回	變回
变征	變徵
变种	變種
变脏	變髒
变髒	變髒
叙	敘
叙别	敘別
叙录	敘錄
叛党	叛黨
叠	疊
叠了	疊了
叠出	疊出
叠合	疊合
口仇	口仇
口出	口出
口占	口占
口干	口乾
口彩	口彩
口愿	口願
口才	口才
口腹之欲	口腹之慾
口里	口裏
口钟	口鐘
古书云	古書云
古制	古制
古書云	古書云
古朴	古樸
古板	古板
古柯咸	古柯鹹
古游	古遊
古語云	古語云
古迹	古蹟
古钟	古鐘
古钟表	古鐘錶
另于	另於
另借	另借
另辟	另闢
叩出	叩出
叩钟	叩鐘
只买	只買
只产	只產
只亮	只亮
只今	只今
只从	只從
只会	只會
只传	只傳
只住	只住
只作	只作
只借	只借
只做	只做
只停	只停
只养	只養
只再	只再
只写	只寫
只冲	只衝
只准	只准
只凭	只憑
只分	只分
只刊	只刊
只判	只判
只剩	只剩
只办	只辦
只加	只加
只动	只動
只包	只包
只卖	只賣
只占	只佔
只印	只印
只去	只去
只发	只發
只受	只受
只变	只變
只可	只可
只吃	只吃
只合	只合
只含	只含
只听	只聽
只和	只和
只唱	只唱
只喊	只喊
只喝	只喝
只回	只回
只因	只因
只图	只圖
只在	只在
只坐	只坐
只多	只多
只够	只够
只套	只套
只好	只好
只字	隻字
只学	只學
只守	只守
只定	只定
只害	只害
只对	只對
只封	只封
只射	只射
只将	只將
只尽	只盡
只差	只差
只带	只帶
只帮	只幫
只应	只應
只延	只延
只开	只開
只当	只當
只录	只錄
只影	隻影
只待	只待
只得	只得
只怕	只怕
只怪	只怪
只想	只想
只愿	只願
只懂	只懂
只成	只成
只戴	只戴
只手遮天	隻手遮天
只打	只打
只找	只找
只把	只把
只报	只報
只抱	只抱
只拜	只拜
只拼	只拼
只挑	只挑
只挡	只擋
只捉	只捉
只排	只排
只接	只接
只提	只提
只插	只插
只搬	只搬
只摆	只擺
只撞	只撞
只收	只收
只放	只放
只教	只教
只敢	只敢
只数	只數
只日	隻日
只是	只是
只替	只替
只有	只有
只来	只來
只査	只査
只比	只比
只求	只求
只派	只派
只流	只流
只涂	只塗
只消	只消
只漏	只漏
只演	只演
只点	只點
只照	只照
只煮	只煮
只爲	只爲
只猜	只猜
只玩	只玩
只甚	只甚
只用	只用
只画	只畫
只留	只留
只看	只看
只眼	隻眼
只睡	只睡
只砍	只砍
只种	只種
只租	只租
只称	只稱
只穿	只穿
只立	隻立
只站	只站
只等	只等
只答	只答
只管	只管
只索	只索
只红	只紅
只约	只約
只经	只經
只编	只編
只缝	只縫
只罚	只罰
只考	只考
只聘	只聘
只肯	只肯
只背	只背
只能	只能
只花	只花
只补	只補
只被	只被
只装	只裝
只要	只要
只见	只見
只言片语	隻言片語
只订	只訂
只让	只讓
只记	只記
只讲	只講
只许	只許
只设	只設
只说	只說
只读	只讀
只调	只調
只费	只費
只赌	只賭
只赔	只賠
只赚	只賺
只赢	只贏
只走	只走
只赶	只趕
只跌	只跌
只跟	只跟
只跳	只跳
只踢	只踢
只踩	只踩
只身	隻身
只转	只轉
只轰	只轟
只载	只載
只输	只輸
只达	只達
只过	只過
只进	只進
只追	只追
只送	只送
只通	只通
只道	只道
只配	只配
只采	只採
只量	只量
只铺	只鋪
只销	只銷
只镀	只鍍
只问	只問
只闯	只闖
只闻	只聞
只防	只防
只降	只降
只限	只限
只陪	只陪
只需	只需
只露	只露
只靠	只靠
只须	只須
只顾	只顧
只领	只領
只飞	只飛
叫个	叫個
叫了	叫了
叫价	叫價
叫出	叫出
叫回	叫回
叫板	叫板
召回	召回
召幸	召幸
叮叮当当	叮叮噹噹
叮当	叮噹
可于	可於
可以克制	可以剋制
可别	可別
可向	可向
可周	可週
可当	可當
可恶	可惡
可愿	可願
可欲	可欲
可紧可松	可緊可鬆
可鉴	可鑒
台上	臺上
台下	臺下
台东	臺東
台两	臺兩
台中	臺中
台佟	臺佟
台候	臺候
台光	臺光
台凤	臺鳳
台函	臺函
台制	臺製
台前	臺前
台北	臺北
台南	臺南
台历	檯曆
台号	臺號
台司	臺司
台后	臺後
台启	臺啓
台命	臺命
台商	臺商
台地	臺地
台型	臺型
台城	臺城
台基	臺基
台塑	臺塑
台墩	臺墩
台大	臺大
台委	臺委
台子	臺子 檯子
台孩	臺孩
台安	臺安
台客	臺客
台尺	臺尺
台山	台山
台峪	臺峪
台州	台州
台币	臺幣
台布	檯布
台帘	臺簾
台席	臺席
台座	臺座
台式	臺式
台意	臺意
台收	臺收
台文	臺文
台斤	臺斤
台旨	臺旨
台本	臺本
台柱	臺柱
台榭	臺榭
台槐	臺槐
台步	臺步
台汽	臺汽
台海	臺海
台湾	臺灣
台澎	臺澎
台灯	檯燈
台照	臺照
台独	臺獨
台玻	臺玻
台球	檯球
台甫	臺甫
台电	臺電
台盏	臺盞
台盘	臺盤
台省	臺省
台矶	臺磯
台站	臺站
台端	臺端
台糖	臺糖
台联	臺聯
台肥	臺肥
台胞	臺胞
台航	臺航
台艺	臺藝
台菜	臺菜
台衔	臺銜
台装	臺裝
台西	臺西
台视	臺視
台讳	臺諱
台词	臺詞
台语	臺語
台资	臺資
台车	臺車
台辅	臺輔
台金	臺金
台鉴	臺鑒
台钟	臺鐘
台钱	臺錢
台铁	臺鐵
台铝	臺鋁
台银	臺銀
台阁	臺閣
台阶	臺階
台面	檯面
台音	臺音
台风	颱風
台驾	臺駕
叱咤乐坛	叱咤樂壇
叱咤叱叱咤	叱咤叱叱咤
叱咤咤	叱咤咤
叱咤樂壇	叱咤樂壇
史游	史游
右后	右後
右戚	右戚
右面	右面
叶	葉
叶丛	葉叢
叶儿	葉兒
叶兰	葉蘭
叶原	葉原
叶县	葉縣
叶叶	葉葉
叶堂	葉堂
叶子	葉子
叶尖	葉尖
叶序	葉序
叶形	葉形
叶恭弘	叶恭弘
叶慈	葉慈
叶拱	葉拱
叶挺	葉挺
叶斑	葉斑
叶枝	葉枝
叶柄	葉柄
叶树	葉樹
叶片	葉片
叶状	葉狀
叶王	葉王
叶缘	葉緣
叶耳	葉耳
叶肉	葉肉
叶肥	葉肥
叶脉	葉脈
叶脤	葉脤
叶腋	葉腋
叶舌	葉舌
叶芽	葉芽
叶茎	葉莖
叶蜂	葉蜂
叶蝉	葉蟬
叶语	葉語
叶蹟	葉蹟
叶轮	葉輪
叶轴	葉軸
叶适	葉適
叶酸	葉酸
叶针	葉針
叶门	葉門
叶面	葉面
叶鞘	葉鞘
叶音	叶音
叶韵	叶韻
号	號
号志	號誌
号板	號板
号舍	號舍
叹	歎
叽	嘰
吁俞	吁俞
吁吁	吁吁
吁咈	吁咈
吁嗟	吁嗟
吁嘘	吁噓
吁天	籲天
吁气	吁氣
吁求	籲求
吁请	籲請
吃了	吃了
吃出	吃出
吃姜	吃薑
吃尽	吃盡
吃板刀面	吃板刀麵
吃烟	吃煙
吃着不尽	吃着不盡
吃药	吃藥
吃辣面	吃辣麵
吃里扒外	吃裏扒外
吃里爬外	吃裏爬外
吃错药	吃錯藥
各个	各個
各借	各借
各党	各黨
各出	各出
各别	各別
各升	各升
各厂	各廠
各发	各發
各吊	各吊
各向	各向
各回	各回
各团	各團
各尽	各盡
各当	各當
各种	各種
各签	各簽
各类钟	各類鐘
各系	各系
各胜	各勝
各辟	各闢
各里	各里
各须	各須
合上	合上
合下	合下
合中	閤中
合乎	合乎
合于	合於
合从	合從
合付	合付
合众	合眾
合伙	合夥
合会	合會
合传	合傳
合住	合住
合体	合體
合作	合作
合借	合借
合做	合做
合儿	閤兒
合养	合養
合准	合準
合出	合出
合击	合擊
合刃	合刃
合到	合到
合券	合券
合刻	合刻
合剂	合劑
合力	合力
合办	合辦
合十	合十
合卺	合巹
合历	合曆
合发	合發
合变	合變
合口	合口
合叶	合葉
合吃	合吃
合合	合合
合同	合同
合后	合後
合唱	合唱
合围	合圍
合在	合在
合声	合聲
合头	合頭
合奏	合奏
合好	合好
合婚	合婚
合子	合子
合宅	合宅
合定	合定
合宜	合宜
合家	閤家
合局	合局
合并	合併
合府	閤府
合度	合度
合式	合式
合弦	合弦
合弹	合彈
合当	合當
合影	合影
合得	合得
合心	合心
合情	合情
合意	合意
合成	合成
合战	合戰
合手	合手
合扑	合撲
合折	合折
合报	合報
合抱	合抱
合拍	合拍
合拢	合攏
合掌	合掌
合数	合數
合族	合族
合时	合時
合昏	合昏
合是	合是
合朔	合朔
合本	合本
合机	合機
合杀	合殺
合板	合板
合校	合校
合格	合格
合欢	合歡
合款	合款
合气	合氣
合沓	合沓
合法	合法
合注	合注
合洗	合洗
合派	合派
合流	合流
合溜	合溜
合演	合演
合火	合火
合照	合照
合爲	合爲
合牵	合牽
合独	合獨
合班	合班
合球	合球
合理	合理
合璧	合璧
合瓣	合瓣
合生	合生
合用	合用
合盖	合蓋
合眼	閤眼
合着	合着
合租	合租
合窆	合窆
合站	合站
合符	合符
合签	合簽
合算	合算
合纤	合纖
合约	合約
合纵	合縱
合组	合組
合编	合編
合缝	合縫
合群	合群
合股	合股
合肥	合肥
合苦	合苦
合营	合營
合葬	合葬
合补	合補
合计	合計
合该	合該
合请	合請
合读	合讀
合调	合調
合谋	合謀
合谐	合諧
合谷	合谷
合购	合購
合资	合資
合起	合起
合踢	合踢
合踩	合踩
合身	合身
合辙	合轍
合适	合適
合通	合通
合造	合造
合遝	合遝
合醵	合醵
合采	合採
合金	合金
合钓	合釣
合锯	合鋸
合镜	合鏡
合闸	合閘
合面	合面
合音	合音
合领	合領
合骑	合騎
合髻	合髻
合龙	合龍
吉凶	吉凶
吉占	吉占
吉蔑	吉蔑
吊上	吊上
吊下	吊下
吊丧	弔喪
吊个	吊個
吊书	弔書
吊了	吊了
吊伐	吊伐
吊儿郎当	弔兒郎當
吊到	吊到
吊卷	弔卷
吊去	吊去
吊取	吊取
吊古	弔古
吊吊	吊吊
吊名	吊名
吊唁	弔唁
吊喉	弔喉
吊喭	弔喭
吊嗓	吊嗓
吊嘴	吊嘴
吊场	吊場
吊头	弔頭
吊奠	弔奠
吊好	吊好
吊子	吊子
吊孝	弔孝
吊客	弔客
吊宴	弔宴
吊带	吊帶
吊床	吊床
吊影	弔影
吊得	吊得
吊慰	弔慰
吊扇	吊扇
吊扣	吊扣
吊拷	弔拷
吊拷绷扒	弔拷繃扒
吊挂	吊掛
吊挂着	吊掛着
吊撒	弔撒
吊文	弔文
吊旗	弔旗
吊杆	吊杆
吊架	吊架
吊桥	吊橋
吊桶	吊桶
吊楼	吊樓
吊死	吊死
吊毛	吊毛
吊民	弔民
吊水	吊水
吊灯	吊燈
吊环	吊環
吊盘	吊盤
吊着	吊着
吊祭	弔祭
吊稍	吊稍
吊窗	吊窗
吊篮	弔籃
吊索	吊索
吊纸	弔紙
吊线	吊綫
吊者大悦	弔者大悅
吊脚	吊腳
吊脚儿事	弔腳兒事
吊腰撒跨	弔腰撒跨
吊膀子	弔膀子
吊臂	弔臂
吊袜	吊襪
吊装	吊裝
吊裤	吊褲
吊词	弔詞
吊诡	弔詭
吊谎	弔謊
吊贺迎送	弔賀迎送
吊走	吊走
吊起	吊起
吊车	吊車
吊钟	吊鐘
吊钩	吊鉤
吊铺	吊鋪
吊销	吊銷
吊问	弔問
吊颈	吊頸
吊饰	吊飾
吊鹤	弔鶴
同一	同一
同上	同上
同下	同下
同业	同業
同义	同義
同乐	同樂
同乡	同鄉
同事	同事
同于	同於
同产	同產
同人	同人
同仁	同仁
同仇	同仇
同伙	同夥
同伴	同伴
同位	同位
同体	同體
同余	同餘
同侪	同儕
同做	同做
同僚	同僚
同光	同光
同党	同黨
同出	同出
同分	同分
同列	同列
同到	同到
同化	同化
同区	同區
同升	同升
同去	同去
同县	同縣
同参	同參
同右	同右
同号	同號
同吃	同吃
同名	同名
同向	同向
同命	同命
同唱	同唱
同喜	同喜
同国	同國
同在	同在
同地	同地
同坐	同坐
同堂	同堂
同声	同聲
同好	同好
同姓	同姓
同学	同學
同宗	同宗
同定	同定
同室	同室
同宿	同宿
同寅	同寅
同对	同對
同尘	同塵
同居	同居
同屋	同屋
同岁	同歲
同工	同工
同左	同左
同席	同席
同年	同年
同庆	同慶
同床	同床
同庚	同庚
同度	同度
同座	同座
同异	同異
同张	同張
同归	同歸
同当	同當
同往	同往
同德	同德
同心	同心
同志	同志
同性	同性
同情	同情
同意	同意
同感	同感
同愿	同願
同房	同房
同打	同打
同指	同指
同排	同排
同支	同支
同改	同改
同文	同文
同方	同方
同族	同族
同日	同日
同时	同時
同是	同是
同月	同月
同有	同有
同期	同期
同机	同機
同来	同來
同校	同校
同样	同樣
同根	同根
同案	同案
同梦	同夢
同梯	同梯
同榜	同榜
同榻	同榻
同欢	同歡
同正	同正
同步	同步
同母	同母
同气	同氣
同治	同治
同派	同派
同渡	同渡
同温	同溫
同源	同源
同点	同點
同爨	同爨
同爲	同爲
同父	同父
同班	同班
同理	同理
同生	同生
同用	同用
同甲	同甲
同盖	同蓋
同盟	同盟
同省	同省
同知	同知
同砚	同硯
同种	同種
同科	同科
同穴	同穴
同窗	同窗
同站	同站
同章	同章
同等	同等
同篇	同篇
同类	同類
同系	同系
同约	同約
同级	同級
同线	同綫
同罪	同罪
同职	同職
同胞	同胞
同致	同致
同行	同行
同袍	同袍
同被	同被
同襟	同襟
同订	同訂
同论	同論
同调	同調
同谋	同謀
同谱	同譜
同质	同質
同走	同走
同跑	同跑
同路	同路
同车	同車
同轨	同軌
同轴	同軸
同辈	同輩
同边	同邊
同达	同達
同过	同過
同进	同進
同道	同道
同酬	同酬
同重	同重
同量	同量
同长	同長
同门	同門
同队	同隊
同音	同音
同项	同項
同题	同題
同高	同高
同龄	同齡
名坛	名壇
名录	名錄
名曲	名曲
名种	名種
名系	名系
名胜	名勝
名表	名錶
名鉴	名鑒
后	後
后上	後上
后下	後下
后世	後世
后丰	后豐
后主	後主
后事	後事
后于	後於
后人	後人
后代	後代
后仰	後仰
后件	後件
后任	後任
后会	後會
后传	後傳
后作	後作
后偏	後偏
后像	後像
后儿	後兒
后冠	后冠
后凉	後涼
后凋	後凋
后分	後分
后到	後到
后制	後製
后劲	後勁
后勤	後勤
后北街	后北街
后区	後區
后半	後半
后卫	後衛
后印	後印
后去	後去
后发座	后髮座
后台	後臺
后叶	後葉
后向	後向
后周	後周
后命	後命
后哨	後哨
后唐	後唐
后嗣	後嗣
后园	後園
后图	後圖
后土	后土
后埔	後埔
后堂	後堂
后壁	後壁
后备	後備
后天	後天
后夫	後夫
后头	後頭
后奏	後奏
后妃	后妃
后妈	後媽
后妻	後妻
后娘	後孃
后嫁	後嫁
后学	後學
后安路	后安路
后宫	後宮
后尘	後塵
后尾	後尾
后山	後山
后巷	後巷
后市	後市
后帝	后帝
后平路	后平路
后年	後年
后庄	後庄
后序	後序
后座	後座
后庭	後庭
后影	後影
后心	後心
后怕	後怕
后悔	後悔
后患	後患
后房	後房
后手	後手
后排	後排
后接	後接
后援	後援
后摆	後襬
后撤	後撤
后攻	後攻
后放	後放
后效	後效
后文	後文
后方	後方
后日	後日
后昆	後昆
后晋	後晉
后晌	後晌
后晚	後晚
后景	後景
后有	後有
后期	後期
后来	後來
后果	後果
后桅	後桅
后桥	後橋
后梁	後梁
后槽	後槽
后步	後步
后段	後段
后殿	後殿
后母	後母
后汉	後漢
后派	後派
后浪	後浪
后海湾	后海灣
后海灣	后海灣
后港	後港
后点	後點
后燕	後燕
后爲	後爲
后父	後父
后爹	後爹
后王	后王
后生	後生
后用	後用
后由	後由
后皇	后皇
后盾	後盾
后知	後知
后福	後福
后秃	後禿
后秦	後秦
后程	後程
后稷	后稷
后窗	後窗
后站	後站
后端	後端
后篇	後篇
后继	後繼
后续	後續
后缀	後綴
后置	後置
后羿	后羿
后者	後者
后肢	後肢
后背	後背
后脑	後腦
后脚	後腳
后腰	後腰
后腿	後腿
后膛	後膛
后节	後節
后藏	後藏
后虑	後慮
后蜀	後蜀
后行	後行
后街	后街
后裔	後裔
后襟	後襟
后觉	後覺
后角	后角
后言	後言
后计	後計
后记	後記
后设	後設
后话	後話
后读	後讀
后豐	后豐
后账	後賬
后走	後走
后赵	後趙
后起	後起
后足	後足
后跟	後跟
后路	後路
后身	後身
后车	後車
后转	後轉
后轮	後輪
后辈	後輩
后辛	后辛
后辟	后辟
后边	後邊
后过	後過
后进	後進
后述	後述
后退	後退
后送	後送
后部	後部
后里	后里
后重	後重
后镜	後鏡
后门	後門
后防	後防
后院	後院
后集	後集
后面	後面
后项	後項
后顾	後顧
后颈	後頸
后首	後首
后髮座	后髮座
后魏	後魏
后龙	後龍
吐出	吐出
吐穗	吐穗
向上	向上
向下	向下
向东	向東
向人	向人
向使	向使
向例	向例
向光	向光
向內	向內
向前	向前
向化	向化
向北	向北
向午	向午
向南	向南
向右	向右
向后	向後
向善	向善
向地	向地
向外	向外
向天	向天
向学	向學
向宠	向寵
向导	嚮導
向左	向左
向年	向年
向应	嚮應
向度	向度
向当	向當
向往	嚮往
向心	向心
向性	向性
向慕	嚮慕
向戌	向戌
向斜	向斜
向日	向日
向时	向時
向明	嚮明
向晓	向曉
向晚	向晚
向晦	嚮晦
向暮	向暮
向来	向來
向海	向海
向火	向火
向用	向用
向盘	向盤
向着	向着
向秀	向秀
向者	曏者
向背	向背
向荣	向榮
向西	向西
向触	向觸
向迩	嚮邇
向量	向量
向阳	向陽
向隅	向隅
向非	向非
向顺	向順
向风	向風
吓	嚇
吓了	嚇了
吓出	嚇出
吕	呂
吕后	呂后
吕布	呂布
吕蒙	呂蒙
吗	嗎
吞了	吞了
吞并	吞併
吞烟	吞煙
吟坛	吟壇
吟游	吟遊
吠舍	吠舍
吣	唚
吧台	吧檯
吨	噸
含了	含了
含蜡	含蠟
含齿戴发	含齒戴髮
听	聽
听了	聽了
听于	聽於
听出	聽出
启	啓
启发	啓發
启蒙	啓蒙
吴	吳
吸了	吸了
吸出	吸出
吸回	吸回
吸烟	吸菸
吸虫	吸蟲
吹了	吹了
吹云	吹雲
吹出	吹出
吹发	吹髮
吹台	吹臺
吹向	吹向
吹干	吹乾
吹炼	吹煉
吹胡	吹鬍
吻别	吻別
吻合	吻合
吾党	吾黨
吾当	吾當
呂后	呂后
呆串了皮	呆串了皮
呆了	呆了
呆事	呆事
呆人	呆人
呆呆	呆呆
呆头	呆頭
呆子	呆子
呆性	呆性
呆想	呆想
呆憨呆	呆憨呆
呆板	呆板
呆根	呆根
呆气	呆氣
呆滞	呆滯
呆痴	呆痴
呆着	呆着
呆磕	呆磕
呆等	呆等
呆脑	呆腦
呆致致	呆緻緻
呆话	呆話
呆里呆气	呆裏呆氣
呈准	呈准
告别	告別
告发	告發
呐	吶
呒	嘸
呓	囈
呕	嘔
呖	嚦
呗	唄
呗赞	唄讚
员	員
呙	咼
呛	嗆
呛了	嗆了
呜	嗚
周一	週一
周三	週三
周书	周書
周事	周事
周二	週二
周五	週五
周人	周人
周仓	周倉
周代	周代
周休	週休
周会	週會
周內	周內
周全	周全
周公	周公
周六	週六
周刊	週刊
周到	周到
周勃	周勃
周匝	周匝
周南	周南
周卫	周衛
周历	周曆
周原	周原
周召	周召
周告	周告
周四	週四
周回	週迴
周围	周圍
周堂	周堂
周处	周處
周备	周備
周天	周天
周官	周官
周室	周室
周家	周家
周密	周密
周岁	週歲
周年	週年
周庄王	周莊王
周延	周延
周忌	周忌
周急	周急
周恤	周恤
周折	周折
周报	週報
周数	週數
周文	周文
周方	周方
周旋	周旋
周日	週日
周昉	周昉
周易	周易
周晬	周晬
周朝	周朝
周期	週期
周末	週末
周杰倫	周杰倫
周正	周正
周氏	周氏
周波	周波
周流	周流
周浃	周浹
周济	周濟
周游	周遊
周游世界	週遊世界
周率	周率
周瑜	周瑜
周相	周相
周知	周知
周礼	周禮
周章	周章
周给	周給
周缘	周緣
周置	周置
周考	週考
周至	周至
周薪	週薪
周行	周行
周览	周覽
周角	周角
周记	週記
周详	周詳
周诰	周誥
周身	周身
周转	周轉
周边	周邊
周近	週近
周遍	周遍
周道	周道
周遭	周遭
周遮	周遮
周郎	周郎
周长	週長
周顗	周顗
周颂	周頌
周颙	周顒
周髀	周髀
呼出	呼出
呼吁	呼籲
和丰	和豐
和了	和了
和克制	和剋制
和合	和合
和同	和同
和哄	和哄
和奸	和姦
和胜	和勝
和面	和麵
咍台	咍臺
咎征	咎徵
咏	詠
咏赞	詠贊
咒愿	咒愿
咒术	咒術
咕咕钟	咕咕鐘
咙	嚨
咙胡	嚨胡
咛	嚀
咤	吒
咨询	諮詢
咬了	咬了
咬合	咬合
咬姜呷醋	咬薑呷醋
咬秋	咬秋
咯当	咯噹
咳嗽药	咳嗽藥
咸丰	咸豐
咸信	咸信
咸卤	鹹鹵
咸味	鹹味
咸和	咸和
咸咸	鹹鹹
咸嘴淡舌	鹹嘴淡舌
咸土	鹹土
咸宁	咸寧
咸宜	咸宜
咸度	鹹度
咸得	鹹得
咸批	鹹批
咸水	鹹水
咸池	咸池
咸汤	鹹湯
咸派	鹹派
咸海	鹹海
咸淡	鹹淡
咸湖	鹹湖
咸潟	鹹潟
咸猪肉	鹹豬肉
咸的	鹹的
咸类	鹹類
咸粥	鹹粥
咸肉	鹹肉
咸菜	鹹菜
咸菜干	鹹菜乾
咸蛋	鹹蛋
咸阳	咸陽
咸食	鹹食
咸鱼	鹹魚
咸鸭蛋	鹹鴨蛋
哀吊	哀弔
哀戚	哀戚
哀挽	哀輓
品尝	品嚐
品汇	品彙
品种	品種
品系	品系
品鉴	品鑒
哄乱	哄亂
哄了	哄了
哄人	哄人
哄伙	鬨夥
哄传	哄傳
哄动	鬨動
哄哄	哄哄
哄堂	鬨堂
哄弄	哄弄
哄得	哄得
哄抢	哄搶
哄抬	哄擡
哄然	哄然 鬨然
哄笑	鬨笑
哄诱	哄誘
哄赚	哄賺
哄走	哄走
哄骗	哄騙
哈克	哈克
响	響
响了	響了
响卜	響卜
响板	響板
响钟	響鐘
哑	啞
哑板	啞板
哒	噠
哓	嘵
哔	嗶
哕	噦
哗	嘩
哙	噲
哜	嚌
哝	噥
哟	喲
哪个	哪個
哪几	哪幾
哪只	哪隻
哪台	哪臺
哪回	哪回
哪种	哪種
哪里	哪裏
哭个	哭個
哭了	哭了
哭出	哭出
哭尽	哭盡
哭脏	哭髒
哼个	哼個
哼出	哼出
唁吊	唁弔
唇干	唇乾
唛	嘜
唠	嘮
唢	嗩
唤	喚
唤出	喚出
唤回	喚回
售价	售價
售出	售出
唱个	唱個
唱了	唱了
唱出	唱出
唱回	唱回
唱曲	唱曲
唱游	唱遊
唱针	唱針
唸了	唸了
唾余	唾餘
唾面	唾面
唾面自干	唾面自乾
啃出	啃出
商借	商借
商历	商曆
商周	商周
商团	商團
商秋	商秋
啜哄	啜哄
啧	嘖
啬	嗇
啭	囀
啮	嚙
啮合	嚙合
啷当	啷噹
啸	嘯
喂乳	餵乳
喂了	餵了
喂你	餵你
喂养	餵養
喂喂	喂喂
喂奶	餵奶
喂它	餵它
喂我	餵我
喂猪	餵豬
喂眼	喂眼
喂给	餵給
喂羊	餵羊
喂过	餵過
喂食	餵食
喂饱	餵飽
喂驴	餵驢
喂鱼	餵魚
喂鸡	餵雞
喂鸭	餵鴨
喂鹅	餵鵝
善于	善於
善价	善價
善后	善後
善恶	善惡
善才	善才
喊了	喊了
喊价	喊價
喊出	喊出
喊回	喊回
喘出	喘出
喜娘	喜娘
喜恶	喜惡
喜欢表	喜歡錶
喜欢钟	喜歡鐘
喝个	喝個
喝了	喝了
喝出	喝出
喝参	喝參
喝尽	喝盡
喝干	喝乾
喝彩	喝彩
喝采	喝采
喧哄	喧鬨
喷	噴
喷出	噴出
喷发	噴發
喷洒	噴洒
喽	嘍
喾	嚳
嗅出	嗅出
嗑药	嗑藥
嗛志	嗛志
嗜欲	嗜慾
嗝症	嗝症
嗟吁	嗟吁
嗣后	嗣後
嗣适	嗣適
嗫	囁
嗳	噯
嘀嗒的表	嘀嗒的錶
嘉肴	嘉肴
嘉谷	嘉穀
嘘	噓
嘤	嚶
嘱	囑
嘱托	囑託
嘴里	嘴裏
噎饥	噎饑
噙齿戴发	噙齒戴髮
噜	嚕
噜苏	嚕囌
嚚暗	嚚闇
嚣	囂
嚷出	嚷出
嚷刮	嚷刮
嚼蜡	嚼蠟
嚼谷	嚼穀
囉囉苏苏	囉囉囌囌
囉苏	囉囌
囓合	囓合
囚系	囚繫
四万	四萬
四个	四個
四余	四餘
四克	四克
四党	四黨
四凶	四凶
四出	四齣
四出征收	四出徵收
四分历	四分曆
四千	四千
四只	四隻
四合	四合
四向	四向
四周	四周
四扎	四紮
四杰	四傑
四板	四板
四极	四極
四柜	四櫃
四胡	四胡
四舍五入	四捨五入
四舍六入	四捨六入
四表	四表
四里	四里
四面	四面
四面钟	四面鐘
回丝	回絲
回个	回個
回中	回中
回九	回九
回乡	回鄉
回书	回書
回买	回買
回了	回了
回事	回事
回交	回交
回人	回人
回佣	回佣
回信	回信
回候	回候
回光返照	迴光返照
回击	回擊
回函	回函
回到	回到
回动	回動
回匝	迴匝
回升	回升
回单	回單
回历	回曆
回去	回去
回台	回臺
回合	回合
回吐	回吐
回向	迴向
回告	回告
回味	回味
回和	回和
回咬	回咬
回响	迴響
回嘴	回嘴
回回	回回
回国	回國
回圈	迴圈
回塘	回塘
回填	回填
回声	回聲
回复	回覆
回天	迴天
回头	回頭
回奉	回奉
回子	回子
回字	回字
回定	回定
回家	回家
回容	回容
回师	回師
回帖	回帖
回带	迴帶
回席	回席
回应	回應
回府	回府
回廊	迴廊
回归	回歸
回形夹	迴形夾
回得	回得
回心	迴心
回忆	回憶
回忌	回忌
回思	回思
回想	回想
回惶	回惶
回戏	回戲
回手	回手
回扣	回扣
回执	回執
回护	迴護
回报	回報
回拜	回拜
回掉	回掉
回援	回援
回收	回收
回教	回教
回敬	回敬
回文	迴文
回斡	迴斡
回旋	迴旋
回族	回族
回旨	回旨
回易	回易
回映	回映
回春	回春
回暖	回暖
回朝	回朝
回本	回本
回条	回條
回来	回來
回档	回檔
回棋	回棋
回椎	回椎
回民	回民
回水	回水
回波	回波
回流	迴流
回游	回遊
回溯	回溯
回滩	回灘
回潮	回潮
回火	回火
回灯	回燈
回炉	回爐
回煞	回煞
回片	回片
回状	回狀
回环	迴環
回生	回生
回用	回用
回电	回電
回疆	回疆
回盘	回盤
回着	回着
回示	回示
回礼	回禮
回禀	回稟
回禄	回祿
回程	回程
回穴	迴穴
回笼	回籠
回答	回答
回籍	回籍
回纥	回紇
回纳	回納
回纹针	迴紋針
回绕	迴繞
回绝	回絕
回翔	迴翔
回肠	迴腸
回背	回背
回腕	迴腕
回航	回航
回荡	回蕩
回见	回見
回访	回訪
回诊	回診
回话	回話
回诵	迴誦
回请	回請
回赎	回贖
回赠	回贈
回起	回起
回跌	回跌
回路	迴路
回身	回身
回车	迴車
回转	迴轉
回过	回過
回返	回返
回递性	迴遞性
回途	回途
回遑	回遑
回避	迴避
回邪	回邪
回邮	回郵
回部	回部
回采	回採
回銮	迴鑾
回销	回銷
回锅	回鍋
回锋	回鋒
回门	回門
回阑	回闌
回防	回防
回阳荡气	回陽蕩氣
回雪	迴雪
回青	回青
回音	迴音
回顾	回顧
回风	迴風
回飙	迴飆
回馈	回饋
回首	回首
回马	回馬
回驳	回駁
回骂	回罵
回魂	回魂
回鹘	回鶻
因于	因於
团	團
团丁	團丁
团主	團主
团书	團書
团伙	團伙
团体	團體
团保	團保
团剥	團剝
团勇	團勇
团匪	團匪
团名	團名
团员	團員
团团	團團
团围	團圍
团圆	團圓
团坐	團坐
团头	團頭
团契	團契
团委	團委
团子	糰子
团康	團康
团弄	團弄
团扇	團扇
团拜	團拜
团掿	團掿
团旗	團旗
团服	團服
团栾	團欒
团案	團案
团牌	團牌
团状	團狀
团瓢	團瓢
团矿	團礦
团社	團社
团空	團空
团粒	團粒
团练	團練
团结	團結
团聚	團聚
团脐	團臍
团脸	團臉
团花	團花
团茶	團茶
团荷	團荷
团藻	團藻
团行	團行
团购	團購
团部	團部
团长	團長
团队	團隊
团音	團音
团鱼	團魚
团龙	團龍
团𪢮	團圞
园	園
园游会	園遊會
园里	園裏
困乏	睏乏
困了	困了
困于	困於
困人	困人
困住	困住
困倦	睏倦
困兽	困獸
困兽之斗	困獸之鬭
困兽犹斗	困獸猶鬭
困厄	困厄
困围	困圍
困在	困在
困境	困境
困处	困處
困学	困學
困守	困守
困局	困局
困惑	困惑
困惫	困憊
困扰	困擾
困斗	困鬭
困歇	困歇
困滞	困滯
困畏	困畏
困穷	困窮
困窘	困窘
困竭	困竭
困苦	困苦
困觉	睏覺
困话	困話
困踬	困躓
困蹙	困蹙
困阨	困阨
困阻	困阻
困隘	困隘
困难	困難
困顿	困頓
囱	囪
围	圍
围了	圍了
围困	圍困
围岩	圍巖
囵	圇
固于	固於
固征	固徵
国	國
国之桢干	國之楨榦
国于	國於
国仇	國讎
国别	國別
国历	國曆
国戚	國戚
国术	國術
国药	國藥
图	圖
图录	圖錄
图板	圖板
图表	圖表
图里	圖裏
图鉴	圖鑑
囿于	囿於
圆	圓
圆台	圓臺
圆周	圓周
圆板	圓板
圆雕	圓雕
圈占	圈佔
圈子里	圈子裏
圈梁	圈樑
圈里	圈裏
土制	土製
土参	土參
土布	土布
土种	土種
土药	土藥
土里	土裏
圣	聖
圣坛	聖壇
在于	在於
在克制	在剋制
在出	在出
在台	在臺
在种	在種
圭表	圭表
地丑德齐	地醜德齊
地价	地價
地克制	地剋制
地占	地佔
地当	地當
地志	地誌
地板	地板
地极	地極
地蜡	地蠟
地表	地表
地里	地里
地面	地面
圹	壙
场	場
场合	場合
场面	場面
坊曲	坊曲
坍台	坍臺
坏	壞
坏了	壞了
坏于	坏於
坏恶	壞惡
坐了	坐了
坐困	坐困
坐如钟	坐如鐘
坐庄	坐莊
坐致	坐致
坐药	坐藥
坐蜡	坐蠟
坐钟	坐鐘
坑蒙	坑蒙
坑里	坑裏
块	塊
坚	堅
坚致	堅緻
坛	壇
坛兆	壇兆
坛台	壇臺
坛场	壇場
坛坛罐罐	罈罈罐罐
坛坫	壇坫
坛城	壇城
坛子	罈子
坛宇	壇宇
坛騞	罈騞
坜	壢
坝	垻
坞	塢
坟	墳
坠	墜
坤极	坤極
坤范	坤範
坦克	坦克
坦涂	坦塗
坦荡	坦蕩
坦荡荡	坦蕩蕩
坨里	坨里
坯布	坯布
坱郁	坱鬱
垂了	垂了
垂于	垂於
垂发	垂髮
垂帘	垂簾
垂范	垂範
垂面	垂面
垄	壟
垆	壚
型别	型別
型录	型錄
型范	型範
垒	壘
垢面	垢面
垦	墾
垦复	墾複
垦辟	墾闢
垩	堊
垫	墊
垫个	墊個
垫了	墊了
垫出	墊出
垫发	墊發
垫回	墊回
垫板	墊板
垭	埡
垮了	垮了
垮台	垮臺
垮向	垮向
垲	塏
垻台	垻臺
埃及历	埃及曆
埃及艳后	埃及豔后
埃荣冲	埃榮衝
埋了	埋了
埋头寻表	埋頭尋錶
埋头寻钟	埋頭尋鐘
埋布	埋佈
城里	城裏
城雕	城雕
埔裡社撫墾局	埔裏社撫墾局
埔里	埔里
埔里社抚垦局	埔裏社撫墾局
埘	塒
埙	塤
埚	堝
埯	垵
基于	基於
基准	基準
基团	基團
基岩	基岩
基干	基幹
基板	基板
基极	基極
堂布	堂布
堆了	堆了
堑	塹
堕	墮
堕胎药	墮胎藥
堙淀	堙澱
堪布	堪布
堪当	堪當
塌台	塌臺
塑炼	塑煉
塔台	塔臺
塔吊	塔吊
塔布	塔布
塞药	塞藥
填个	填個
填了	填了
填发	填發
填表	填表
墓志	墓誌
墓表	墓表
墙	牆
墙里	牆裏
墙面	牆面
增修	增修
增辟	增闢
墟里	墟里
墨卷	墨卷
墨斗	墨斗
墨沈	墨沈
墨沈未干	墨瀋未乾
墩台	墩臺
墩布	墩布
壁志	壁誌
壑谷	壑谷
壮	壯
壮志	壯志
壮游	壯遊
壮面	壯麵
声	聲
声价	聲價
壳	殼
壳里	殼裏
壶	壷
壶里	壷裏
壷里	壷裏
壸范	壼範
壹郁	壹鬱
处	處
处了	處了
处于	處於
备	備
备尝	備嘗
备御	備禦
备注	備註
复	復
复三	復三
复上	覆上
复业	復業
复习	複習
复书	復書
复亡	覆亡
复交	復交
复亩珍	複畝珍
复仇	復仇
复仞年如	複仞年如
复以百万	複以百萬
复任	復任
复位	複位
复住	覆住
复信	覆信
复健	復健
复元	復元
复元音	複元音
复兴	復興
复冒	覆冒
复写	複寫
复军	覆軍
复冰	復冰
复决	複決
复出	復出
复函	復函
复函数	複函數
复分数	複分數
复分析	複分析
复分解	複分解
复刊	復刊
复列	複列
复利	複利
复制	複製
复刻	復刻
复卒	復卒
复印	複印
复原	復原
复发	複發
复变函数	複變函數
复古	復古
复句	複句
复叶	複葉
复合	複合
复名	複名
复呈	覆呈
复员	複員
复命	覆命
复回	復回
复国	復國
复圆	復圓
复土	復土
复圣	復聖
复在	覆在
复墓	覆墓
复壁	複壁
复壮	複壯
复复	複復
复始	復始
复姓	複姓
复婚	復婚
复字键	複字鍵
复学	復學
复宗	覆宗
复审	複審
复对数	複對數
复工	復工
复帐	覆帳
复帱	覆幬
复平面	複平面
复建	復建
复式	複式
复役	復役
复思	復思
复意	複意
复成	覆成
复手	覆手
复按	覆按
复政	復政
复数	複數
复文	覆文
复新	復新
复方	複方
复旦	復旦
复旧	復舊
复明	復明
复本	複本
复杂	複雜
复权	復權
复杯	覆杯
复果	複果
复查	複査
复査	複査
复校	覆校
复核	複核
复案	復案
复检	複檢
复次	複次
复比	複比
复水	覆水
复没	覆沒
复活	復活
复流	複流
复测	複測
复灭	覆滅
复现	復現
复瓿	覆瓿
复甕	覆甕
复生	復生
复电	覆電
复盂	覆盂
复盆	覆盆
复盐	複鹽
复盖	覆蓋
复盘	覆盤
复目	複目
复眼	複眼
复礼	復禮
复种	複種
复称	複稱
复穴	複穴
复籍	復籍
复线	複綫
复职	復職
复肥	複肥
复育	覆育
复舟	覆舟
复色	複色
复苏	復甦
复蔽	覆蔽
复被	覆被
复襦	複襦
复视	複視
复议	複議
复评	複評
复诊	複診
复词	複詞
复试	複試
复诵	複誦
复读	復讀
复课	復課
复败	覆敗
复赛	複賽
复身	復身
复车	覆車
复载	覆載
复辅音	複輔音
复辙	覆轍
复辟	復辟
复述	複述
复逆	覆逆
复选	複選
复道	複道
复醒	復醒
复醢	覆醢
复钱	複錢
复阁	複閣
复阅	複閱
复除	復除
复雠	復讎
复露	覆露
复音	複音
复韵	複韻
复频	複頻
复魄	復魄
复鼎	覆鼎
复𫗧	覆餗
夏于乔	夏于喬
夏于喬	夏于喬
夏历	夏曆
夏天里	夏天裏
夏布	夏布
夏日里	夏日裏
夏游	夏遊
夏种	夏種
夏虫	夏蟲
夕烟	夕煙
外借	外借
外出	外出
外制	外製
外厂	外廠
外向	外向
外强中干	外強中乾
外戚	外戚
外才	外才
外挂	外掛
外汇	外匯
外涂	外塗
外烟	外菸
外舍	外舍
外蒙	外蒙
外表	外表
外面	外面
夙仇	夙仇
夙愿	夙願
多丑	多醜
多么	多麼
多于	多於
多云	多雲
多余	多餘
多借	多借
多党	多黨
多冲	多衝
多划	多劃
多占	多佔
多只	多隻
多台	多臺
多向	多向
多回	多回
多幸	多幸
多当	多當
多彩	多彩
多才	多才
多欲	多欲
多种	多種
多表	多表
多面	多面
夜光表	夜光錶
夜台	夜臺
夜合	夜合
夜暗	夜暗
夜曲	夜曲
夜游	夜遊
夜里	夜裏
够	够
够了	够了
够克制	够剋制
够凶	够兇
够出	够出
够涂	够塗
够种	够種
大丑	大丑
大个	大個
大丰	大豐
大于	大於
大伙	大夥
大修	大修
大党	大黨
大冲	大衝 大沖
大凶	大凶
大别	大別
大千	大千
大卷	大卷
大厂	大廠
大历	大曆
大发	大發
大只	大隻
大同	大同
大呆	大呆
大周后	大周后
大周折	大週摺
大咸	大咸
大回	大回
大团	大團
大型钟	大型鐘
大夸	大誇
大奸	大奸
大娘	大娘
大尽	大盡
大布	大布
大干	大幹
大幸	大幸
大当	大當
大志	大志
大恶	大惡
大才	大才
大批涌到	大批涌到
大折儿	大摺兒
大搜	大搜
大摆	大擺
大斗	大斗
大明历	大明曆
大曲	大麯
大本钟	大本鐘
大板	大板
大梁	大樑 大梁
大欲	大欲
大烟	大煙
大病初愈	大病初癒
大症	大症
大目干连	大目乾連
大秋	大秋
大笨钟	大笨鐘
大系	大系
大胜	大勝
大致	大致
大舍	大舍
大虫	大蟲
大蜡	大蜡
大衍历	大衍曆
大言非夸	大言非夸
大赞	大讚
大辟	大辟
大采	大采
大里	大里
大钟	大鐘
大锤	大錘
大面	大面
天价	天價
天克地冲	天克地衝
天历	天曆
天台	天台 天臺
天后	天後 天后
天地为范	天地爲範
天坛	天壇
天复	天覆
天干	天干
天干物燥	天乾物燥
天幸	天幸
天才	天才
天文学钟	天文學鐘
天文钟	天文鐘
天暗	天暗
天表	天表
太仆	太僕
太冲	太沖
太初历	太初曆
太卜	太卜
太后	太后
太极	太極
夫党	夫黨
夫娘	夫娘
夭折	夭折
夯干	夯幹
失于	失於
失修	失修
失出	失出
失当	失當
失志	失志
失据	失據
头	頭
头发	頭髮
头回	頭回
头巾吊在水里	頭巾弔在水裏
头当	頭當
头彩	頭彩
头板	頭板
头柜	頭櫃
头里	頭裏
头面	頭面
夸	誇
夸丽	夸麗
夸了	誇了
夸人	夸人
夸克	夸克
夸功	誇功
夸口	誇口
夸嘴	誇嘴
夸多斗靡	誇多鬭靡
夸大	誇大
夸夸	誇誇
夸夸其谈	夸夸其談
夸奖	誇獎
夸姣	夸姣
夸官	誇官
夸容	夸容
夸尔	夸爾
夸张	誇張
夸得	誇得
夸成	誇成
夸毗	夸毗
夸父	夸父
夸特	夸特
夸示	誇示
夸耀	誇耀
夸脱	夸脫
夸诞	夸誕
夸诩	誇詡
夸说	誇說
夸赞	誇讚
夸起	誇起
夸辩	誇辯
夸过	誇過
夸饰	誇飾
夹	夾
夹个	夾個
夹了	夾了
夹克	夾克
夹板	夾板
夹注	夾註
夺	奪
夺回	奪回
夺彩	奪彩
夺志	奪志
夺斗	奪鬭
奁	奩
奂	奐
奇丑	奇醜
奇岩	奇巖
奇志	奇志
奇才	奇才
奇术	奇術
奇迹	奇蹟
奈向	奈向
奉别	奉別
奉复	奉復
奉干	奉干
奉系	奉系
奉药	奉藥
奉表	奉表
奋	奮
奋发	奮發
奋志	奮志
奋斗	奮鬭
奏了	奏了
奏于	奏於
奏出	奏出
奏折	奏摺
奏曲	奏曲
奏表	奏表
契合	契合
契据	契據
奔出	奔出
奔向	奔向
奔回	奔回
奖	獎
奖借	獎借
奖杯	獎杯
奖赞	獎贊
套个	套個
套了	套了
套出	套出
套曲	套曲
套板	套板
套汇	套匯
套种	套種
奥	奧
奥占	奧佔
女丑	女丑
女仆	女僕
女佣	女傭
女娘	女娘
女御	女御
女杰	女傑
奴仆	奴僕
奴才	奴才
奶卷	奶捲
奶娘	奶孃
奸人	奸人
奸伏	姦伏
奸佞	奸佞
奸俏	奸俏
奸党	奸黨
奸凶	姦凶
奸刁	奸刁
奸匪	奸匪
奸商	奸商
奸夫	姦夫
奸妇	姦婦
奸宄	奸宄
奸巧	奸巧
奸徒	奸徒
奸情	姦情
奸慝	奸慝
奸杀	姦殺
奸棍	奸棍
奸毒	奸毒
奸汙	姦汙
奸污	姦汙
奸淫	姦淫
奸滑	奸滑
奸狡	奸狡
奸猾	奸猾
奸笑	奸笑
奸细	奸細
奸臣	奸臣
奸言	奸言
奸计	奸計
奸诈	奸詐
奸谋	奸謀
奸贼	奸賊
奸通	姦通
奸邪	奸邪
奸险	奸險
奸雄	奸雄
奸非	姦非
奸顽	奸頑
奸骗	奸騙
奸黠	奸黠
她克制	她剋制
她出	她出
好丑	好醜
好个	好個
好了	好了
好于	好於
好价	好價
好几	好幾
好凶	好凶
好出	好出
好合	好合
好向	好向
好呆	好呆
好困	好睏
好家伙	好傢夥
好干	好乾
好当	好當
好恶	好惡
好斗	好鬭
好签	好籤
好胜	好勝
如于	如於
如云	如雲
如同	如同
如干	如干
如愿	如願
如果干	如果幹
如须	如須
如饥似渴	如饑似渴
妆	妝
妆台	妝臺
妇	婦
妈	媽
妖后	妖后
妖术	妖術
妙才	妙才
妙曲	妙曲
妙极	妙極
妙药	妙藥
妢胡	妢胡
妥当	妥當
妩	嫵
妪	嫗
妫	嬀
妻党	妻黨
始于	始於
始愿	始願
姌袅	姌嫋
姑娘	姑娘
姑恶	姑惡
姑苏	姑蘇
姑表	姑表
姓系	姓系
委托	委託
委曲	委曲
姗	姍
姜丝	薑絲
姜夔	姜夔
姜嫄	姜嫄
姜尚	姜尚
姜文杰	姜文杰
姜是老的辣	薑是老的辣
姜末	薑末
姜桂	薑桂
姜母	薑母
姜汁	薑汁
姜汤	薑湯
姜片	薑片
姜糖	薑糖
姜维	姜維
姜老辣	薑老辣
姜芋	姜芋
姜茶	薑茶
姜蓉	薑蓉
姜被	姜被
姜饼	薑餅
姜黄	薑黃
姨娘	姨娘 姨孃
姨表	姨表
姬姜	姬姜
姱修	姱修
姹	奼
姻党	姻黨
姻戚	姻戚
威棱	威棱
娄	婁
娅	婭
娆	嬈
娇	嬌
娇娘	嬌娘
娈	孌
娘亲	孃親
娘儿	孃兒
娘姨	孃姨
娘娘	娘娘
娘婆	娘婆
娘子	娘子
娘家	孃家
娘的	孃的
娘胎	孃胎
娘舅	孃舅
娩出	娩出
娱	娛
娲	媧
娲杆	媧杆
娴	嫻
娴于	嫻於
娶了	娶了
婆娘	婆娘
婚后	婚後
婢仆	婢僕
婴	嬰
婵	嬋
婶	嬸
婶娘	嬸孃
媒合	媒合
媪	媼
媵御	媵御
嫁个	嫁個
嫁了	嫁了
嫁于	嫁於
嫁出	嫁出
嫉恶	嫉惡
嫌凶	嫌兇
嫌好道丑	嫌好道醜
嫌恶	嫌惡
嫒	嬡
嫔	嬪
嫔御	嬪御
嫡出	嫡出
嫡系	嫡系
嫩叶	嫩葉
嫱	嬙
嬉游	嬉遊
嬖幸	嬖倖
嬴余	嬴餘
嬷	嬤
子之丰兮	子之丰兮
子云	子云
子叶	子葉
子游	子游
孔虫	孔蟲
孕出	孕出
孕穗	孕穗
孖虫	孖蟲
字据	字據
字汇	字彙
字表	字表
字里行间	字裏行間
字面	字面
存于	存於
存录	存錄
存折	存摺
孙	孫
孝布	孝布
孟冬	孟冬
孟秋	孟秋
孟获	孟獲
季冬	季冬
季咸	季咸
季布	季布
季秋	季秋
孤云	孤雲
孤征	孤征
孤注	孤注
孤涂	孤塗
孤游	孤遊
学	學
学制	學制
学历	學曆 學歷
学台	學臺
学回	學回
学术	學術
学系	學系
学舍	學舍
学里	學裏
孪	孿
孬种	孬種
孱困	孱困
孵出	孵出
孽党	孽黨
孽种	孽種
宁	寧
宁个	寧個
宁愿	寧願
宇宙志	宇宙誌
守制	守制
守御	守禦
守舍	守舍
安了	安了
安于	安於
安扎	安扎
安沈铁路	安瀋鐵路
安眠药	安眠藥
安胎药	安胎藥
安胡	安胡
安适	安適
宋克	宋克
宋板	宋板
完了	完了
宏志	宏志
宏愿	宏願
宗周	宗周
宗周钟	宗周鐘
官价	官價
官准	官准
官制	官制
官卷	官卷
官历	官曆
官地为采	官地爲寀
官庄	官莊
官舍	官舍
官面	官面
定了	定了
定于	定於
定价	定價
定准	定準
定出	定出
定制	定製
定向	定向
定当	定當
宜于	宜於
宜云	宜云
宝	寶
宝丰	寶丰 寶豐
宝卷	寶卷
宝历	寶曆
宝庄	寶莊
宝志	寶誌
宝里宝气	寶裏寶氣
宝鉴	寶鑑
实	實
实价	實價
实发	實發
实干	實幹
实录	實錄
实才	實才
实据	實據
实症	實症
宠	寵
宠幸	寵幸
审	審
客游	客遊
客舍	客舍
宣卷	宣卷
宣布	宣布
宣泄	宣泄
宣赞	宣贊
宦游	宦遊
宪	憲
宪台	憲臺
宫	宮
宫里	宮裏
宰制	宰制
害于	害於
害发	害發
害虫	害蟲
宴游	宴遊
宵征	宵征
家丑	家醜
家仆	家僕
家伙	傢伙
家俱	傢俱
家具	傢具
家制	家制
家庄	家莊
家当	家當
家种	家種
家系	家系
家里	家裏
宸极	宸極
宸游	宸遊
容于	容於
容幸	容幸
容范	容範
容表	容表
宽	寬
宽了	寬了
宽于	寬於
宽余	寬餘
宽宽松松	寬寬鬆鬆
宽松	寬鬆
宾	賓
宿志	宿志
宿愿	宿願
宿舍	宿舍
寂历	寂歷
寄了	寄了
寄于	寄於
寄出	寄出
寄发	寄發
寄回	寄回
寄托	寄託
寅台	寅臺
密云	密雲
密仑	密侖
密合	密合
密布	密布
密致	密緻
寇仇	寇仇
寇准	寇準
富于	富於
富余	富餘
富里	富里
寒于	寒於
寒假里	寒假裏
寒冬	寒冬
寒栗	寒慄
寒症	寒症
寒秋	寒秋
寒舍	寒舍
寓于	寓於
寝	寢
寡占	寡佔
寡合	寡合
寡欲	寡慾
寮采	寮寀
寶曆	寶曆
寸发千金	寸髮千金
对	對
对了	對了
对于	對於
对准	對準
对准表	對準錶
对准钟	對準鐘
对台	對臺
对合	對合
对当	對當
对折	對摺
对症	對症
对表	對錶
对针	對針
对面	對面
寺舍	寺舍
寺钟	寺鐘
寻	尋
寻仇	尋仇
寻出	尋出
寻获	尋獲
导	導
导出	導出
导向	導向
导板	導板
导游	導遊
导致	導致
寿	壽
寿丰	壽豐
寿面	壽麵
封个	封個
封了	封了
封台	封臺
封后	封后
封弥	封彌
封蜡	封蠟
封里	封裏
封面	封面
封面里	封面裏
射了	射了
射出	射出
射向	射向
射回	射回
射复	射覆
射干	射干
射雕	射鵰
将	將
将于	將於
将出	將出
将占	將佔
将回	將回
将尽	將盡
将才	將才
小丑	小丑
小个	小個
小了	小了
小于	小於
小仆	小僕
小价	小价
小伙	小伙
小伙子	小夥子
小修	小修
小几	小几
小别	小別
小厂	小廠
小发	小發
小只	小隻
小叶	小葉
小周后	小周后
小回	小回
小型钟	小型鐘
小娘	小娘
小尝	小嚐
小尽	小盡
小庵	小庵
小曲	小曲
小板	小板
小注	小注
小秋	小秋
小种	小種
小穗	小穗
小筑	小築
小米面	小米麵
小系	小系
小胜	小勝
小苏	小蘇
小范	小范
小虫	小蟲
小针	小針
少了	少了
少于	少於
少出	少出
少占	少佔
少吊	少吊
少采	少採
尔	爾
尔冬升	爾冬升
尔后	爾後
尔当	爾當
尖团	尖團
尘	塵
尘表	塵表
尚志	尚志
尚须	尚須
尝	嘗
尝个	嚐個
尝了	嚐了
尝出	嚐出
尝到	嚐到
尝尝	嘗嘗
尝巧	嘗巧
尝敌	嘗敵
尝新	嘗新
尝点	嚐點
尝胆	嘗膽
尝膳	嘗膳
尝草	嘗草
尝药	嘗藥
尝试	嘗試
尝酸	嘗酸
尤须	尤須
尧	堯
尧布	堯布
就于	就於
就克制	就剋制
就出	就出
就回	就回
就当	就當
就范	就範
就里	就裏
尴	尷
尸	屍
尸位	尸位
尸位素餐	尸位素餐
尸体	屍體
尸僵	屍僵
尸利	尸利
尸变	屍變
尸居余气	尸居餘氣
尸斑	屍斑
尸格	屍格
尸榇	屍櫬
尸灵	屍靈
尸祝	尸祝
尸禄	尸祿
尸臣	尸臣
尸蜡	屍蠟
尸衣	屍衣
尸解	尸解
尸谏	尸諫
尸身	尸身
尸饔	尸饔
尸首	屍首
尸骨	屍骨
尸骸	屍骸
尸魂界	尸魂界
尸鸠	尸鳩
尺板	尺板
尼克	尼克
尼坛	尼壇
尼庵	尼庵
尼采	尼采
尽	盡
尽世	盡世
尽了	盡了
尽些	盡些
尽人	盡人
尽信	盡信
尽做	盡做
尽先	儘先
尽兴	盡興
尽其	盡其
尽其所有	儘其所有
尽到	盡到
尽力	儘力
尽去	盡去
尽可	儘可
尽可能	儘可能
尽命	盡命
尽善	盡善
尽在	盡在
尽够	儘够
尽失	盡失
尽头	盡頭
尽如	盡如
尽子	儘子
尽孝	盡孝
尽尽	儘儘
尽属	盡屬
尽席	盡席
尽年	盡年
尽得	盡得
尽心	盡心
尽忠	盡忠
尽快	儘快
尽性	儘性 盡性
尽情	盡情
尽想	儘想
尽意	盡意
尽教	儘教
尽散	盡散
尽数	盡數
尽日	盡日
尽早	儘早
尽是	盡是
尽欢	盡歡
尽然	盡然
尽瘁	盡瘁
尽礼	盡禮
尽端	盡端
尽管	儘管
尽职	盡職
尽能	盡能
尽自	儘自
尽致	盡致
尽节	盡節
尽若	盡若
尽要	盡要
尽言	盡言
尽让	儘讓
尽读	盡讀
尽责	盡責
尽述	盡述
尽速	儘速
尽量	儘量
尽量克制	盡量剋制
尿布	尿布
尿斗	尿斗
局里	局裏
局面	局面
屁股大吊了心	屁股大弔了心
层	層
层云	層雲
层出	層出
层台	層臺
层面	層面
居于	居於
居里	居里
屈志	屈志
屈才	屈才
屈折	屈折
屈曲	屈曲
屉	屜
届	屆
屋子里	屋子裏
屋梁	屋樑
屋舍	屋舍
屋里	屋裏
屋面	屋面
屏当	屏當
屏极	屏極
屑于	屑於
展出	展出
展卷	展卷
展布	展布
展才	展才
展采	展采
属	屬
属于	屬於
属托	屬託
屠苏	屠蘇
屡	屢
屡顾尔仆	屢顧爾僕
履历	履歷
屦	屨
屯扎	屯紮
屯里	屯裏
山后	山後
山向	山向
山岩	山岩
山岳	山嶽
山崩钟应	山崩鐘應
山庄	山莊
山斗	山斗
山梁	山樑
山棱	山棱
山洞里	山洞裏
山系	山系
山羊胡	山羊鬍
山苏	山蘇
山药	山藥
山谷	山谷
山里	山裏
山重水复	山重水複
屿	嶼
岁	歲
岁修	歲修
岁凶	歲凶
岁出	歲出
岁聿云暮	歲聿云暮
岂	豈
岂只	豈只
岐周	岐周
岑参	岑參
岔曲	岔曲
岖	嶇
岗	崗
岘	峴
岙	嶴
岚	嵐
岛	島
岩圈	岩圈
岩基	岩基
岩壁	巖壁
岩层	岩層
岩居	巖居
岩屑	岩屑
岩岩	巖巖
岩岸	巖岸
岩巉	巖巉
岩床	岩床
岩徼	巖徼
岩心	岩心
岩棉	岩棉
岩洞	巖洞
岩浆	岩漿
岩溶	岩溶
岩盐	岩鹽
岩石	岩石
岩礁	岩礁
岩穴	巖穴
岩羊	岩羊
岩脉	岩脈
岩邑	巖邑
岩郎	巖郎
岩阻	巖阻
岩陛	巖陛
岭	嶺
岭表	嶺表
岱岳	岱嶽
岳岳	嶽嶽
岳麓	嶽麓
岿	巋
峄	嶧
峡	峽
峡谷	峽谷
峤	嶠
峥	崢
峦	巒
峰回	峰迴
峰岩	峰巖
峻岭	峻岭
峻极	峻極
崂	嶗
崃	崍
崑仑	崑崙
崑曲	崑曲
崔涂	崔塗
崖广	崖广
崤谷	崤谷
崩症	崩症
崭	嶄
嵌岩	嵌巖
嵘	嶸
嵝	嶁
嵫厘	嵫釐
嶒棱	嶒棱
嶰谷	嶰谷
嶽云	嶽雲
巅	巔
巉岩	巉巖
川后	川后
川谷	川穀
州同	州同
州里	州里
巡回	巡迴
巡幸	巡幸
巡游	巡遊
工于	工於
工价	工價
工党	工黨
工厂	工廠
工团	工團
工种	工種
工致	工緻
左冲右突	左衝右突
左后	左後
左向	左向
左面	左面
巧了	巧了
巧历	巧曆
巧合	巧合
巧干	巧幹
巨万	巨萬
巨奸	巨奸
巩	鞏
巫咸	巫咸
巫术	巫術
差于	差於
差价	差價
差别	差別
差发	差發
差恶	差惡
巯	巰
己丑	己丑
已于	已於
已占	已佔
已极	已極
巴尔干	巴爾幹
巴斗	巴斗
巴游	巴游
巴里	巴里
巷里	巷裏
币	幣
币制	幣制
市价	市價
市占	市佔
市里	市裏
市面	市面
布丁	布丁
布下	佈下
布丹	布丹
布于	佈於
布伞	布傘
布偶	布偶
布农	布農
布划	佈劃
布列	布列
布匹	布匹
布叶	布葉
布合	布合
布告	布告
布哨	佈哨
布复	布覆
布头	布頭
布婚	布婚
布宁	布寧
布宪	布憲
布尔	布爾
布局	布局
布岗	佈崗
布巾	布巾
布帆	布帆
布希	布希
布帘	布帘
布帛	布帛
布幕	布幕
布庄	布莊
布店	布店
布德	布德
布慈	布慈
布摆	佈擺
布政	布政
布教	布教
布散	佈散
布料	布料
布施	佈施
布景	布景
布朗	布朗
布望	布望
布条	布條
布桩	布樁
布梏	布梏
布气	布氣
布水	布水
布满	布滿
布濩	布濩
布特	布特
布疋	布疋
布白	布白
布算	布算
布篷	布篷
布素	布素
布线	布綫
布缦	布縵
布置	布置
布署	布署
布耳	布耳
布臆	布臆
布色	布色
布荆	布荊
布菜	佈菜
布萨	布薩
布衣	布衣
布衫	布衫
布袋	布袋
布被	布被
布褐	布褐
布让	佈讓
布谷	布穀
布谷鸟钟	布穀鳥鐘
布货	布貨
布边	布邊
布达	布達
布道	佈道
布防	布防
布阵	布陣
布雪	布雪
布雷	布雷
布雷封锁	佈雷封鎖
布雷的	佈雷的
布雷舰	佈雷艦
布雷艇	佈雷艇
布雷速度	佈雷速度
布面	布面
布鞋	布鞋
帅	帥
帆布	帆布
师	師
师团	師團
师娘	師孃
师范	師範
师表	師表
希伯来历	希伯來曆
帏	幃
帐	帳
帐面	帳面
帘	簾
帘子	簾子
帘官	簾官
帘布	簾布
帘帐	簾帳
帘帷	簾帷
帘幔	簾幔
帘幕	簾幕
帘栊	簾櫳
帘波	簾波
帜	幟
帝制	帝制
带	帶
带个	帶個
带了	帶了
带出	帶出
带发修行	帶髮修行
带同	帶同
带回	帶回
带团	帶團
带征	帶徵
帧	幀
席卷	席捲
席胜	席勝
席面	席面
帮	幫
帮伙	幫夥
帮佣	幫傭
帮冬	幫冬
帮凶	幫兇
帮别	幫別
帱	幬
常价	常價
常向	常向
常回	常回
常胜	常勝
常须	常須
帻	幘
帼	幗
帽帘	帽簾
幂	冪
幅面	幅面
幕后	幕後
幞	襆
幡布	幡布
干上	幹上
干下去	幹下去
干不了	幹不了
干不成	幹不成
干与	干與
干丝	乾絲
干个	幹個
干个够	乾個够
干么	幹麼
干乔	乾喬
干了	幹了 乾了
干事	幹事
干井	乾井
干些	幹些
干产	乾產
干亲	乾親
干人	幹人
干什么	幹什麼
干休	干休
干儿	乾兒
干元	乾元
干冰	乾冰
干冷	乾冷
干净	乾淨
干凉	乾涼
干刍	乾芻
干刻版	乾刻版
干剥剥	乾剝剝
干办	幹辦
干劲	幹勁
干劲冲天	幹勁沖天
干卦	乾卦
干台	乾颱
干号	乾號
干吊着下巴	乾吊着下巴
干吏	幹吏
干吗	幹嗎
干呕	乾嘔
干员	幹員
干和	乾和
干咳	乾咳
干咽	乾咽
干哕	乾噦
干哥	乾哥
干哭	乾哭
干唱	乾唱
干啥	幹啥
干啼	乾啼
干嘛	幹嘛
干嚎	乾嚎
干回付	乾回付
干图	乾圖
干圆洁净	乾圓潔淨
干地	乾地
干坏事	幹壞事
干坞	乾塢
干坤	乾坤
干头	幹頭
干女	乾女
干奴才	乾奴才
干妈	乾媽
干妹	乾妹
干姊	乾姊
干姜	乾薑
干娘	乾孃
干子	乾子
干季	乾季
干宅	乾宅
干完	幹完
干家	幹家
干将	幹將
干尸	乾屍
干屎橛	乾屎橛
干巴	乾巴
干干	乾乾
干干净净	乾乾淨淨
干式	乾式
干弟	乾弟
干当	幹當
干得	幹得
干急	乾急
干性	乾性
干性油	幹性油
干戈	干戈
干才	幹才
干打雷	乾打雷
干扰	干擾
干折	乾折
干掉	幹掉
干探	幹探
干撂台	乾撂台
干撇下	乾撇下
干擦	乾擦
干支	干支
干支剌	乾支剌
干支支	乾支支
干政	干政
干料	乾料
干断	乾斷
干旦	乾旦
干旱	乾旱
干时	干時
干暖	乾暖
干曜	乾曜
干材	乾材
干村沙	乾村沙
干杯	乾杯
干果	乾果
干枯	乾枯
干柴	乾柴
干校	幹校
干梅	乾梅
干死	乾死
干池	乾池
干沟	乾溝
干没	乾沒
干洗	乾洗
干活	幹活
干流	幹流
干济	幹濟
干涉	干涉
干涩	乾澀
干涸	乾涸
干淨	乾淨
干渠	乾渠
干渴	乾渴
干湿	乾濕
干漆	乾漆
干灯盏	乾燈盞
干热	乾熱
干熬	乾熬
干熱	乾熱
干燥	乾燥
干父之蛊	幹父之蠱
干爸	乾爸
干爹	乾爹
干爽	乾爽
干片	乾片
干犯	干犯
干球温度	幹球溫度
干甚么	幹甚麼
干生受	乾生受
干生子	乾生子
干田	乾田
干电	乾電
干略	幹略
干疥	乾疥
干瘦	乾瘦
干瘪	乾癟
干瘾	乾癮
干癣	乾癬
干白儿	乾白兒
干的	乾的
干的停当	幹的停當
干眼	乾眼
干着	乾着
干着急	干着急
干瞪眼	乾瞪眼
干礼	乾禮
干稿	乾稿
干笑	乾笑
干等	乾等
干篾片	乾篾片
干粉	乾粉
干粮	乾糧
干糇	乾餱
干系	干係
干細胞	幹細胞
干红	乾紅
干纲	乾綱
干线	幹綫
干练	幹練
干细胞	幹細胞
干结	乾結
干绷	乾繃
干缺	幹缺
干群关系	幹群關係
干耗	乾耗
干肉片	乾肉片
干股	乾股
干肥	乾肥
干脆	乾脆
干花	乾花
干苔	乾苔
干茨腊	乾茨臘
干茶钱	乾茶錢
干草	乾草
干菜	乾菜
干营生	幹營生
干落	乾落
干薪	乾薪
干虔	乾虔
干蛊	幹蠱
干血浆	乾血漿
干衣	乾衣
干裂	乾裂
干警	幹警
干象	乾象
干贝	乾貝
干货	乾貨
干起来	幹起來
干路	幹路
干躁	乾躁
干这一行	幹這一行
干这种事	幹這種事
干造	乾造
干逼	乾逼
干道	幹道
干部	幹部
干酪	乾酪
干酵母	乾酵母
干醋	乾醋
干重	乾重
干量	乾量
干阿奶	乾阿奶
干隆	乾隆
干雷	乾雷
干霍乱	乾霍亂
干面	乾麵
干革命	幹革命
干预	干預
干颡	乾顙
干饭	乾飯
干馆	乾館
干馏	乾餾
干鱼	乾魚
干鲜	乾鮮
平个	平個
平了	平了
平价	平價
平准	平準
平台	平臺
平复	平復
平板	平板
平梁	平梁
平泉庄	平泉莊
平胡	平胡
平表	平表
平谷	平谷
平雕	平雕
平面	平面
年代里	年代裏
年几	年幾
年历	年曆
年台	年臺
年后	年後
年表	年表
年谷	年穀
年里	年裏
年鉴	年鑑
并	並
并一不二	併一不二
并上	並上
并不	並不
并与	並與
并且	並且
并世	並世
并为一体	併爲一體
并为一家	併爲一家
并举	並舉
并于	並於
并产	併產
并从	並從
并会	並會
并作	並作
并先	並先
并入	併入
并兴	並興
并兼	併兼
并再	並再
并出	並出
并刀	並刀
并列	並列
并到	併到
并力	並力
并包	並包
并发	併發
并叠	併疊
并可	並可
并合	併合
并同	並同
并名	併名
并吞	併吞
并吞下	併吞下
并回	並回
并在	並在
并坐	並坐
并头	並頭
并存	並存
并存着	並存着
并寿	並壽
并将	並將
并州	並州
并当	並當
并往	並往
并得	並得
并成	併成
并拢	併攏
并排	並排
并无	並無
并日	並日
并日而食	並日而食
并时	並時
并是	並是
并曰入淀	並曰入澱
并有	並有
并未	並未
并条	並條
并案	併案
并毂	並轂
并没	並沒
并派	並派
并流	併流
并火	併火
并然	並然
并爲	並爲
并用	並用
并由	並由
并禽	並禽
并科	併科
并称	並稱
并立	並立
并线	併綫
并网	併網
并联	並聯
并肩	並肩
并肩子	併肩子
并能	並能
并蒂	並蒂
并行	並行
并要	並要
并论	並論
并请	並請
并购	併購
并起	並起
并蹟	並蹟
并躺	並躺
并轨	並軌
并辏	並輳
并辔	並轡
并过	並過
并进	並進
并迭	並迭
并邀	並邀
并邦	並邦
并邻	並鄰
并重	並重
并除	併除
并非	並非
并马	並馬
并驰	並馳
并驱	並驅
并驾	並駕
并骛	並騖
并骨	併骨
幸于	幸於
幸亏	幸虧
幸会	幸會
幸位	幸位
幸倡	幸倡
幸免	倖免
幸喜	幸喜
幸好	幸好
幸存	倖存
幸幸	倖幸
幸得	幸得
幸未	幸未
幸民	幸民
幸然	幸然
幸甚	幸甚
幸生	幸生
幸福	幸福
幸童	幸童
幸而	幸而
幸能	幸能
幸臣	幸臣
幸蒙	幸蒙
幸运	幸運
幸运胡	幸運鬍
幸进	倖進
幸逢	幸逢
幻出	幻出
幻术	幻術
幼托	幼托
幼虫	幼蟲
幽岩	幽巖
幽暗	幽暗
幽谷	幽谷
广	廣
广布	廣布
广征	廣徵
广舍	廣捨
广部	广部
广里	廣裏
庄上	莊上
庄严	莊嚴
庄主	莊主
庄农	莊農
庄员	莊員
庄周	莊周
庄园	莊園
庄士顿道	莊士頓道
庄子	莊子
庄客	莊客
庄家	莊家
庄户	莊戶
庄房	莊房
庄敬	莊敬
庄田	莊田
庄稼	莊稼
庄舄越吟	莊舄越吟
庄语	莊語
庄里	莊裏
庄重	莊重
庄院	莊院
庄骚	莊騷
庆	慶
庆云	慶雲
庆历	慶曆
庆吊	慶弔
庆幸	慶幸
床板	床板
序升	序升
序录	序錄
序曲	序曲
庐	廬
庐舍	廬舍
庑	廡
库	庫
库仑	庫侖
应	應
应克制	應剋制
应制	應制
应当	應當
应征	應徵
应钟	應鐘
应须	應須
底价	底價
底板	底板
底极	底極
底里	底裏
底面	底面
店伙	店夥
店里	店裏
店面	店面
庙	廟
庙台	廟臺
庙里	廟裏
府台	府臺
府后	府後
府干	府幹
庞	龐
庞克	龐克
废	廢
废了	廢了
废后	廢后
度搜	度搜
度曲	度曲
座钟	座鐘
庵主	庵主
庵儿	庵兒
庵堂	庵堂
庵婪	菴婪
庵寺	庵寺
庵庐	菴廬
庵庵	菴菴
庵舍	菴舍
庵蔼	菴藹
庵观	庵觀
庶几	庶幾
庶出	庶出
康回	康回
康复	康復
康庄	康莊
康梁	康梁
康采恩	康採恩
庸才	庸才
庸暗	庸闇
廉价	廉價
廉纤	廉纖
廛布	廛布
廢后	廢后
廪	廩
廪秋	廩秋
延修	延修
延厘	延釐
延后	延後
延挨	延挨
廷布	廷布
建于	建於
建党	建黨
建出	建出
建制	建制
建厂	建廠
建台	建臺
建极	建極
建筑	建築
开	開
开个	開個
开了	開了
开价	開價
开伙	開伙
开冬	開冬
开出	開出
开卷	開卷
开厂	開廠
开发	開發
开台	開臺
开吊	開弔
开向	開向
开哄	開鬨
开回	開回
开复	開復
开彩	開彩
开征	開徵
开杆	開杆
开秋	開秋
开筑	開築
开药	開藥
开蒙	開蒙
开辟	開闢
开采	開採
开面	開面
异	異
异于	異於
异同	異同
异彩	異彩
异志	異志
异才	異才
异种	異種
异采	異采
弃	棄
弃尸	棄屍
弃舍	棄捨
弄丑	弄醜
弄僵	弄僵
弄出	弄出
弄干	弄乾
弄松	弄鬆
弄脏	弄髒
弄鬼吊猴	弄鬼弔猴
弈秋	弈秋
弊幸	弊倖
弊恶	弊惡
弋获	弋獲
弑	弒
弓极	弓極
引出	引出
引发	引發
引布	引布
引据	引據
引斗	引鬭
引种	引種
引致	引致
弘历	弘曆
弘愿	弘願
张	張
张三丰	張三丰
张了	張了
张出	張出
张勋	張勳
张千	張千
张志	張志
张挂	張掛
张致	張致
弥	彌
弥久	彌久
弥事	彌事
弥勒	彌勒
弥天	彌天
弥封	彌封
弥山遍野	瀰山遍野
弥年	彌年
弥弥	瀰瀰
弥撒	彌撒
弥敬	彌敬
弥时	彌時
弥月	彌月
弥望	彌望
弥满	彌滿
弥漫	彌漫
弥漫着	瀰漫着
弥留	彌留
弥纶	彌綸
弥缝	彌縫
弥罗	彌羅
弥补	彌補
弥陀	彌陀
弪	弳
弯	彎
弯回	彎回
弯曲	彎曲
弱于	弱於
張三丰	張三丰
弹	彈
弹了	彈了
弹出	彈出
弹回	彈回
弹子台	彈子檯
弹珠台	彈珠檯
弹药	彈藥
弹针	彈針
强	強
强了	強了
强于	強於
强借	強借
强制	強制
强占	強佔
强奸	強姦
强干	強幹
强梁	強梁
弼针	弼針
彊御	彊禦
彊志	彊志
彊梁	彊梁
归	歸
归于	歸於
归余	歸餘
归向	歸向
归并	歸併
归烟	歸煙
归面	歸面
当	當
当上	當上
当下	當下
当世	當世
当个	當個
当中	當中
当了	當了
当事	當事
当于	當於
当今	當今
当代	當代
当令	當令
当众	當眾
当作	當作
当便	當便
当值	當值
当做	當做
当儿	當兒
当元	當元
当先	當先
当关	當關
当兵	當兵
当准	當準
当初	當初
当到	當到
当前	當前
当午	當午
当卢	當盧
当即	當即
当原	當原
当厨	當廚
当口	當口
当可	當可
当合	當合
当周	當週
当啷	噹啷
当国	當國
当地	當地
当场	當場
当垆	當壚
当堂	當堂
当堵	當堵
当夕	當夕
当夜	當夜
当天	當天
当头	當頭
当官	當官
当室	當室
当家	當家
当局	當局
当巡	當巡
当差	當差
当年	當年
当应	當應
当归	當歸
当当	噹噹
当役	當役
当待	當待
当得	當得
当心	當心
当意	當意
当成	當成
当手	當手
当拦	當攔
当掉	當掉
当撑	當撐
当政	當政
当敌	當敵
当日	當日
当时	當時
当是	當是
当晚	當晚
当月	當月
当朝	當朝
当机	當機
当权	當權
当村	當村
当来	當來
当案	當案
当槽	當槽
当此	當此
当涂	當塗
当灾	當災
当炉	當爐
当然	當然
当班	當班
当用	當用
当番	當番
当直	當直
当真	當真
当眼	當眼
当着	當着
当票	當票
当空	當空
当紧	當緊
当红	當紅
当罏	當罏
当舖	當舖
当花	當花
当行	當行
当街	當街
当该	當該
当赌	當賭
当起	當起
当路	當路
当轴	當軸
当过	當過
当选	當選
当道	當道
当量	當量
当铺	當鋪
当间	當間
当阳	當陽
当院	當院
当面	當面
录	錄
录上	錄上
录下	錄下
录个	錄個
录了	錄了
录事	錄事
录供	錄供
录像	錄像
录到	錄到
录制	錄製
录取	錄取
录囚	錄囚
录在	錄在
录录	彔彔
录影	錄影
录得	錄得
录成	錄成
录歌	錄歌
录灌	錄灌
录点	錄點
录用	錄用
录的	錄的
录着	錄着
录科	錄科
录起	錄起
录载	錄載
录过	錄過
录遗	錄遺
录音	錄音
形于	形於
形制	形制
形单影只	形單影隻
形同	形同
形影相吊	形影相弔
形胜	形勝
彤云	彤雲
彦	彥
彩云	彩雲
彩光	彩光
彩凤	綵鳳
彩券	彩券
彩印	彩印
彩号	彩號
彩喷	彩噴
彩塑	彩塑
彩墨	彩墨
彩头	彩頭 綵頭
彩女	綵女
彩妆	彩妝
彩市	彩市
彩带	綵帶
彩度	彩度
彩影	彩影
彩扩	彩擴
彩排	彩排
彩旗	彩旗
彩旦	彩旦
彩条	彩條
彩棚	綵棚
彩楼	綵樓
彩灯	彩燈
彩照	彩照
彩牌楼	綵牌樓
彩球	綵球
彩瓷	彩瓷
彩电	彩電
彩画	彩畫
彩砖	彩磚
彩礼	彩禮
彩票	彩票
彩笔	彩筆
彩纸	彩紙
彩线	綵綫
彩练	彩練
彩绘	彩繪
彩绸	綵綢
彩缎	綵緞
彩缯	綵繒
彩胜	綵勝
彩船	綵船
彩色	彩色
彩虹	彩虹
彩衣	綵衣
彩调	彩調
彩轿	彩轎
彩釉	彩釉
彩金	彩金
彩钱	彩錢
彩陶	彩陶
彩雕	彩雕
彩霞	彩霞
彩饰	彩飾
彩鸾	綵鸞
彩鹢	彩鷁
彭咸	彭咸
彭蒙	彭蒙
影占	影占
影后	影后
影坛	影壇
役于	役於
役别	役別
役种	役種
彻	徹
彼此克制	彼此剋制
往后	往後
往复	往復
往日無仇	往日無讎
往里	往裏
征人	徵人
征令	徵令
征伐	征伐
征信	徵信
征候	徵候
征兆	徵兆
征兵	徵兵
征到	徵到
征募	徵募
征勦	征勦
征占	徵佔
征友	徵友
征发	徵發
征召	徵召
征名责实	徵名責實
征吏	徵吏
征启	徵啓
征咎	徵咎
征圣	徵聖
征士	徵士
征夫	征夫
征婚	徵婚
征实	徵實
征尘	征塵
征帆	征帆
征庸	徵庸
征引	徵引
征彸	征彸
征得	徵得
征怪	徵怪
征戍	征戍
征战	征戰
征才	徵才
征招	徵招
征收	徵收
征效	徵效
征敛	征斂
征文	徵文
征旆	征旆
征服	征服
征求	徵求
征状	徵狀
征用	徵用
征程	征程
征税	徵稅
征稿	徵稿
征答	徵答
征结	徵結
征聘	徵聘
征衣	征衣
征衫	征衫
征讨	征討
征训	徵訓
征询	徵詢
征调	徵調
征象	徵象
征购	徵購
征车	徵車
征辟	徵辟
征迹	徵蹟
征选	徵選
征逐	徵逐
征途	征途
征集	徵集
征风召雨	徵風召雨
征马	征馬
征驾	征駕
征验	徵驗
径	徑
径向	徑向
待了	待了
待制	待制
待发	待發
很丑	很醜
很僵	很僵
很凶	很兇
很干	很乾
很暗	很暗
律历志	律曆志
徐娘	徐娘
徐干	徐幹
徐汇	徐匯
徒托空言	徒託空言
徕	徠
得了	得了
得于	得於
得克制	得剋制
得出	得出
得幸	得幸
得当	得當
得志	得志
得胜	得勝
得采	得采
御世	御世
御书	御書
御人	御人
御仗	御仗
御侮	禦侮
御制	御製
御前	御前
御医	御醫
御厨	御廚
御史	御史
御夫	御夫
御孙	御孫
御宇	御宇
御守	御守
御宝	御寶
御容	御容
御寇	禦寇
御寒	禦寒
御库	御庫
御庙	御廟
御府	御府
御弟	御弟
御所	御所
御手	御手
御敌	禦敵
御旨	御旨
御札	御札
御极	御極
御案	御案
御气	御氣
御沟	御溝
御河	御河
御状	御狀
御用	御用
御窑	御窯
御笔	御筆
御者	御者
御苑	御苑
御览	御覽
御赐	御賜
御轮	御輪
御道	御道
御风	御風
御馔	御饌
御驾	御駕
御龙	御龍
微卷	微卷
微纤	微纖
徯幸	徯倖
德占	德佔
德才	德才
德里	德里
徼幸	徼幸
心于	心於
心余	心餘
心向	心向
心志	心志
心愿	心願
心折	心折
心曲	心曲
心术	心術
心游	心遊
心理	心理
心系一	心繫一
心系万	心繫萬
心系东	心繫東
心系两	心繫兩
心系中	心繫中
心系乔	心繫乔
心系五	心繫五
心系京	心繫京
心系人	心繫人
心系他	心繫他
心系伊	心繫伊
心系众	心繫眾
心系传	心繫傳
心系何	心繫何
心系你	心繫你
心系健	心繫健
心系全	心繫全
心系兰	心繫蘭
心系农	心繫农
心系功	心繫功
心系动	心繫動
心系募	心繫募
心系北	心繫北
心系十	心繫十
心系千	心繫千
心系南	心繫南
心系台	心繫台
心系和	心繫和
心系哪	心繫哪
心系唐	心繫唐
心系嘱	心繫囑
心系四	心繫四
心系困	心繫困
心系国	心繫國
心系在	心繫在
心系地	心繫地
心系大	心繫大
心系天	心繫天
心系夫	心繫夫
心系奥	心繫奧
心系女	心繫女
心系她	心繫她
心系妇	心繫婦
心系妻	心繫妻
心系子	心繫子
心系它	心繫它
心系宣	心繫宣
心系家	心繫家
心系富	心繫富
心系小	心繫小
心系山	心繫山
心系川	心繫川
心系幼	心繫幼
心系广	心繫廣
心系彼	心繫彼
心系德	心繫德
心系您	心繫您
心系慈	心繫慈
心系我	心繫我
心系摩	心繫摩
心系故	心繫故
心系新	心繫新
心系日	心繫日
心系昌	心繫昌
心系晓	心繫曉
心系曼	心繫曼
心系林	心繫林
心系母	心繫母
心系民	心繫民
心系江	心繫江
心系汶	心繫汶
心系沈	心繫沈
心系沙	心繫沙
心系泰	心繫泰
心系浙	心繫浙
心系港	心繫港
心系湖	心繫湖
心系澳	心繫澳
心系灾	心繫災
心系父	心繫父
心系生	心繫生
心系病	心繫病
心系百	心繫百
心系的	心繫的
心系着	心繫着
心系社	心繫社
心系祖	心繫祖
心系神	心繫神
心系红	心繫紅
心系美	心繫美
心系群	心繫群
心系老	心繫老
心系舞	心繫舞
心系英	心繫英
心系茶	心繫茶
心系西	心繫西
心系贫	心繫貧
心系输	心繫輸
心系近	心繫近
心系远	心繫遠
心系选	心繫選
心系重	心繫重
心系长	心繫長
心系阮	心繫阮
心系震	心繫震
心系非	心繫非
心系风	心繫風
心系香	心繫香
心系高	心繫高
心系麦	心繫麥
心系黄	心繫黃
心脏	心臟
心荡	心蕩
心药	心藥
心里	心裏
心里面	心裏面
心长发短	心長髮短
必修	必修
必当	必當
必胜	必勝
必须	必須
忆	憶
忌烟	忌菸
忍个	忍個
忍了	忍了
忍冬	忍冬
忍术	忍術
忏	懺
忒恶	忒惡
志业	志業
志书	志書
志事	志事
志于	志於
志分	志分
志向	志向
志哀	誌哀
志喜	誌喜
志坚	志堅
志士	志士
志学	志學
志尚	志尚
志工	志工
志庆	誌慶
志度	志度
志异	誌異
志心	志心
志怪	志怪
志悼	誌悼
志意	志意
志愿	志願
志成	志成
志气	志氣
志略	志略
志节	志節
志行	志行
志诚	志誠
志趣	志趣
志量	志量
忘了	忘了
忙于	忙於
忙并	忙併
忙里	忙裏
忙里偷闲	忙裏偷閒
忠于	忠於
忠仆	忠僕
忧	憂
忧戚	憂戚
忧郁	憂鬱
快了	快了
快借	快借
快克	快克
快克制	快剋制
快冲	快衝
快出	快出
快升	快升
快向	快向
快回	快回
快干	快乾
快当	快當
快搜	快搜
快板	快板
快适	快適
念了	念了
忾	愾
忿发	忿發
怀	懷
怀了	懷了
怀表	懷錶
怀里	懷裏
怀钟	懷鐘
态	態
怂	慫
怃	憮
怄	慪
怅	悵
怆	愴
怎么	怎麼
怎么着	怎麼着
怒于	怒於
怒发冲冠	怒髮衝冠
怒恶	怒惡
怜	憐
怜才	憐才
思如泉涌	思如泉涌
思致	思致
怠于	怠於
急于	急於
急冲而下	急衝而下
急症	急症
急须	急須
性别	性別
性发	性發
性向	性向
性征	性徵
性恶	性惡
性欲	性慾
怨仇	怨仇
怪了	怪了
怪杰	怪傑
怪里怪气	怪裏怪氣
怫郁	怫鬱
怯症	怯症
总	總
总厂	總廠
总发	總髮
总合	總合
总汇	總彙
怼	懟
怿	懌
恂栗	恂慄
恋	戀
恋恋不舍	戀戀不捨
恋曲	戀曲
恒	恆
恒生指数	恒生指數
恒生股价指数	恒生股價指數
恒生银行	恒生銀行
恕乏价催	恕乏价催
恙虫	恙蟲
恢台	恢臺
恢复	恢復
恨了	恨了
恩仇	恩仇
恩准	恩准
恩台	恩臺
恩幸	恩幸
恬适	恬適
息交绝游	息交絕遊
息谷	息穀
恰当	恰當
恰才	恰纔
恳	懇
恳愿	懇願
恳托	懇託
恶	惡
恶业	惡業
恶习	惡習
恶人	惡人
恶例	惡例
恶俗	惡俗
恶兆	惡兆
恶党	惡黨
恶劣	惡劣
恶化	惡化
恶发	惡發
恶口	惡口
恶名	惡名
恶因	惡因
恶地	惡地
恶声	惡聲
恶妇	惡婦
恶婆	惡婆
恶嫌	惡嫌
恶子	惡子
恶孽	惡孽
恶客	惡客
恶寒	惡寒
恶少	惡少
恶岁	惡歲
恶形	惡形
恶徒	惡徒
恶心	噁心
恶念	惡念
恶怜	惡憐
恶性	惡性
恶恶	惡惡
恶意	惡意
恶感	惡感
恶战	惡戰
恶报	惡報
恶搞	惡搞
恶政	惡政
恶斗	惡鬭
恶曜	惡曜
恶月	惡月
恶有	惡有
恶极	惡極
恶果	惡果
恶梦	惡夢
恶棍	惡棍
恶毒	惡毒
恶气	惡氣
恶汉	惡漢
恶法	惡法
恶浊	惡濁
恶煞	惡煞
恶犬	惡犬
恶狠	惡狠
恶疮	惡瘡
恶疾	惡疾
恶癖	惡癖
恶直丑正	惡直醜正
恶相	惡相
恶神	惡神
恶终	惡終
恶耗	惡耗
恶臭	惡臭
恶行	惡行
恶补	惡補
恶言	惡言
恶讯	惡訊
恶识	惡識
恶诧	惡詫
恶语	惡語
恶质	惡質
恶贼	惡賊
恶赖	惡賴
恶趣	惡趣
恶躁	惡躁
恶运	惡運
恶逆	惡逆
恶道	惡道
恶阻	惡阻
恶限	惡限
恶障	惡障
恶露	惡露
恶霸	惡霸
恶风	惡風
恶食	惡食
恶骂	惡罵
恶鬼	惡鬼
恶魔	惡魔
恸	慟
恹	懨
恺	愷
恻	惻
恼	惱
恽	惲
悍药	悍藥
悒郁	悒鬱
悚栗	悚慄
悟出	悟出
悠悠荡荡	悠悠蕩蕩
悠暗	悠闇
悠游	悠遊
悠荡	悠盪
悦	悅
您克制	您剋制
悫	愨
悬	懸
悬吊	懸吊
悬岩	懸巖
悬挂	懸掛
悬梁	懸樑
悬臂梁	懸臂樑
悬针	懸針
悬钟	懸鐘
悭	慳
悯	憫
悲愿	悲願
悲戚	悲戚
悲秋	悲秋
悲筑	悲筑
悲谷	悲谷
悲郁	悲鬱
悸栗	悸慄
情志	情志
情愿	情願
情欲	情慾
情种	情種
情致	情致
情采	情采
情面	情面
惇朴	惇樸
惊	驚
惊赞	驚讚
惊钟	驚鐘
惏栗	惏慄
惑志	惑志
惑术	惑術
惕栗	惕慄
惜别	惜別
惠鉴	惠鑒
惦挂	惦掛
惧	懼
惧于	懼於
惨	慘
惨历	慘歷
惨戚	慘慼
惨栗	慘慄
惩	懲
惫	憊
惬	愜
惬当	愜當
惭	慚
惮	憚
惯	慣
惯于	慣於
惯摆	慣擺
想个	想個
想了	想了
想借	想借
想克制	想剋制
想出	想出
想回	想回
想尽	想盡
想录	想錄
惴栗	惴慄
惹出	惹出
愁云	愁雲
愆面	愆面
愈合	癒合
意克制	意剋制
意占	意佔
意向	意向
意大利面	意大利麵
意志	意志
意愿	意願
意欲	意欲
意表	意表
意面	意麵
愚蒙	愚蒙
感于	感於
感冒药	感冒藥
感发	感發
愠	慍
愤	憤
愤发	憤發
愦	憒
愧于	愧於
愿	願
愿力	願力
愿心	願心
愿意	願意
愿景	願景
愿望	願望
愿朴	愿樸
愿而恭	愿而恭
愿行	願行
愿谨	願謹
慈云	慈雲
慈制	慈制
慌了	慌了
慌里慌张	慌裏慌張
慑	懾
慢了	慢了
慢曲	慢曲
慢板	慢板
慢游	慢遊
慢表	慢表
慧种	慧種
慰借	慰藉
憎恶	憎惡
懂了	懂了
懈松	懈鬆
懑	懣
懒	懶
懒于	懶於
懒虫	懶蟲
懔	懍
懔栗	懍慄
懰栗	懰慄
懵药	懵藥
懿戚	懿戚
懿范	懿範
戆	戇
戋	戔
戏	戲
戏台	戲臺
戏团	戲團
戏彩娱亲	戲綵娛親
戏曲	戲曲
戏里	戲裏
成了	成了
成于	成於
成仇	成仇
成千	成千
成合	成合
成周	成周
成药	成藥
成虫	成蟲
我克制	我剋制
我党	我黨
我只	我只
我向	我向
我回	我回
我愿	我願
我搜	我搜
戒坛	戒壇
戒涂	戒塗
戒烟	戒菸
或于	或於
戗	戧
战	戰
战个	戰個
战了	戰了
战云	戰雲
战后	戰後
战天斗地	戰天鬭地
战斗	戰鬭
战术	戰術
战栗	戰慄
战胜	戰勝
战表	戰表
戚串	戚串
戚党	戚黨
戚容	戚容
戚属	戚屬
戚戚	慼慼
戚施	戚施
戚族	戚族
戚旧	戚舊
戚然	戚然
戚谊	戚誼
戚里	戚里
戛云	戛雲
截发	截髮
截板	截板
截获	截獲
截面	截面
戬	戩
戬谷	戩穀
戮尸	戮屍
戯	戱
戴个	戴個
戴了	戴了
戴出	戴出
戴发含齿	戴髮含齒
戴表	戴錶
户	戶
戽斗	戽斗
房价	房價
房舍	房舍
房里	房裏
所云	所云
所云云	所云云
所占	所佔
所向	所向
所幸	所幸
所托	所託
所致	所致
扁拟谷盗虫	扁擬穀盜蟲
扇面	扇面
手冢治虫	手冢治虫
手卷	手卷
手塚治虫	手冢治虫
手折	手摺
手术	手術
手松	手鬆
手板	手板
手表	手錶
手里	手裏
手面	手面
才上	才上
才下	才下
才不	才不
才买	才買
才人	才人
才付	才付
才会	才會
才俊	才俊
才信	才信
才像	才像
才克制	才剋制
才具	才具
才再	才再
才出	才出
才分	才分
才则	纔則
才刚	纔剛
才到	才到
才力	才力
才华	才華
才去	才去
才可	纔可
才名	才名
才向	才向
才器	才器
才回	才回
才在	才在
才士	才士
才多	才多
才够	才够
才女	才女
才好	才好
才始	才始
才媛	才媛
才子	才子
才学	才學
才守	才守
才定	才定
才对	才對
才将	才將
才带	才帶
才干	才幹
才开	才開
才得	才得
才得两年	纔得兩年
才德	才德
才思	才思
才怪	才怪
才悟	才悟
才情	才情
才想	才想
才打	才打
才拿	才拿
才排	才排
才敢	才敢
才料	才料
才是	才是
才智	才智
才有	才有
才望	才望
才来	才來
才此	纔此
才气	才氣
才没	才沒
才派	才派
才爲	才爲
才用	才用
才略	才略
才看	才看
才笔	才筆
才等	才等
才算	才算
才给	才給
才能	才能
才色	才色
才艺	才藝
才藻	才藻
才行	才行
才要	才要
才订	才訂
才讲	才講
才识	才識
才语	才語
才读	才讀
才调	才調
才貌	才貌
才资	才資
才跟	才跟
才过	才過
才附	才附
才降	才降
才难	才難
扎上	紮上
扎下	紮下
扎乎	扎乎
扎住	扎住
扎到	扎到
扎嘴	扎嘴
扎囮	紮囮
扎垫	扎墊
扎堆	扎堆
扎好	紮好
扎实	紮實
扎寨	紮寨
扎带子	紮帶子
扎心	扎心
扎成	紮成
扎手	扎手
扎扎	扎扎
扎括	扎括
扎挣	扎掙
扎掂	扎掂
扎撒	扎撒
扎枪	扎槍
扎根	紮根
扎煞	扎煞
扎眼	扎眼
扎紧	紮緊
扎缚	扎縛
扎脚	紮腳
扎花	扎花
扎草	扎草
扎营	紮營
扎裹	紮裹
扎诈	紮詐
扎起	紮起
扎针	扎針
扎铁	紮鐵
扑	撲
扑了	撲了
扑作教刑	扑作教刑
扑克	撲克
扑冬	撲鼕
扑冬冬	撲鼕鼕
扑出	撲出
扑同	撲同
扑向	撲向
扑复	撲復
扑打	扑打
扑挞	扑撻
扑面	撲面
扒出	扒出
打个	打個
打价	打價
打伙	打夥
打出	打出
打出吊入	打出弔入
打制	打製
打千	打千
打卡钟	打卡鐘
打参	打參
打发	打發
打合	打合
打吨	打吨
打哄	打鬨
打回	打回
打团	打團
打干	打幹
打干哕	打乾噦
打并	打併
打当	打當
打折	打折
打拼	打拚
打挨	打捱
打斗	打鬭
打着钟	打着鐘
打胜	打勝
打药	打藥
打蜡	打蠟
打谷	打穀
打路庄板	打路莊板
打针	打針
打钟	打鐘
扔出	扔出
扔回	扔回
托买	託買
托了	託了
托事	託事
托交	託交
托人	託人
托付	託付
托住	托住
托儿	托兒
托儿所	託兒所
托勒	托勒
托卖	託賣
托古讽今	託古諷今
托叶	托葉
托名	託名
托命	託命
托咎	託咎
托地	托地
托墨	托墨
托大	託大
托子	托子
托孤	託孤
托实	托實
托幼	托幼
托庇	託庇
托故	託故
托架	托架
托梦	託夢
托熟	托熟
托生	托生
托疾	託疾
托病	託病
托盘	托盤
托福	托福
托管	託管
托维	托維
托育	托育
托胆	托膽
托胎	托胎
托腮	托腮
托色	托色
托言	託言
托词	託詞
托赖	托賴
托起	托起
托足	托足
托身	託身
托辞	託辭
托过	託過
托运	託運
托鉢	托鉢
托附	託附
托领	托領
托马	托馬
扛了	扛了
扛出	扛出
扛大梁	扛大樑
扞御	扞禦
扣了	扣了
扣克	扣剋
扣出	扣出
扣回	扣回
执	執
执板	執板
扩	擴
扩厂	擴廠
扪	捫
扫	掃
扫出	掃出
扫荡	掃蕩
扬	揚
扬升	揚升
扭出	扭出
扭别	扭別
扭摆	扭擺
扭曲	扭曲
扯出	扯出
扯纤	扯縴
扯面	扯麵
扰	擾
扶了	扶了
扶余国	扶餘國
扶出	扶出
扶同	扶同
扶苏	扶蘇
批价	批價
批准	批准
批出	批出
批发	批發
批回	批迴
批复	批複
批尸	批尸
批斗	批鬭
批注	批註
扼制	扼制
找个	找個
找了	找了
找价	找價
找出	找出
找回	找回
承修	承修
承制	承製
承当	承當
承蒙	承蒙
技术	技術
抄发	抄發
抄台	抄臺
抄录	抄錄
抄扎	抄扎
抄获	抄獲
把个	把個
把了	把了
把卷	把卷
抑制	抑制
抑郁	抑鬱
抒发	抒發
抓出	抓出
抓周	抓週
抓奸	抓姦
抓彩	抓彩
抓斗	抓鬭
抓药	抓藥
投了	投了
投出	投出
投合	投合
投向	投向
投回	投回
投托	投托
投注	投注
投药	投藥
抖了	抖了
抖出	抖出
抗了	抗了
抗御	抗禦
抗志	抗志
抗癌药	抗癌藥
抗药	抗藥
折上	折上
折下	折下
折中	折中
折价	折價
折伤	折傷
折倒	折倒
折光	折光
折兑	折兌
折兵	折兵
折冲	折衝
折券	折券
折剉	折剉
折半	折半
折卖	折賣
折受	折受
折变	折變
折叠	摺疊
折台	折檯
折合	摺合
折回	折回
折头	折頭
折奏	摺奏
折子	摺子
折实	折實
折对	折對
折寿	折壽
折射	折射
折尺	摺尺
折屐	折屐
折帐	折帳
折弯	折彎
折当	折當
折得	折得
折成	折成
折扇	摺扇
折扣	折扣
折抵	折抵
折挫	折挫
折损	折損
折断	折斷
折旧	折舊
折服	折服
折本	折本
折杀	折殺
折枝	折枝
折柬	折柬
折柳	折柳
折桂	折桂
折梯	摺梯
折椅	摺椅
折狱	折獄
折痕	摺痕
折的	折的
折碗	折碗
折磨	折磨
折福	折福
折秤	折秤
折简	折簡
折算	折算
折箩	折籮
折箭	折箭
折篷	摺篷
折纸	摺紙
折线	折綫
折罚	折罰
折翼	折翼
折耗	折耗
折肱	折肱
折腰	折腰
折腾	折騰
折色	折色
折节	折節
折莫	折莫
折行	折行
折衷	折衷
折裙	摺裙
折角	折角
折让	折讓
折证	折證
折账	折賬
折起	折起
折身	折身
折转	折轉
折辨	折辨
折辩	折辯
折辱	折辱
折返	折返
折进	折進
折钱	折錢
抚	撫
抚台	撫臺
抚尸	撫屍
抚面	撫面
抛	拋
抛出	拋出
抛向	拋向
抛摆	拋擺
抟	摶
抠	摳
抠出	摳出
抡	掄
抢	搶
抢了	搶了
抢修	搶修
抢占	搶佔
抢种	搶種
护	護
护厂	護廠
护发	護髮
护向	護向
护板	護板
护面	護面
报	報
报仇	報仇
报价	報價
报修	報修
报出	報出
报团	報團
报复	報復
报表	報表
披云	披雲
披卷	披卷
披发	披髮
披复	披覆
披头散发	披頭散髮
披挂	披掛
披榛采兰	披榛採蘭
抬价	擡價
抬出	擡出
抬回	擡回
抱出	抱出
抱朴	抱朴
抱素怀朴	抱素懷樸
抵了	抵了
抵借	抵借
抵制	抵制
抵向	抵向
抵当	抵當
抵御	抵禦
抵针	抵針
抹了	抹了
抹布	抹布
抹干	抹乾
抹面	抹面
押出	押出
押回	押回
押当	押當
押柜	押櫃
押汇	押匯
押注	押注
抽丰	抽豐
抽公签	抽公籤
抽出	抽出
抽厘	抽釐
抽尽	抽盡
抽斗	抽斗
抽烟	抽菸
抽穗	抽穗
抽签	抽籤
抿发	抿髮
拂荡	拂盪
拂钟无声	拂鐘無聲
拂面	拂面
拂须	拂鬚
担	擔
担仔面	擔仔麵
担当	擔當
担担面	擔擔麵
担着	擔着
担负着	擔負着
拆伙	拆夥
拆借	拆借
拆出	拆出
拆台	拆臺
拆回	拆回
拈折	拈折
拈须	拈鬚
拉了	拉了
拉克施尔德钟	拉克施爾德鐘
拉出	拉出
拉制	拉制
拉升	拉昇
拉向	拉向
拉回	拉回
拉杆	拉桿
拉纤	拉縴
拉链	拉鍊
拉面	拉麵
拌折	拌折
拌种	拌種
拍出	拍出
拍发	拍發
拍板	拍板
拏云	拏雲
拐了	拐了
拐出	拐出
拐回	拐回
拑制	拑制
拒于	拒於
拒烟	拒菸
拓朴	拓樸
拔个	拔個
拔了	拔了
拔出	拔出
拔发	拔髮
拔回	拔回
拔须	拔鬚
拖了	拖了
拖出	拖出
拖吊	拖吊
拖回	拖回
拖板	拖板
拗别	拗彆
拘于	拘於
拘出	拘出
拘板	拘板
拘系	拘繫
拙于	拙於
拙朴	拙樸
拚斗	拚鬭
拚舍	拚捨
招了	招了
招出	招出
招回	招回
招复	招復
招致	招致
拜冬	拜冬
拜别	拜別
拜台	拜臺
拜复	拜覆
拜托	拜託
拜斗	拜斗
拜表	拜表
拟	擬
拟于	擬於
拢	攏
拣	揀
拣出	揀出
拣别	揀別
拥	擁
拥向	擁向
拦	攔
拦当	攔當
拦柜	攔櫃
拧	擰
拧了	擰了
拧干	擰乾
拧种	擰種
拨	撥
拨出	撥出
拨发	撥發
拨回	撥回
拨谷	撥穀
择	擇
括发	括髮
拭干	拭乾
拮据	拮据
拱出	拱出
拱托	拱托
拳坛	拳壇
拳曲	拳曲
拳术	拳術
拼了	拼了
拼出	拼出
拼却	拚卻
拼合	拼合
拼命	拚命
拼回	拼回
拼斗	拼鬭
拼死	拚死
拼生尽死	拚生盡死
拼绝	拚絕
拼老命	拚老命
拼舍	拚捨
拽扎	拽扎
拾回	拾回
拾沈	拾瀋
拾穗	拾穗
拾获	拾獲
拿下表	拿下錶
拿下钟	拿下鐘
拿个	拿個
拿准	拿準
拿出	拿出
拿发	拿發
拿回	拿回
拿破仑	拿破崙
拿获	拿獲
持胜	持勝
挂	掛
挂上	掛上
挂下	掛下
挂个	掛個
挂了	掛了
挂住	掛住
挂僵	掛僵
挂入	掛入
挂冠	掛冠
挂出	掛出
挂到	掛到
挂勾	掛勾
挂千	掛千
挂单	掛單
挂历	掛曆
挂号	掛號
挂名	掛名
挂回	掛回
挂图	掛圖
挂在	掛在
挂失	掛失
挂好	掛好
挂孝	掛孝
挂帅	掛帥
挂帐	掛帳
挂帘	掛簾
挂彩	掛彩
挂得	掛得
挂心	掛心
挂念	掛念
挂怀	掛懷
挂意	掛意
挂成	掛成
挂掉	掛掉
挂搭	掛搭
挂斗	掛斗
挂断	掛斷
挂有	掛有
挂来	掛來
挂架	掛架
挂满	掛滿
挂漏	掛漏
挂火	掛火
挂灯	掛燈
挂牌	掛牌
挂的	掛的
挂碍	掛礙
挂篮	掛籃
挂红	掛紅
挂虑	掛慮
挂衣	掛衣
挂表	掛錶
挂记	掛記
挂账	掛賬
挂起	掛起
挂车	掛車
挂轴	掛軸
挂过	掛過
挂进	掛進
挂钟	掛鐘
挂钩	掛鉤
挂锁	掛鎖
挂零	掛零
挂面	掛麵
挂齿	掛齒
指了	指了
指出	指出
指向	指向
指回	指回
指手划脚	指手劃腳
指针	指針
按了	按了
按出	按出
按回	按回
挌斗	挌鬭
挑了	挑了
挑出	挑出
挑台	挑臺
挑大梁	挑大樑
挑尽	挑盡
挑斗	挑鬭
挖出	挖出
挚	摯
挛	攣
挝	撾
挞	撻
挟	挾
挟制	挾制
挠	撓
挠折	撓折
挠曲	撓曲
挡	擋
挡了	擋了
挡修	擋修
挡回	擋回
挡御	擋禦
挡板	擋板
挢	撟
挣	掙
挣出	掙出
挣扎	掙扎
挤	擠
挤了	擠了
挤出	擠出
挤向	擠向
挥	揮
挥了	揮了
挥别	揮別
挥发	揮發
挥杆	揮杆
挨上	捱上
挨了	捱了
挨光	挨光
挨到	捱到
挨呲	挨呲
挨家	挨家
挨延	挨延
挨得	捱得
挨户	挨戶
挨打	捱打
挨拿	挨拿
挨挤	挨擠
挨挨	挨挨
挨捕	挨捕
挨排	挨排
挨揍	挨揍
挨次	挨次
挨满	挨滿
挨的	捱的
挨磨	捱磨
挨肩	挨肩
挨苦	捱苦
挨身	挨身
挨过	捱過
挨近	挨近
挨门	挨門
挨闹	挨鬧
挨靠	挨靠
挨饿	挨餓
挨骂	捱罵
挪借	挪借
挪出	挪出
挫折	挫折
振荡	振盪
挹注	挹注
挺了	挺了
挺出	挺出
挺升	挺升
挺尸	挺屍
挽住	挽住
挽回	挽回
挽夫	輓夫
挽手	挽手
挽救	挽救
挽曲	輓曲
挽歌	輓歌
挽毂	挽轂
挽留	挽留
挽联	輓聯
挽聯	輓聯
挽袖	挽袖
挽詞	輓詞
挽詩	輓詩
挽词	輓詞
挽诗	輓詩
挽起	挽起
挽面	挽面
挽额	輓額
挽髻	挽髻
捅了	捅了
捆了	捆了
捆扎	捆紮
捉发	捉髮
捉奸	捉姦
捋采	捋采
捍御	捍禦
捏合	捏合
捏面人	捏麵人
捐出	捐出
捕获	捕獲
捕虫	捕蟲
捞	撈
捞干	撈乾
捞面	撈麵
损	損
损于	損於
损折	損折
捡	撿
捡了	撿了
捡回	撿回
换	換
换个	換個
换了	換了
换借	換借
换出	換出
换厂	換廠
换发	換髮
换只	換隻
换台	換臺
换吊	換吊
换向	換向
换回	換回
换板	換板
换汇	換匯
换签	換籤
换系	換系
换药	換藥
捣	搗
捣针	搗針
捣鬼吊白	搗鬼弔白
捧出	捧出
据	據
据云	據云
据传	據傳
据信	據信
据守	據守
据实	據實
据常	據常
据干而窥井底	據榦而窺井底
据悉	據悉
据报	據報
据有	據有
据此	據此
据点	據點
据理	據理
据称	據稱
据说	據說
据道	據道
据鞍	據鞍
捵面	捵麵
捶炼	捶鍊
捶链	捶鍊
捷克	捷克
捷才	捷才
捻合	捻合
捻针	捻鍼
掀了	掀了
掀出	掀出
掂折	掂折
掉个	掉個
掉了	掉了
掊克	掊克
掌柜	掌櫃
掏出	掏出
排出	排出
排当	排當
排烟	排煙
排表	排表
排须	排鬚
排骨面	排骨麵
掘出	掘出
探了	探了
探出	探出
探获	探獲
掣签	掣籤
接个	接個
接了	接了
接合	接合
接回	接回
接着说	接着說
接种	接種
接穗	接穗
接获	接獲
接面	接面
控制	控制
控卷	控捲
控御	控御
推出	推出
推向	推向
推回	推回
推情准理	推情準理
推托	推託
推挽	推輓
推杆	推杆
掩卷	掩卷
掩面	掩面
掰了	掰了
掳	擄
掳获	擄獲
掴	摑
掷	擲
掸	撣
掺	摻
掺合	摻合
掼	摜
揉合	揉合
揍了	揍了
描了	描了
描出	描出
描涂	描塗
提个	提個
提了	提了
提价	提價
提出	提出
提制	提製
提升	提升
提向	提向
提回	提回
提子干	提子乾
提心吊胆	提心弔膽
提梁	提樑
提炼	提煉
插于	插於
插回	插回
插曲	插曲
握别	握別
握发	握髮
揩干	揩乾
揪出	揪出
揪发	揪髮
揪采	揪採
揪须	揪鬚
揭丑	揭醜
揭出	揭出
揭发	揭發
揭布	揭布
揭折	揭折
援据	援據
揽	攬
揽胜	攬勝
揿	撳
搀	攙
搀伙	攙夥
搁	擱
搂	摟
搅	攪
搅合	攪合
搋面	搋麵
搌布	搌布
搏斗	搏鬭
搏炼	搏煉
搓板	搓板
搜下	搜下
搜书	搜書
搜了	搜了
搜人	搜人
搜出	搜出
搜刮	搜刮
搜到	搜到
搜剿	搜剿
搜吧	搜吧
搜听	搜聽
搜啊	搜啊
搜图	搜圖
搜奇	搜奇
搜宝	搜寶
搜客	搜客
搜寻	搜尋
搜山	搜山
搜店	搜店
搜房	搜房
搜括	蒐括
搜捕	搜捕
搜掠	搜掠
搜搜	搜搜
搜救	搜救
搜星	搜星
搜查	搜査
搜检	搜檢
搜歌	搜歌
搜求	搜求
搜游	搜遊
搜爆	搜爆
搜狐	搜狐
搜狗	搜狗
搜的	搜的
搜神	搜神
搜秀	搜秀
搜索	搜索
搜缴	搜繳
搜网	搜網
搜罗	蒐羅
搜获	搜獲
搜藏	蒐藏
搜虎	搜虎
搜证	蒐證
搜豹	搜豹
搜购	蒐購
搜走	搜走
搜身	搜身
搜遍	搜遍
搜酷	搜酷
搜集	蒐集 搜集
搜霸	搜霸
搞了	搞了
搞出	搞出
搤肮拊背	搤肮拊背
搪饥	搪飢
搬出	搬出
搬回	搬回
搬斗	搬鬭
搭个	搭個
搭伙	搭夥
搭出	搭出
搭干铺	搭乾鋪
搭面	搭面
携	攜
携出	攜出
携同	攜同
搽药	搽藥
摄	攝
摄于	攝於
摄制	攝製
摅	攄
摆	擺
摆上	擺上
摆下	擺下
摆供	擺供
摆出	擺出
摆划	擺劃
摆列	擺列
摆到	擺到
摆制	擺制
摆动	擺動
摆卖	擺賣
摆回	擺回
摆在	擺在
摆夷	擺夷
摆好	擺好
摆子	擺子
摆尾	擺尾
摆布	擺佈
摆席	擺席
摆平	擺平
摆开	擺開
摆弄	擺弄
摆当	擺當
摆得	擺得
摆忙	擺忙
摆成	擺成
摆手	擺手
摆拨	擺撥
摆搠	擺搠
摆搭	擺搭
摆摆	擺擺
摆摊	擺攤
摆撼	擺撼
摆放	擺放
摆明	擺明
摆来	擺來
摆样	擺樣
摆格	擺格
摆槊	擺槊
摆款	擺款
摆法	擺法
摆渡	擺渡
摆点	擺點
摆番	擺番
摆站	擺站
摆线	擺綫
摆置	擺置
摆脱	擺脫
摆荡	擺盪
摆落	擺落
摆设	擺設
摆谱	擺譜
摆起	擺起
摆进	擺進
摆酒	擺酒
摆针	擺針
摆钟	擺鐘
摆锤	擺錘
摆长	擺長
摆阔	擺闊
摆阵	擺陣
摆露	擺露
摆饭	擺飯
摆饰	擺飾
摆齐	擺齊
摇	搖
摇了	搖了
摇摆	搖擺
摇摇荡荡	搖搖蕩蕩
摇杆	搖桿
摇板	搖板
摇荡	搖盪
摇针	搖針
摈	擯
摊	攤
摊了	攤了
摊出	攤出
摒出	摒出
摔了	摔了
摘借	摘借
摘出	摘出
摘录	摘錄
摧坚获丑	摧堅獲醜
摧折	摧折
摩托	摩托
摭采	摭採
摸了	摸了
摸出	摸出
摸彩	摸彩
摸棱	摸棱
摸秋	摸秋
摸钟	摸鐘
撂了	撂了
撄	攖
撇吊	撇弔
撑	撐
撑了	撐了
撑杆	撐杆
撒布	撒佈
撒极	撒極
撒种	撒種
撕了	撕了
撚须	撚鬚
撞出	撞出
撞尸	撞屍
撞球台	撞球檯
撞针	撞針
撞钟	撞鐘
撞阵冲军	撞陣衝軍
撤出	撤出
撤后	撤後
撤回	撤回
撤帘	撤簾
撤并	撤併
撧折	撧折
撩斗	撩鬭
撬了	撬了
播于	播於
播出	播出
播发	播發
播种	播種
播荡	播蕩
撮合	撮合
撮药	撮藥
撰录	撰錄
撵	攆
撵出	攆出
撷	擷
撸	擼
撺	攛
撺哄	攛哄
擀面	擀麵
擂台	擂臺
擅于	擅於
操作钟	操作鐘
擐系	擐繫
擒获	擒獲
擘划	擘劃
擞	擻
擢升	擢升
擢发	擢髮
擦刮	擦刮
擦布	擦布
擦干	擦乾
擦干净	擦乾淨
擦药	擦藥
攀云	攀雲
攀升	攀升
攀岩	攀巖
攀折	攀折
攒	攢
支出	支出
支划	支劃
支干	支幹
支当	支當
支杆	支桿
收了	收了
收出	收出
收发	收發
收回	收回
收复	收復
收尸	收屍
收录	收錄
收据	收據
收秋	收秋
收获	收穫
收针	收針
改个	改個
改了	改了
改于	改於
改修	改修
改制	改制 改製
改向	改向
改回	改回
改当	改當
改征	改徵
攻了	攻了
攻克	攻克
攻占	攻佔
攻向	攻向
放个	放個
放了	放了
放党	放黨
放出	放出
放参	放參
放回	放回
放尽	放盡
放松	放鬆
放烟	放煙
放荡	放蕩
放蒙挣	放懞掙
政党	政黨
政制	政制
政坛	政壇
故事里	故事裏
故于	故於
故云	故云
故出	故出
故当	故當
故舍	故舍
故里	故里
敌	敵
敌党	敵黨
敌后	敵後
敌忾同仇	敵愾同讎
敏于	敏於
救出	救出
救回	救回
救药	救藥
敖游	敖遊
敖荡	敖盪
教个	教個
教了	教了
教于	教於
教出	教出
教团	教團
教坛	教壇
教学钟	教學鐘
教范	教範
敛	斂
敝舍	敝舍
敢于	敢於
敢借	敢借
敢出	敢出
敢向	敢向
敢干	敢幹
敢当	敢當
敢摆	敢擺
散于	散於
散伙	散夥
散出	散出
散发	散發 散髮
散布	散布
散曲	散曲
散板	散板
散荡	散蕩
敦朴	敦樸
敬同	敬同
敬挽	敬輓
敬烟	敬菸
数	數
数万	數萬
数与虏确	數與虜确
数了	數了
数借	數借
数出	數出
数千	數千
数字钟	數字鐘
数据	數據
数术	數術
数罪并罚	數罪併罰
敲了	敲了
敲出	敲出
敲扑	敲扑
敲钟	敲鐘
整个	整個
整了	整了
整修	整修
整党	整黨
整出	整齣
整发	整發
整发用品	整髮用品
整只	整隻
整叶	整葉
整合	整合
整周	整週
整庄	整莊
整柜	整櫃
整面	整面
敷了	敷了
敷出	敷出
敷布	敷布
敷涂	敷塗
敷药	敷藥
敷面	敷面
文丑	文丑
文同	文同
文坛	文壇
文彩	文彩
文征明	文徵明
文思泉涌	文思泉涌
文才	文才
文曲	文曲
文种	文種
文致	文致
文表	文表
文采	文采
文鉴	文鑒
文面	文面
斋	齋
斋坛	齋壇
斋栗	齋慄
斋舍	齋舍
斓	斕
斗上	鬭上
斗不过	鬭不過
斗丽	鬭麗
斗了	鬭了
斗争	鬭爭
斗倒	鬭倒
斗储	斗儲
斗六	斗六
斗分子	鬭分子
斗别气	鬭彆氣
斗力	鬭力
斗劲	鬭勁
斗升	斗升
斗南	斗南
斗叠	鬭疊
斗口	鬭口
斗叶儿	鬭葉兒
斗叶子	鬭葉子
斗合	鬭合
斗哄	鬭鬨
斗嘴	鬭嘴
斗地主	鬭地主
斗城	斗城
斗士	鬭士
斗大	斗大
斗头	鬭頭
斗子	斗子
斗室	斗室
斗富	鬭富
斗居	斗居
斗山	斗山
斗巧	鬭巧
斗帐	斗帳
斗幌子	鬭幌子
斗店	斗店
斗府	斗府
斗弄	鬭弄
斗引	鬭引
斗彩	鬭彩
斗很	鬭很
斗心眼	鬭心眼
斗志	鬭志
斗成	鬭成
斗打	鬭打
斗批改	鬭批改
斗技	鬭技
斗拱	斗拱
斗文	鬭文
斗斋	斗齋
斗斗	鬭鬭 斗斗
斗方	斗方
斗智	鬭智
斗暴	鬭暴
斗杓	斗杓
斗来斗去	鬭來鬭去
斗极	斗極
斗柄	斗柄
斗栱	斗栱
斗概	斗概
斗武	鬭武
斗殴	鬭毆
斗气	鬭氣
斗法	鬭法
斗渠	斗渠
斗灯	斗燈
斗然	斗然
斗牌	鬭牌
斗牙拌齿	鬭牙拌齒
斗牙斗齿	鬭牙鬭齒
斗牛	鬭牛
斗犀台	鬭犀臺
斗犬	鬭犬
斗狠	鬭狠
斗百草	鬭百草
斗眼	鬭眼
斗着	鬭着
斗私批修	鬭私批修
斗笠	斗笠
斗筲	斗筲
斗箕	斗箕
斗篷	斗篷
斗纹	斗紋
斗绝	斗絕
斗而铸兵	鬭而鑄兵
斗而铸锥	鬭而鑄錐
斗胆	斗膽
斗胜	鬭勝
斗脚	鬭腳
斗舰	鬭艦
斗艳	鬭豔
斗茶	鬭茶
斗草	鬭草
斗薮	斗藪
斗蟋蟀	鬭蟋蟀
斗话	鬭話
斗起	鬭起
斗趣	鬭趣
斗车	斗車
斗酒	斗酒
斗量	斗量
斗门	斗門
斗闲气	鬭閒氣
斗闷	鬭悶
斗阵	鬭陣
斗雪红	鬭雪紅
斗顿	斗頓
斗风	鬭風
斗食	斗食
斗饤	鬭飣
斗香	斗香
斗魁	斗魁
斗鱼	鬭魚
斗鸡	鬭雞
斗鸭	鬭鴨
斗鹌鹑	鬭鵪鶉
料斗	料斗
斜了	斜了
斜曲	斜曲
斜谷	斜谷
斜面	斜面
斥卤	斥鹵
斩	斬
斩尽	斬盡
斩获	斬獲
斫雕为朴	斫雕爲樸
断	斷
断了	斷了
断发	斷髮
断后	斷後
断烟	斷煙
断种	斷種
断面	斷面
斯干	斯干
斯托	斯托
斯须	斯須
新丰	新豐
新党	新黨
新出	新出
新制	新制
新历	新曆
新发	新發
新台	新臺
新叶	新葉
新娘	新娘
新庄	新莊
新扎	新紮
新秋	新秋
斲雕为朴	斲雕爲樸
方便面	方便麵
方几	方几
方向	方向
方志	方誌
方才	方纔
方术	方術
方胜	方勝
方药	方藥
方里	方里
方针	方針
方面	方面
於姓	於姓
於氏	於氏
施于	施於
施舍	施捨
施药	施藥
旁出	旁出
旁征	旁徵
旁征博引	旁徵博引
旁注	旁註
旁系	旁系
旅历	旅歷
旅游	旅遊
旅舍	旅舍
旋回	旋迴
旋干转坤	旋乾轉坤
旋绕着	旋繞着
旋胡	旋胡
旋辟	旋辟
旋里	旋里
旌别	旌別
旌表	旌表
旍表	旍表
族党	族黨
族里	族裏
旗杆	旗杆
旛胜	旛勝
无	無
无价	無價
无余	無餘
无党	無黨
无几	無幾
无出	無出
无后	無後
无尽	無盡
无干	無干
无征不信	無徵不信
无据	無據
无极	無極
无梁楼盖	無樑樓蓋
无法克制	無法剋制
无烟	無煙
无药可救	無藥可救
无须	無須
日出	日出
日占	日佔
日历	日曆
日后	日後
日子里	日子裏
日干	日干
日御	日御
日志	日誌
日晒	日曬
日系	日系
日表	日表
旧	舊
旧制	舊制
旧厂	舊廠
旧历	舊曆
旧庄	舊庄
旧恶	舊惡
旧游	舊遊
旧症	舊症
旧药	舊藥
旧表	舊錶
旧钟	舊鐘
旧钟表	舊鐘錶
早了	早了
早于	早於
早借	早借
早出	早出
早参	早參
早秋	早秋
旱干	旱乾
旱烟	旱菸
时	時
时价	時價
时症	時症
时针	時針
时钟	時鐘
时间里	時間裏
旷	曠
旷荡	曠蕩
旸谷	暘谷
昆仑	崑崙
昆仑山	昆崙山
昆剧	崑劇
昆山	崑山
昆布	昆布
昆曲	崑曲
昆腔	崑腔
昆苏	崑蘇
昆虫	昆蟲
昆调	崑調
明了	明瞭
明于	明於
明发	明發
明台	明臺
明后	明後
明当	明當
明征	明徵
明志	明志
明据	明據
明摆	明擺
明暗	明暗
明板	明板
明目张胆	明目張胆
明确	明確
明窗净几	明窗淨几
明范	明範
明里	明裏
明鉴	明鑑
昏了	昏了
昏困	昏困
昏暗	昏暗
昏沈	昏沈
易于	易於
易克制	易剋制
昙	曇
星云	星雲
星历	星曆
星回	星迴
星团	星團
星彩	星彩
星斗	星斗
星术	星術
星系	星系
星虫	星蟲
星表	星表
星辰表	星辰錶
映出	映出
春假里	春假裏
春卷	春捲
春台	春臺
春困	春困
春天里	春天裏
春日里	春日裏
春游	春遊
春秋	春秋
春纤	春纖
春胜	春勝
春药	春藥
春香斗学	春香鬭學
昧于	昧於
昧谷	昧谷
昭回	昭回
是个	是個
是须	是須
昼	晝
显	顯
显出	顯出
显示表	顯示錶
显示钟	顯示鐘
晃了	晃了
晃荡	晃盪
晋	晉
晋升	晉升
晒	曬
晒伤	曬傷
晒台	曬臺
晒图	曬圖
晒干	曬乾
晒成	曬成
晒晒	曬曬
晒烟	曬菸
晒种	曬種
晒衣	曬衣
晒谷	曬穀
晒黑	曬黑
晓	曉
晔	曄
晕	暈
晕台	暈臺
晕船药	暈船藥
晕车药	暈車藥
晕针	暈針
晖	暉
晚于	晚於
晚参	晚參
晚娘	晚娘
晚秋	晚秋
晚钟	晚鐘
晞发	晞髮
晤面	晤面
晦暗	晦暗
晦蒙	晦蒙
晨钟	晨鐘
普冬冬	普鼕鼕
景云	景雲
景致	景緻
晴了	晴了
晶系	晶系
晶面	晶面
智周	智周
智术	智術
晾干	晾乾
暂	暫
暂于	暫於
暂借	暫借
暂别	暫別
暂升	暫升
暌合	暌合
暑修	暑修
暑假里	暑假裏
暖冬	暖冬
暖厂	暖廠
暖帘	暖簾
暖种	暖種
暗中	暗中
暗九	暗九
暗乱	闇亂
暗了	暗了
暗事	暗事
暗付	暗付
暗伤	暗傷
暗伦	闇倫
暗冥	闇冥
暗到	暗到
暗劣	闇劣
暗叫	暗叫
暗号	暗號
暗合	暗合
暗含	暗含
暗喜	暗喜
暗喻	暗喻
暗器	暗器
暗地	暗地
暗地里	暗地裏
暗场	暗場
暗堡	暗堡
暗处	暗處
暗娼	暗娼
暗室	暗室
暗害	暗害
暗射	暗射
暗屋	暗屋
暗巷	暗巷
暗弱	闇弱
暗影	暗影
暗得	暗得
暗忖	暗忖
暗恋	暗戀
暗想	暗想
暗房	暗房
暗指	暗指
暗探	暗探
暗斗	暗鬭
暗昧	暗昧
暗暗	暗暗
暗杀	暗殺
暗桩	暗樁
暗槓	暗槓
暗沟	暗溝
暗沟里	暗溝裏
暗泣	暗泣
暗流	暗流
暗浅	闇淺
暗淡	暗淡
暗渠	暗渠
暗滩	暗灘
暗潮	暗潮
暗澹	暗澹
暗然	闇然
暗疾	暗疾
暗的	暗的
暗盘	暗盤
暗盼	暗盼
暗码	暗碼
暗礁	暗礁
暗示	暗示
暗移	暗移
暗笑	暗笑
暗算	暗算
暗管	暗管
暗箭	暗箭
暗箱	暗箱
暗红	暗紅
暗线	暗綫
暗练	暗練
暗自	暗自
暗色	暗色
暗莫	闇莫
暗蔼	暗藹
暗藏	暗藏
暗虚	暗虛
暗行	暗行
暗袋	暗袋
暗褐	暗褐
暗计	暗計
暗记	暗記
暗访	暗訪
暗语	暗語
暗诵	闇誦
暗跳	闇跳
暗转	暗轉
暗边	暗邊
暗送	暗送
暗通	暗通
暗道	暗道
暗里	暗裏
暗釦	暗釦
暗锁	暗鎖
暗门	暗門
暗问	暗問
暗香	暗香
暗骂	暗罵
暗黝	暗黝
暧	曖
暮烟	暮煙
暮秋	暮秋
暴发	暴發
暴敛横征	暴斂橫徵
暴晒	暴曬
暴腌	暴醃
暴面	暴面
曝晒	曝曬
曰云	曰云
曲从	曲從
曲体	曲體
曲匝	曲匝
曲台	曲臺
曲名	曲名
曲园	曲園
曲士	曲士
曲子	曲子
曲学	曲學
曲室	曲室
曲宴	曲宴
曲尘	麯塵
曲尺	曲尺
曲局	曲局
曲庇	曲庇
曲度	曲度
曲式	曲式
曲径	曲徑
曲律	曲律
曲意	曲意
曲房	曲房
曲折	曲折
曲拐	曲拐
曲拗	曲拗
曲挠	曲撓
曲曲	曲曲
曲本	曲本
曲柄	曲柄
曲栏	曲欄
曲水	曲水
曲江	曲江
曲流	曲流
曲牌	曲牌
曲率	曲率
曲球	曲球
曲琼	曲瓊
曲生	麯生
曲盖	曲蓋
曲目	曲目
曲直	曲直
曲礼	曲禮
曲秀才	麯秀才
曲笔	曲筆
曲笛	曲笛
曲线	曲綫
曲绕	曲繞
曲背	曲背
曲臂	曲臂
曲致	曲致
曲艺	曲藝
曲菌	麯菌
曲薄	曲薄
曲蘖	麯櫱
曲蟮	曲蟮
曲裾	曲裾
曲解	曲解
曲话	曲話
曲说	曲說
曲调	曲調
曲谨	曲謹
曲谱	曲譜
曲赦	曲赦
曲车	麯車
曲轴	曲軸
曲道	曲道
曲道士	麯道士
曲钱	麯錢
曲阜	曲阜
曲阳	曲陽
曲阻	曲阻
曲院	麯院
曲隐	曲隱
曲霉	麯黴
曲面	曲面
更仆难数	更僕難數
更出	更出
更向	更向
更复	更復
更当	更當
更愿	更願
更签	更籤
更钟	更鐘
更须	更須
曷极	曷極
曹参	曹參
曼谷	曼谷
曾于	曾於
曾参	曾參
曾朴	曾樸
最后	最後
最多	最多
最须	最須
月出	月出
月历	月曆
月台	月臺
月团	月團
月御	月御
月面	月面
有个	有個
有了	有了
有事之无范	有事之無範
有仆	有僕
有仇	有仇
有价	有價
有余	有餘
有准	有準
有发头陀寺	有髮頭陀寺
有只	有隻
有只采	有只採
有后	有後
有周	有周
有够赞	有够讚
有幸	有幸
有当	有當
有征	有徵
有志	有志
有恒街	有恒街
有才	有才
有极	有極
有栖川	有栖川
有棱有角	有棱有角
有秋	有秋
有种	有種
有采	有采
有鉴	有鑒
有面	有面
朋党	朋黨
朋奸	朋奸
服了	服了
服于	服於
服制	服制
服御	服御
服舍	服舍
服药	服藥
朔云	朔雲
朔党	朔黨
望云	望雲
望后石	望后石
望向	望向
望幸	望幸
望着表	望着錶
望着钟	望着鐘
望着钟表	望着鐘錶
朝云	朝雲
朝后	朝後
朝向	朝向
朝钟	朝鐘
朦胧	朦朧
木偶戏扎	木偶戲紮
木制	木製
木厂	木廠
木叶	木葉
木杆	木杆
木材干馏	木材乾餾
木板	木板
木梁	木樑
木蜡	木蠟
木钟	木鐘
木雕	木雕
未了	未了
未几	未幾
未出	未出
未尝	未嘗
未尽	未盡
未干	未乾
未获	未獲
末了	末了
末叶	末葉
末后	末後
末娘	末娘
末药	末藥
本价	本價
本党	本黨
本厂	本廠
本台	本臺
本周	本週
本回	本回
本团	本團
本当	本當
本征	本徵
本志	本志
本愿	本願
本系	本系
本里	本里
术	術
术士	術士
术数	術數
术科	術科
术艺	術藝
术语	術語
术赤	朮赤
朱丹	朱丹
朱亥	朱亥
朱仑街	朱崙街
朱先	朱先
朱光	朱光
朱华	朱華
朱卷	硃卷
朱唇皓齿	硃唇皓齒
朱墨	朱墨 硃墨
朱子	朱子
朱学	朱學
朱实	朱實
朱庆余	朱慶餘
朱弁	朱弁
朱弦	朱弦
朱批	硃批
朱提	朱提
朱文	朱文
朱明	朱明
朱权	朱權
朱标	朱標
朱槿	朱槿
朱温	朱溫
朱漆	朱漆
朱熹	朱熹
朱理安历	朱理安曆
朱瑞	朱瑞
朱砂	硃砂
朱穆	朱穆
朱笔	硃筆
朱筠	朱筠
朱紫	朱紫
朱红	硃紅
朱红色	硃紅色
朱耷	朱耷
朱脣	朱脣
朱色	硃色
朱蒙	朱蒙
朱蕉	朱蕉
朱衣	朱衣
朱记	朱記
朱诺	朱諾
朱谕	硃諭
朱轩	朱軒
朱轮	朱輪
朱邸	朱邸
朱门	朱門
朱阁	朱閣
朱陈	朱陳
朱雀	朱雀
朱顶	朱頂
朱颜	朱顏
朱鸟	朱鳥
朱鹭	朱鷺
朱黄	朱黃
朴修斯	樸修斯
朴刀	朴刀
朴厚	樸厚
朴子	朴子
朴学	樸學
朴实	樸實
朴忠	朴忠
朴念仁	樸念仁
朴拙	樸拙
朴樕	樸樕
朴父	朴父
朴直	樸直
朴硝	朴硝
朴素	樸素
朴茂	朴茂
朴讷	樸訥
朴质	樸質
朴鄙	樸鄙
朴重	樸重
朴野	樸野
朴钝	樸鈍
朴陋	樸陋
朴马	樸馬
朴鲁	樸魯
朵云	朵雲
机	機
机制	機制
机发	機發
机板	機板
机械表	機械錶
机械钟	機械鐘
机种	機種
机绣	機繡
机辟	機辟
杀	殺
杀价	殺價
杀出	殺出
杀才	殺才
杀虫	殺蟲
杀虫药	殺蟲藥
杂	雜
杂合面儿	雜合麵兒
杂当	雜當
杂录	雜錄
杂志	雜誌
杂症	雜症
杂种	雜種
杂面	雜麵
权	權
权制	權制
权幸	權幸
权术	權術
杆	桿
杆上	杆上
杆儿	杆兒 桿兒
杆刀	桿刀
杆塔	杆塔
杆子	杆子
杆状	桿狀
杆直	桿直
杆秤	桿秤
杆茵	桿茵
杆菌	桿菌
李连杰	李連杰
李連杰	李連杰
杏坛	杏壇
材干	材幹
材种	材種
村子里	村子裏
村庄	村莊
村舍	村舍
村里	村裏
杜老志道	杜老誌道
杞宋无征	杞宋無徵
杞梁	杞梁
束修	束脩
束发	束髮
杠杆	杠桿
条	條
条干	條幹
条据	條據
来	來
来个	來個
来了	來了
来于	來於
来历	來歷
来台	來臺
来叶	來葉
来回	來回
来复	來複
来苏	來蘇
杨	楊
杨修	楊修
杨朱	楊朱
杩	榪
杪秋	杪秋
杯台	杯臺
杯干	杯乾
杯面	杯麵
杰	傑
杰伦	杰倫
杰作	傑作
杰克	傑克
杰出	傑出
杰特	杰特
松一口气	鬆一口氣
松下	松下
松丘	松丘
松乔	松喬
松了	鬆了
松些	鬆些
松仁	松仁
松元音	鬆元音
松动	鬆動
松劲	鬆勁
松口	鬆口
松叶	松葉
松喉	鬆喉
松土	鬆土
松子	松子
松宽	鬆寬
松山	松山
松岭	松嶺
松开	鬆開
松弛	鬆弛
松快	鬆快
松懈	鬆懈
松手	鬆手
松掉	鬆掉
松散	鬆散
松明	松明
松木	松木
松松	鬆鬆
松林	松林
松果	松果
松枝	松枝
松柏	松柏
松柔	鬆柔
松树	松樹
松毛	松毛
松毬	松毬
松气	鬆氣
松江	松江
松油	松油
松浮	鬆浮
松涛	松濤
松漠	松漠
松烟	松煙
松煤	松煤
松球	松球
松瓤	松瓤
松科	松科
松竹	松竹
松类	松類
松紧	鬆緊
松纹	松紋
松绑	鬆綁
松缓	鬆緩
松胶	松膠
松脂	松脂
松脆	鬆脆
松脱	鬆脫
松花	松花
松茸	松茸
松菌	松菌
松萝	松蘿
松蕈	松蕈
松蕊	松蕊
松蛋	鬆蛋
松起	鬆起
松软	鬆軟
松通	鬆通
松针	松針
松露	松露
松风	松風
松饼	鬆餅
松香	松香
松鱼	松魚
松鸡	松雞
松鹤	松鶴
松鼠	松鼠
板书	板書
板儿	板兒
板凳	板凳
板壁	板壁
板子	板子
板式	板式
板擦	板擦
板斧	板斧
板本	板本
板材	板材
板极	板極
板栗	板栗
板桥	板橋
板滞	板滯
板牙	板牙
板球	板球
板画	板畫
板着脸	板着臉
板结	板結
板胡	板胡
板荡	板蕩
板起	板起
板车	板車
板金	板金
板鸭	板鴨
极	極
极不	極不
极乐	極樂
极了	極了
极低	極低
极佳	極佳
极值	極值
极光	極光
极其	極其
极具	極具
极冠	極冠
极刑	極刑
极力	極力
极化	極化
极口	極口
极右	極右
极品	極品
极圈	極圈
极地	極地
极处	極處
极大	極大
极好	極好
极富	極富
极小	極小
极少	極少
极尽	極盡
极峰	極峰
极左	極左
极带	極帶
极度	極度
极微	極微
极性	極性
极恶	極惡
极愿	極願
极早	極早
极权	極權
极板	極板
极点	極點
极爲	極爲
极盛	極盛
极目	極目
极移	極移
极端	極端
极至	極至
极致	極致
极色	極色
极轴	極軸
极选	極選
极量	極量
极锋	極鋒
极限	極限
极高	極高
构	構
构筑	構築
析出	析出
枕借	枕藉
林冲	林沖
林宏岳	林宏嶽
林表	林表
林钟	林鐘
枚卜	枚卜
果于	果於
果子干	果子乾
果干	果乾
果穗	果穗
枝不得大于干	枝不得大於榦
枝叶	枝葉
枝干	枝幹
枝针	枝針
枞	樅
枢	樞
枣	棗
枣庄	棗莊
枥	櫪
枨	棖
枪	槍
枪托	槍托
枪杆	槍桿
枫	楓
枫叶	楓葉
枭	梟
枯叶	枯葉
枯干	枯乾
架个	架個
架了	架了
架出	架出
架回	架回
架钟	架鐘
枷板	枷板
柏克	柏克
柏台	柏臺
某个	某個
某只	某隻
某种	某種
某舍	某舍
某面	某面
染发	染髮
染布	染布
染干	染干
染殿后	染殿后
柔克	柔克
柔术	柔術
柜	櫃
柜上	櫃上
柜台	櫃檯
柜子	柜子
柜房	櫃房
柜柳	柜柳
柜橱	櫃櫥
柠	檸
柱梁	柱樑
柳叶	柳葉
柳诒征	柳詒徵
柴胡	柴胡
査价	査價
査修	査修
査出	査出
査卷	査卷
査回	査回
査获	査獲
査表	査表
柽	檉
栀	梔
栅	柵
栅极	柵極
标	標
标价	標價
标准	標準
标出	標出
标占	標占
标志	標誌
标杆	標杆
标注	標註
标签	標籤
标致	標緻
标表	標表
栈	棧
栉	櫛
栉发工	櫛髮工
栊	櫳
栋	棟
栋梁	棟樑
栌	櫨
栎	櫟
栏	欄
栏干	欄干
栏杆	欄杆
栏板	欄板
栏柜	欄櫃
树	樹
树党	樹黨
树叶	樹葉
树干	樹榦
树梁	樹樑
树种	樹種
栖	棲
栖于	棲於
栖栖皇皇	栖栖皇皇
栗冽	慄冽
栗凿	栗鑿
栗喇	栗喇
栗子	栗子
栗尾	栗尾
栗暴	栗暴
栗栗	慄慄 栗栗
栗烈	栗烈
栗然	慄然
栗爆	栗爆
栗碌	栗碌
栗色	栗色
栗苞	栗苞
栗薪	栗薪
栗鼠	栗鼠
校仇	校讎
校准	校準
校舍	校舍
样	樣
样板	樣板
样范	樣範
核准	核准
核发	核發
核复	核覆
根据	根據
根系	根系
格于	格於
格斗	格鬭
格致	格致
格范	格範
格里	格里
格里历	格里曆
格里高利历	格里高利曆
栽种	栽種
栾	欒
桂圆干	桂圓乾
桂秋	桂秋
桅杆	桅杆
框出	框出
案准	案准
案卷	案卷
案发	案發
案据	案據
案板	案板
桌几	桌几
桌历	桌曆
桌布	桌布
桌面	桌面
桑叶	桑葉
桑干	桑乾
桑虫	桑蟲
桑针	桑針
桓表	桓表
桠	椏
桡	橈
桢	楨
桢干	楨幹
档	檔
档卷	檔卷
桤	榿
桥	橋
桥台	橋臺
桥梁	橋樑
桥面	橋面
桦	樺
桧	檜
桨	槳
桩	樁
梁上	樑上
梁丽	梁麗
梁书	梁書
梁园	梁園
梁子	樑子
梁孟	梁孟
梁山	梁山
梁州	梁州
梁架	樑架
梁柱	樑柱
梁栋	樑棟
梁案	梁案
梁楷	梁楷
梁祝	梁祝
梁辀	梁輈
梁鸿	梁鴻
梁龙	樑龍
梓里	梓里
梢云	梢雲
梦	夢
梦云	夢雲
梦卜	夢卜
梦游	夢遊
梦里	夢裏
梨云	梨雲
梨干	梨乾
梯冲	梯衝
械斗	械鬭
械系	械繫
梳了	梳了
梵谷	梵谷
梼	檮
检	檢
检修	檢修
检复	檢覆
检尸	檢屍
检录	檢錄
棂	欞
棉制	棉製
棉卷	棉卷
棉厂	棉廠
棉布	棉布
棋布	棋布
棒坛	棒壇
棒子面	棒子麵
棒针	棒針
棘针	棘針
棫朴	棫樸
森林里	森林裏
棱体	棱體
棱台	棱臺
棱子	棱子
棱层	棱層
棱柱	棱柱
棱棱	棱棱
棱登	棱登
棱等登	棱等登
棱线	棱綫
棱缝	棱縫
棱角	棱角
棱锥	棱錐
棱镜	棱鏡
棺材里	棺材裏
椁	槨
植党	植黨
植发	植髮
椟	櫝
椠	槧
椤	欏
椭	橢
椰枣干	椰棗乾
椰胡	椰胡
椰雕	椰雕
椽梁	椽梁
楚庄王	楚莊王
楚庄绝缨	楚莊絕纓
楚庄问鼎	楚莊問鼎
楮叶	楮葉
楼	樓
楼台	樓臺
楼板	樓板
楼面	樓面
榄	欖
榇	櫬
榈	櫚
榉	櫸
榔板	榔板
榨干	榨乾
榻布	榻布
槃才	槃才
槓杆	槓桿
槛	檻
槟	檳
槠	櫧
樛曲	樛曲
模制	模製
模板	模板
模棱	模棱
模范	模範
模表	模表
横	橫
横冲	橫衝
横出	橫出
横向	橫向
横征暴敛	橫徵暴斂
横摆	橫擺
横杆	横杆
横梁	橫樑
横秋	橫秋
横舍	橫舍
横面	橫面
樯	檣
樱	櫻
樵苏	樵蘇
樵采	樵採
橡斗	橡斗
橥	櫫
橦布	橦布
橱	櫥
橱柜	櫥櫃
橹	櫓
橼	櫞
檀板	檀板
檩	檁
欠当	欠當
欠据	欠據
次于	次於
次后	次後
欢	歡
欣戚	欣戚
欤	歟
欧	歐
欧克	歐克
欧游	歐遊
欲令智昏	慾令智昏
欲堑	欲塹
欲壑难填	慾壑難填
欲待	欲待
欲得	欲得
欲念	慾念
欲望	慾望
欲求	欲求
欲海	慾海
欲火	慾火
欲界	欲界
欲障	慾障
欷吁	欷吁
欺蒙	欺矇
款冬	款冬
款曲	款曲
歇了	歇了
歇后	歇後
歌后	歌后
歌坛	歌壇
歌曲	歌曲
歌板	歌板
歌钟	歌鐘
歎吁	歎吁
止于	止於
止咳药	止咳藥
止痛药	止痛藥
止血药	止血藥
止饥	止飢
正于	正於
正凶	正凶
正出	正出
正合	正合
正后	正後
正向	正向
正在叱咤	正在叱咤
正当	正當
正极	正極
正确	正確
正面	正面
此后	此後
武丑	武丑
武后	武后
武当	武當
武斗	武鬭
武术	武術
武松	武松
歧出	歧出
歪向	歪向
歪才	歪才
歪曲	歪曲
歹斗	歹鬭
死了	死了
死于	死於
死党	死黨
死别	死別
死后	死後
死尸	死屍
死当	死當
死板	死板
死症	死症
死谷	死谷
死里求生	死裏求生
死里逃生	死裏逃生
死面	死面 死麵
歼	殲
殁	歿
殆尽	殆盡
殇	殤
殊别	殊別
殊胜	殊勝
殊致	殊致
残	殘
残余	殘餘
残党	殘黨
残冬	殘冬
残卷	殘卷
残秋	殘秋
残肴	殘肴
殒	殞
殓	殮
殖谷	殖穀
殚	殫
殚尽	殫盡
殡	殯
殡舍	殯舍
殴	毆
殴斗	毆鬭
殷同	殷同
殷师牛斗	殷師牛鬭
殷鉴	殷鑒
殿后	殿後
殿钟自鸣	殿鐘自鳴
毁	毀
毁了	毀了
毁于	毀於
毁钟为铎	毀鐘爲鐸
毂	轂
毋须	毋須
母丑	母醜
母党	母黨
母后	母后
母系	母系
母范	母範
每个	每個
每于	每於
每只	每隻
每周	每週
每回	每回
每当	每當
每种	每種
每面	每面
毒症	毒症
毒药	毒藥
毒虫	毒蟲
毒针	毒針
比个	比個
比了	比了
比价	比價
比出	比出
比划	比劃
比合	比合
比周	比周
比干	比干
比并	比並
比才	比才
比舍	比舍
毕	畢
毕于	畢於
毕升	畢昇
毙	斃
毚欲	毚欲
毛了	毛了
毛卷	毛卷
毛发	毛髮
毛团	毛團
毛坏	毛坏
毛姜	毛薑
毛布	毛布
毛板	毛板
毛虫	毛蟲
毡	氈
毫克	毫克
毫升	毫升
毫厘	毫釐
毫发	毫髮
毫针	毫針
毵	毿
氇	氌
民党	民黨
民团	民團
民志	民志
民极	民極
气	氣
气了	氣了
气团	氣團
气尽	氣盡
气郁	氣鬱
氢	氫
氤郁	氤鬱
氩	氬
氲	氳
水准	水準
水厂	水廠
水合	水合
水团	水團
水帘	水簾
水彩	水彩
水斗	水斗
水曲	水曲
水来汤里去	水來湯裏去
水柜	水櫃
水注	水注
水烟	水煙
水系	水系
水表	水表
水里	水裏
水鉴	水鑒
水面	水面
永别	永別
永历	永曆
永志	永志
永志不忘	永誌不忘
永胜	永勝
汀曲	汀曲
求借	求借
求出	求出
求才	求才
求知欲	求知慾
求签	求籤
求胜	求勝
汇	匯
汇丰	匯豐
汇付	匯付
汇信	匯信
汇兑	匯兌
汇入	匯入
汇出	匯出
汇刊	彙刊
汇合	匯合
汇展	匯展
汇差	匯差
汇市	匯市
汇总	彙總
汇成	匯成
汇报	彙報
汇整	彙整
汇款	匯款
汇水	匯水
汇流	匯流
汇爲	匯爲
汇率	匯率
汇电	匯電
汇票	匯票
汇算	彙算
汇纂	彙纂
汇编	彙編
汇聚	匯聚
汇费	匯費
汇辑	彙輯
汇钱	匯錢
汇银	匯銀
汇集	彙集
汉	漢
汉奸	漢奸
汉弥登钟	漢彌登鐘
汉志	漢志
汙蔑	汙衊
江参	江參
江干	江干
江苏	江蘇
江表	江表
江面	江面
池里	池裏
污蔑	汙衊
汤	湯
汤下面	湯下麵
汤团	湯糰
汤药	湯藥
汤面	湯麵
汲于	汲於
汴梁	汴梁
汹	洶
汹涌	洶涌
汽表	汽表
沈下	沈下
沈冤	沈冤
沈勇	沈勇
沈厚	沈厚
沈吉线	瀋吉綫
沈吟	沈吟
沈周	沈周
沈复	沈復
沈寂	沈寂
沈山线	瀋山綫
沈州	瀋州
沈思	沈思
沈括	沈括
沈水	瀋水
沈没	沈沒
沈沦	沈淪
沈河	瀋河
沈浊	沈濁
沈浮	沈浮
沈海	瀋海
沈浸	沈浸
沈淀	沈澱
沈湎	沈湎
沈溺	沈溺
沈滞	沈滯
沈疔	沈疔
沈疴	沈痾
沈痛	沈痛
沈痼	沈痼
沈着	沈着
沈睡	沈睡
沈积	沈積
沈筒	沈筒
沈约	沈約
沈腰	沈腰
沈船	沈船
沈落	沈落
沈迷	沈迷
沈郁	沈鬱
沈醉	沈醉
沈重	沈重
沈闷	沈悶
沈阳	瀋陽
沈降	沈降
沈陷	沈陷
沈静	沈靜
沈香	沈香
沈默	沈默
沉淀	沉澱
沉郁	沉鬱
沓合	沓合
沙参	沙蔘
沙发	沙發
沙弥	沙彌
沙里淘金	沙裏淘金
沙雕	沙雕
沟	溝
沟谷	溝谷
没	沒
没了	沒了
没事干	沒事幹
没借	沒借
没准	沒準
没出	沒出
没升	沒升
没后	沒後
没向	沒向
没回	沒回
没干	沒幹
没干没净	沒乾沒淨
没幸	沒幸
没当	沒當
没折至	沒摺至
没梢干	沒梢幹
没种	沒種
没签	沒簽
没药	沒藥
没采	沒采
沣	灃
沤	漚
沤郁	漚鬱
沥	瀝
沦	淪
沦于	淪於
沧	滄
沩	潙
沪	滬
沮舍	沮舍
河岳	河嶽
河梁	河梁
河系	河系
河谷	河谷
河里	河裏
河面	河面
油价	油價
油厂	油廠
油布	油布
油彩	油彩
油斗	油鬭
油松	油松
油烟	油煙
油面	油麵
治了	治了
治愈	治癒
治术	治術
沿溯	沿溯
泄了	泄了
泄出	泄出
泄欲	泄慾
泉台	泉臺
泐复	泐覆
泐布	泐布
法云	法雲
法制	法制
法占	法佔
法台	法臺
法坛	法壇
法曲	法曲
法术	法術
法系	法系
泛出	泛出
泛游	泛遊
泞	濘
泡制	泡製
泡面	泡麵
波发藻	波髮藻
波娘	波娘
波折	波折
波棱菜	波棱菜
波荡	波盪
波谷	波谷
泣别	泣別
泥于	泥於
泥岩	泥岩
泥板	泥板
泥涂	泥塗
注上	註上
注云	注云
注儿	注兒
注入	注入
注冊	註冊
注册	註冊
注到	注到
注名	註名
注塑	注塑
注失	註失
注子	注子
注定	註定
注射	注射
注心	注心
注意	注意
注慕	注慕
注批	註批
注文	註文
注明	註明
注本	注本
注标	註標
注水	注水
注油	注油
注消	注消
注满	注滿
注生娘娘	註生娘娘
注疏	註疏
注目	注目
注脚	註腳
注色	注色
注视	注視
注解	註解
注记	註記
注译	註譯
注释	註釋
注重	注重
注销	註銷
注音	注音
泪	淚
泪如泉涌	淚如泉涌
泪干	淚乾
泪蜡	淚蠟
泰坛	泰壇
泰斗	泰斗
泱郁	泱鬱
泳气钟	泳氣鐘
泶	澩
泷	瀧
泸	瀘
泺	濼
泻	瀉
泻了	瀉了
泻出	瀉出
泻药	瀉藥
泼	潑
泼出	潑出
泼才	潑才
泽	澤
泽卤	澤鹵
泽梁	澤梁
泽渗漓而下降	澤滲灕而下降
泾	涇
洁	潔
洄暗	洄闇
洄游	洄遊
洋参	洋參
洋布	洋布
洋烟	洋菸
洋药	洋藥
洋蜡	洋蠟
洋面	洋麵
洒	灑
洒出	灑出
洒家	洒家
洒扫	洒掃
洒水	洒水
洒洒	洒洒
洒涤	洒滌
洒淅	洒淅
洒濯	洒濯
洒然	洒然
洒脱	洒脫
洗了	洗了
洗出	洗出
洗刮	洗刮
洗发	洗髮
洗炼	洗煉
洗练	洗鍊
洗荡	洗盪
洗链	洗鍊
洗面	洗面
洛克	洛克
洛党	洛黨
洛钟东应	洛鐘東應
洞鉴	洞鑒
津发	津發
津梁	津樑
洪升	洪昇
洪复	洪覆
洪范	洪範
洪适	洪适
洪钟	洪鐘
活了	活了
活出	活出
洼	窪
派克	派克
派出	派出
派别	派別
派团	派團
派系	派系
流个	流個
流了	流了
流于	流於
流云	流雲
流出	流出
流别	流別
流向	流向
流回	流回
流尽	流盡
流布	流布
流当	流當
流征	流徵
流注	流注
流苏	流蘇
流荡	流蕩
浃	浹
浅	淺
浅尝	淺嘗 淺嚐
浅淀	淺澱
浅雕	淺雕
浆	漿
浇	澆
浇漓	澆漓
浇筑	澆築
浈	湞
浊	濁
测	測
测出	測出
浍	澮
济	濟
济困	濟困
济恶	濟惡
浏	瀏
浑	渾
浑个	渾個
浑朴	渾樸
浒	滸
浓	濃
浓于	濃於
浓云	濃雲
浓发	濃髮
浓暗	濃暗
浓烟	濃煙
浓郁	濃郁
浔	潯
浥注	浥注
浩浩荡荡	浩浩蕩蕩
浩荡	浩蕩
浪板	浪板
浪游	浪遊
浪琴表	浪琴錶
浪荡	浪蕩
浮于	浮於
浮云	浮雲
浮借	浮借
浮出	浮出
浮台	浮臺
浮吊	浮吊
浮夸	浮誇
浮尸	浮屍
浮托	浮托
浮松	浮鬆
浮梁	浮樑
浮沈	浮沈
浮游	浮游
浮签	浮簽
浮荡	浮蕩
浮雕	浮雕
浮面	浮面
浴帘	浴簾
海上布雷	海上佈雷
海参	海參
海台	海臺
海干	海乾
海曲	海曲
海松	海松
海涂	海塗
海湾布雷	海灣佈雷
海表	海表
海谷	海谷
海里	海里
海面	海面
浸于	浸於
浸制	浸製
浸种	浸種
涂	塗
涂上	塗上
涂乙	塗乙
涂写	塗寫
涂到	塗到
涂刷	塗刷
涂去	塗去
涂善妮	涂善妮
涂在	塗在
涂地	塗地
涂坤	涂坤
涂壮勋	涂壯勳
涂壯勳	涂壯勳
涂天相	涂天相
涂好	塗好
涂姓	涂姓
涂层	塗層
涂山	塗山
涂布	塗布
涂序瑄	涂序瑄
涂成	塗成
涂抹	塗抹
涂掉	塗掉
涂改	塗改
涂敏恆	涂敏恆
涂敏恒	涂敏恆
涂料	塗料
涂月	涂月
涂有	塗有
涂油	塗油
涂泽	塗澤
涂泽民	涂澤民
涂涂	塗塗
涂消	塗消
涂满	塗滿
涂漆	塗漆
涂潦	塗潦
涂潭	塗潭
涂澤民	涂澤民
涂炭	塗炭
涂着	塗着
涂窜	塗竄
涂粉	塗粉
涂绍煃	涂紹煃
涂羽卿	涂羽卿
涂胶	塗膠
涂色	塗色
涂药	塗藥
涂謹申	涂謹申
涂说	塗說
涂谨申	涂謹申
涂过	塗過
涂逢年	涂逢年
涂醒哲	涂醒哲
涂金	塗金
涂销	塗銷
涂長望	涂長望
涂长望	涂長望
涂附	塗附
涂饰	塗飾
涂鴻欽	涂鴻欽
涂鸦	塗鴉
涂鸭	塗鴨
涂鸿钦	涂鴻欽
涂黑	塗黑
涅面	涅面
消了	消了
消折	消折
消极	消極
消沈	消沈
消炎药	消炎藥
消肿药	消腫藥
涉历	涉歷
涌上	涌上
涌入	涌入
涌出	涌出
涌向	涌向
涌来	涌來
涌泉	涌泉
涌现	涌現
涌起	涌起
涌进	涌進
涛	濤
涝	澇
涞	淶
涟	漣
涠	潿
涡	渦
涡虫	渦蟲
涣	渙
涤	滌
涤尽	滌盡
涤荡	滌盪
涤面	滌面
润	潤
涧	澗
涨	漲
涨了	漲了
涨价	漲價
涨出	漲出
涨回	漲回
涩	澀
液晶表	液晶錶
涳蒙	涳濛
涸干	涸乾
淀乃不耕之地	澱乃不耕之地
淀北片	澱北片
淀山	澱山
淀淀	澱澱
淀积	澱積
淀粉	澱粉
淀解物	澱解物
淀谓之滓	澱謂之滓
淋余土	淋餘土
淋冲	淋沖
淋漓	淋漓
淑范	淑範
淑郁	淑郁
淡于	淡於
淡出	淡出
淡彩	淡彩
淡朱	淡朱
淡蒙蒙	淡濛濛
淨价	淨價
淨发	淨髮
淨尽	淨盡
淨面	淨面
淫欲	淫慾
淫游	淫遊
淫荡	淫蕩
淬炼	淬鍊
淬链	淬鍊
深于	深於
深仇	深仇
深山何处钟	深山何處鐘
深恶	深惡
深暗	深暗
深沈	深沈
深渊里	深淵裏
深秋	深秋
深获	深獲
深表	深表
深谷	深谷
淳于	淳于
淳朴	淳樸
混了	混了
混出	混出
混合	混合
混同	混同
混炼	混煉
混虫	混蟲
添个	添個
添了	添了
清了	清了
清修	清修
清党	清黨
清出	清出
清发	清發
清汤挂面	清湯掛麵
渊	淵
渊淳岳峙	淵淳嶽峙
渊谷	淵谷
渌	淥
渍	漬
渎	瀆
渐	漸
渐升	漸升
渐暗	漸暗
渑	澠
渔	漁
渔娘	漁娘
渔梁	漁梁
渔获	漁獲
渖	瀋
渗	滲
渗出	滲出
渠冲	渠衝
渡了	渡了
温	溫
温克	溫克
温卷	溫卷
港制	港製
港台	港臺
渴了	渴了
渴欲	渴欲
游上	游上
游下	游下
游丝	遊絲
游乐	遊樂
游乡	遊鄉
游了	遊了
游人	遊人
游仙	遊仙
游仪	游儀
游伴	遊伴
游侠	遊俠
游兴	遊興
游冶	遊冶
游击	游擊
游刃有余	遊刃有餘
游动	遊動
游勇	游勇
游历	遊歷
游去	游去
游回	游回
游园	遊園
游士	游士
游奕	游奕
游女	游女
游子	遊子
游学	遊學
游客	遊客
游宦	遊宦
游尘	游塵
游尺	遊尺
游履	游履
游山玩水	遊山玩水
游幕	遊幕
游庠	遊庠
游廊	遊廊
游开	游開
游弋	游弋
游徼	游徼
游必有方	遊必有方
游惰	遊惰
游憩	遊憩
游戏	遊戲
游手	游手
游手好闲	遊手好閒
游扬	游揚
游方	遊方
游日	游日
游旧	游舊
游星	遊星
游来	游來
游标	游標
游标卡尺	遊標卡尺
游民	遊民
游气	遊氣
游水	游水
游河	遊河
游泮	游泮
游泳	游泳
游湖	遊湖
游牧	游牧
游猎	遊獵
游玩	遊玩
游畋	遊畋
游目	遊目
游目骋怀	遊目騁懷
游离	遊離
游移	游移
游程	遊程
游耕	游耕
游船	遊船
游艇	遊艇
游艺	遊藝
游荡	遊蕩
游荡不归	遊蕩不歸
游行	遊行
游衍	游衍
游街	遊街
游观	遊觀
游览	遊覽
游言	游言
游记	遊記
游说	遊說
游谈	游談
游豫	遊豫
游资	遊資
游赏	遊賞
游走	遊走
游踪	遊蹤
游辞	游辭
游过	游過
游进	游進
游逛	遊逛
游错	遊錯
游食	遊食
游骑	遊騎
游骑兵	遊騎兵
游魂	遊魂
游龙	游龍
湖里	湖裏
湖面	湖面
湘帘	湘簾
湘累	湘累
湘绣	湘繡
湟潦生苹	湟潦生苹
湮郁	湮鬱
湾	灣
湿	濕
溃	潰
溃于	潰於
溅	濺
溅了	濺了
溆	漵
源于	源於
溜个	溜個
溜了	溜了
溜出	溜出
溜回	溜回
溜须	溜鬚
溟蒙	溟濛
溢于	溢於
溢价	溢價
溢出	溢出
溢恶	溢惡
溪谷	溪谷
溯游	溯游
溲面	溲麵
溶于	溶於
溶合	溶合
溶岩	溶岩
溺于	溺於
溺志	溺志
溺谷	溺谷
滃郁	滃鬱
滑了	滑了
滑借	滑藉
滑出	滑出
滑杆	滑桿
滑板	滑板
滔荡	滔蕩
滗	潷
滚	滾
滚了	滾了
滚出	滾出
滚回	滾回
滞	滯
滞后	滯後
滠	灄
满	滿
满了	滿了
满于	滿於
满出	滿出
满头洋发	滿頭洋髮
满布	滿布
满拼自尽	滿拚自盡
满面	滿面
滢	瀅
滤	濾
滤出	濾出
滥	濫
滥发	濫發
滦	灤
滨	濱
滩	灘
滩涂	灘涂
滴了	滴了
滴出	滴出
滴向	滴向
滴苏	滴蘇
滴虫	滴蟲
漂了	漂了
漂向	漂向
漂布	漂布
漂摆	漂擺
漂荡	漂盪
漆了	漆了
漆出	漆出
漆布	漆布
漏了	漏了
漏借	漏借
漏出	漏出
漏尽	漏盡
漏斗	漏斗
漏针	漏針
漓水	灕水
漓江	灕江
漓湘	灕湘
漓然	灕然
演个	演個
演出	演出
漕挽	漕輓
漤	灠
漫出	漫出
漫卷	漫卷
漫布	漫布
漫录	漫錄
漫游	漫遊
潆	瀠
潇	瀟
潇洒	瀟洒
潋	瀲
潍	濰
潘谷	潘谷
潜	潛
潜了	潛了
潜修	潛修
潜出	潛出
潜回	潛回
潜意识里	潛意識裏
潜水表	潛水錶
潜水钟	潛水鐘
潟卤	潟鹵
潭里	潭裏
潮涌	潮涌
潮烟	潮菸
潴	瀦
澒蒙	澒濛
澜	瀾
澥谷	澥谷
澹台	澹臺
澹彩	澹彩
澹荡	澹盪
激于	激於
激出	激出
激发	激發
激荡	激盪
濑	瀨
濒	瀕
濒于	瀕於
濠梁	濠梁
瀑布	瀑布
瀛台	瀛臺
瀛表	瀛表
灌个	灌個
灌了	灌了
灌于	灌於
灌出	灌出
灌向	灌向
灌回	灌回
灌录	灌錄
灌注	灌注
灌药	灌藥
灏	灝
火了	火了
火云	火雲
火并	火併
火拼	火拚
火斗	火斗
火烟	火煙
火症	火症
火种	火種
火签	火籤
火箭布雷	火箭佈雷
火药	火藥
灭	滅
灭尸	滅屍
灭尽	滅盡
灭种	滅種
灯	燈
灯台	燈臺
灯彩	燈綵
灯杆	燈杆
灰暗	灰暗
灰蒙	灰濛
灰蒙蒙	灰濛濛
灵	靈
灵修	靈脩
灵台	靈臺
灵坛	靈壇
灵药	靈藥
灸术	灸術
灾	災
灿	燦
炀	煬
炆面	炆麵
炉	爐
炉台	爐臺
炊烟	炊煙
炎症	炎症
炒面	炒麵
炖	燉
炖了	燉了
炖药	燉藥
炜	煒
炝	熗
炮制	炮製
炮台	炮臺
炮炼	炮煉
炸出	炸出
炸药	炸藥
炸酱面	炸醬麵
点	點
点个	點個
点了	點了
点出	點出
点半钟	點半鐘
点发	點發
点回	點回
点多钟	點多鐘
点扎	點扎
点烟	點菸
点里	點裏
点钟	點鐘
点饥	點飢
炼	煉
炼丹	煉丹
炼乳	煉乳
炼冶	鍊冶
炼制	煉製
炼句	鍊句
炼字	鍊字
炼山	煉山
炼师	鍊師
炼度	鍊度
炼形	鍊形
炼气	鍊氣
炼汞	鍊汞
炼油	煉油
炼焦	煉焦
炼狱	煉獄
炼石	煉石
炼糖	煉糖
炼药	煉藥
炼贫	鍊貧
炼金	煉金
炼金术	鍊金術
炼钢	鍊鋼
炼铁	煉鐵
炼铜	煉銅
炼铝	煉鋁
炽	熾
烁	爍
烂	爛
烂游	爛遊
烃	烴
烘了	烘了
烘制	烘製
烘干	烘乾
烘托	烘托
烘板	烘板
烘熏	烘燻
烛	燭
烛台	燭臺
烛穗	燭穗
烝尝	烝嘗
烟	煙
烟丝	菸絲
烟供	煙供
烟具	煙具
烟农	菸農
烟卷	菸捲
烟台	煙臺
烟叶	菸葉
烟味	煙味
烟商	煙商
烟嘴	煙嘴
烟囱	煙囪
烟土	煙土
烟头	菸頭
烟子	煙子
烟客	煙客
烟害	菸害
烟尘	煙塵
烟岚	煙嵐
烟岸	煙岸
烟幕	煙幕
烟户	煙戶
烟斗	菸斗
烟景	煙景
烟月	煙月
烟机	煙機
烟杆	煙桿
烟枪	煙槍
烟柱	煙柱
烟树	煙樹
烟毒	煙毒
烟油	煙油
烟泡	煙泡
烟波	煙波
烟海	煙海
烟渚	煙渚
烟火	煙火
烟灯	煙燈
烟灰	菸灰
烟煤	煙煤
烟煴	煙熅
烟熏	煙燻
烟爨	煙爨
烟瘴	煙瘴
烟瘾	煙癮
烟盒	煙盒
烟碱	菸鹼
烟禁	菸禁
烟穗	煙穗
烟突	煙突
烟窝	煙窩
烟筒	煙筒
烟管	煙管
烟篷	煙篷
烟粉	煙粉
烟缕	煙縷
烟缸	菸缸
烟膏	煙膏
烟臭	煙臭
烟花	煙花
烟苗	煙苗
烟草	菸草
烟蒂	菸蒂
烟蚜	菸蚜
烟袋	菸袋
烟酒	菸酒
烟锅	煙鍋
烟雨	煙雨
烟雾	煙霧
烟霏	煙霏
烟霭	煙靄
烟馆	煙館
烟鬟	煙鬟
烟鬼	煙鬼
烤个	烤個
烤了	烤了
烤干	烤乾
烤晒	烤曬
烤烟	烤煙
烦	煩
烦了	煩了
烦复	煩複
烧	燒
烧了	燒了
烧出	燒出
烧尽	燒盡
烧干	燒乾
烧录	燒錄
烧炼	燒煉
烨	燁
烩	燴
烫	燙
烫一个发	燙一個髮
烫一次发	燙一次髮
烫个	燙個
烫个发	燙個髮
烫出	燙出
烫发	燙髮
烫完发	燙完髮
烫次发	燙次髮
烫蜡	燙蠟
烫面	燙麵
烬	燼
烬余	燼餘
热	熱
热合	熱合
热症	熱症
热药	熱藥
烽烟	烽煙
焊了	焊了
焊出	焊出
焕	煥
焕别	煥別
焕发	煥發
焖	燜
焘	燾
焙干	焙乾
焚修	焚修
焚尸	焚屍
無言不仇	無言不讎
焦了	焦了
焦获	焦穫
焰彩	焰彩
然后	然後
煎个	煎個
煎了	煎了
煎出	煎出
煎药	煎藥
煎面	煎麵
煤烟	煤煙
煤系	煤系
照个	照個
照了	照了
照价	照價
照入签	照入籤
照准	照準
照出	照出
照占	照佔
照发	照發
照台	照臺
照录	照錄
照签	照簽
照表	照表
照面	照面
煨干	煨乾
煮个	煮個
煮出	煮出
煮面	煮麵
煴斗	熅斗
熄了	熄了
熏习	熏習
熏人	熏人
熏制	熏製
熏天	熏天
熏染	熏染
熏沐	熏沐
熏烝	熏烝
熏熏	熏熏
熏笼	熏籠
熏肉	燻肉
熏腐	熏腐
熏草	燻草
熏蒸	熏蒸
熏赫	燻赫
熏鑪	熏鑪
熏陶	熏陶
熏风	熏風
熏香	熏香
熏黑	燻黑
熔于	熔於
熔合	熔合
熔岩	熔岩
熔炼	熔煉
熟了	熟了
熟药	熟藥
熨斗	熨斗
熬出	熬出
熬炼	熬煉
熬药	熬藥
燎发	燎髮
燔针	燔針
燕几	燕几
燕台	燕臺
燕游	燕遊
爆出	爆出
爆发	爆發
爬出	爬出
爬升	爬升
爬虫	爬蟲
爰定祥历	爰定祥厤
爱	愛
爱了	愛了
爱困	愛睏
爱幸	愛幸
爱才	愛才
爲了	爲了
爲幸	爲幸
爲恶	爲惡
爵仇	爵仇
父党	父黨
父台	父臺
父系	父系
爷	爺
爷娘	爺孃
爹娘	爹孃
爽荡	爽蕩
片价	片價
片岩	片岩
片言只语	片言隻語
片面	片面
版筑	版築
版面	版面
牉合	牉合
牌价	牌價
牌板	牌板
牌面	牌面
牍	牘
牒发	牒發
牖里	牖里
牙板	牙板
牙签	牙籤
牙虫	牙蟲
牙雕	牙雕
牛只	牛隻
牛后	牛後
牛肉面	牛肉麵
牛舍	牛舍
牦	氂
物价	物價
物欲	物慾
物种	物種
牵	牽
牵一发	牽一髮
牵了	牽了
牵出	牽出
牵制	牽制
牵合	牽合
牵回	牽回
牵彩	牽彩
牵挂	牽掛
牵系	牽繫
特于	特於
特价	特價
特准	特准
特出	特出
特别	特別
特别致	特别致
特制	特製
特征	特徵
特效药	特效藥
特种	特種
特里	特里
牺	犧
犁板	犁板
犊	犢
犯了	犯了
犯台	犯臺
犯奸	犯奸
犯恶	犯惡
犵党	犵黨
状	狀
犷	獷
犹	猶
犹如表	猶如錶
犹如钟	猶如鐘
狂占	狂佔
狂并潮	狂併潮
狂搜	狂搜
狂荡	狂蕩
狂药	狂藥
狃于	狃於
狈	狽
狎游	狎遊
狐借虎威	狐藉虎威
狗才	狗才
狞	獰
狞恶	獰惡
狠了	狠了
狠恶	狠惡
独	獨
独占	獨佔
独当	獨當
独曲	獨曲
独辟蹊径	獨闢蹊徑
狭	狹
狭谷	狹谷
狮	獅
狮坛	獅壇
狯	獪
狰	猙
狱	獄
狱里	獄裏
狲	猻
狼仆	狼僕
狼借	狼藉
狼烟	狼煙
猃	獫
猎	獵
猎了	獵了
猎获	獵獲
猕	獼
猛于	猛於
猛冲	猛衝
猛升	猛升
猛药	猛藥
猜出	猜出
猝发	猝發
猡	玀
猪	豬
猪只	豬隻
猪舍	豬舍
猫	貓
猬	蝟
献	獻
献丑	獻醜
献了	獻了
献出	獻出
献台	獻臺
獑胡	獑胡
獠面	獠面
獭	獺
玄了	玄了
玄云	玄雲
玄冬	玄冬
玄制	玄製
玄参	玄蔘
玄针	玄鍼
率同	率同
率团	率團
玉历	玉曆
玉台	玉臺
玉帘	玉簾
玉斗	玉斗
玉纤	玉纖
玉虫	玉蟲
玉里	玉里
玉雕	玉雕
玉面	玉面
王余鱼	王餘魚
王侯后	王侯后
王制	王制
王台	王臺
王后	王后
王庄	王莊
王蒙	王蒙
王鉴	王鑑
玑	璣
玛	瑪
玢岩	玢岩
玩了	玩了
玩出	玩出
玮	瑋
环	環
环游	環遊
环面	環面
现	現
现于	現於
现出	現出
玳梁	玳梁
玺	璽
珂里	珂里
珍肴异馔	珍肴異饌
珐	琺
珑	瓏
珠帘	珠簾
班别	班別
班游	班遊
班里	班裏
珲	琿
球台	球檯
球坛	球壇
球杆	球杆
球面	球面
理一个发	理一個髮
理一次发	理一次髮
理个	理個
理个发	理個髮
理了	理了
理出	理出
理发	理髮
理合	理合
理完发	理完髮
理当	理當
理次发	理次髮
理致	理致
琏	璉
琐	瑣
琐才	瑣才
琛板	琛板
琴杆	琴桿
琴钟	琴鐘
琼	瓊
瑞云	瑞雲
瑞征	瑞徵
瑞穗	瑞穗
瑞签	瑞簽
瑶	瑤
瑶台	瑤臺
瑶签	瑤籤
瑷	璦
璅虫	璅蟲
璎	瓔
璧合	璧合
璧回	璧回
瓒	瓚
瓠叶	瓠葉
瓢虫	瓢蟲
瓦合	瓦合
瓦当	瓦當
瓦松	瓦松
瓦舍	瓦舍
瓮安	甕安
瓯	甌
甄别	甄別
甄后	甄后
甘于	甘於
甘当	甘當
甘愿	甘願
甚么	甚麼
甚于	甚於
甚获	甚獲
甜水面	甜水麵
甜面酱	甜麵醬
生个	生個
生了	生了
生于	生於
生出	生出
生力面	生力麵
生发	生髮
生姜	生薑
生布	生布
生物钟	生物鐘
生药	生藥
生锈	生鏽
生面	生面
用于	用於
用尽	用盡
用搜	用搜
用汇	用匯
用药	用藥
甩出	甩出
甩发	甩髮
甪里	甪里
田庄	田莊
田舍	田舍
田谷	田穀
田里	田裏
由于	由於
由余	由余
由表及里	由表及裏
甲板	甲板
甲种	甲種
甲虫	甲蟲
申复	申覆
电	電
电价	電價
电冲	電衝
电厂	電廠
电台	電臺
电复	電覆
电子表	電子錶
电子钟	電子鐘
电杆	電杆
电板	電板
电极	電極
电汇	電匯
电线杆	電綫杆
电表	電錶
电针	電針
电钟	電鐘
男仆	男僕
男佣	男傭
男尸	男屍
男用表	男用錶
男系	男系
甸后	甸後
画	畫
画了	畫了
画出	畫出
画卷	畫卷
画坛	畫壇
画布	畫布
画板	畫板
画着	畫着
画表	畫表
画面	畫面
畅	暢
畅游	暢遊
界面	界面
畏于	畏於
留个	留個
留了	留了
留别	留別
留发	留髮
留后	留後
留种	留種
畚斗	畚斗
略同	略同
略胜	略勝
畴	疇
疏于	疏於
疏松	疏鬆
疑云	疑雲
疑凶	疑兇
疑团	疑團
疑系	疑係
疖	癤
疗	療
疗饥	療飢
疟	瘧
疟虫	瘧蟲
疠	癘
疡	瘍
疥虫	疥蟲
疬	癧
疮	瘡
疯	瘋
疯了	瘋了
疱	皰
疲于	疲於
疲困	疲睏
疴	痾
疾恶	疾惡
病了	病了
病余	病餘
病出	病出
病历	病歷
病发	病發
病后	病後
病征	病徵
病愈	病癒
病症	病症
病舍	病舍
病虫	病蟲
症候	症候
症状	症狀
症结	癥結
痈	癰
痉	痙
痊愈	痊癒
痒	癢
痒了	癢了
痒疹	痒疹
痒痒	痒痒
痕迹	痕蹟
痛了	痛了
痛恶	痛惡
痛赞	痛贊
痨	癆
痨虫	癆蟲
痪	瘓
痫	癇
痫症	癇症
痰症	痰症
痴虫	痴蟲
瘅	癉
瘗	瘞
瘘	瘻
瘦了	瘦了
瘪	癟
瘫	癱
瘾	癮
瘿	癭
癌症	癌症
癒合	癒合
癞	癩
癣	癬
癫	癲
癸丑	癸丑
登个	登個
登了	登了
登出	登出
登台	登臺
登坛	登壇
登录	登錄
登极	登極
發表	發表
白云	白雲
白兔擣药	白兔擣藥
白净面皮	白淨面皮
白卷	白卷
白发	白髮
白团	白團
白布	白布
白干	白乾 白幹
白当	白當
白术	白朮
白朴	白樸
白松	白松
白板	白板
白烟	白煙
白种	白種
白粉面	白粉麵
白胡	白鬍
白苏	白蘇
白苹	白蘋
白药	白藥
白蜡	白蠟
白里透红	白裏透紅
白霉	白黴
白面	白麵
百万	百萬
百个	百個
百余	百餘
百出	百出
百划	百劃
百发	百發
百只	百隻
百叶	百葉
百合	百合
百当	百當
百扎	百紮
百拙千丑	百拙千醜
百炼	百鍊
百科里	百科裏
百花历	百花曆
百药之长	百藥之長
百谷	百穀
百辟	百辟
百里	百里
的克制	的剋制
的历	的歷
的当	的當
的确	的確
的钟	的鐘
的钟表	的鐘錶
皆准	皆準
皆可作淀	皆可作澱
皇历	皇曆
皇后	皇后
皇庄	皇莊
皇极	皇極
皇极历	皇極曆
皇辟	皇辟
皑	皚
皓发	皓髮
皙面	皙面
皮制	皮製
皮松	皮鬆
皮里春秋	皮裏春秋
皮里阳秋	皮裏陽秋
皮雕	皮雕
皮面	皮面
皱	皺
皱别	皺彆
皱折	皺摺
皲	皸
盆吊	盆吊
盈余	盈餘
益于	益於
益发	益發
益虫	益蟲
盏	盞
盐	鹽
盐余	鹽餘
盐卤	鹽滷
盐打怎么咸	鹽打怎麼鹹
监	監
监修	監修
监制	監製
监系	監繫
盒里	盒裏
盖	蓋
盖了	蓋了
盖于	蓋於
盖板	蓋板
盗	盜
盗录	盜錄
盗采	盜採
盗钟	盜鐘
盘	盤
盘回	盤迴
盘据	盤據
盘曲	盤曲
盘术	盤術
盘松	盤松
盘游	盤遊
盘获	盤獲
盘谷	盤谷
盘里	盤裏
盘面	盤面
盛了	盛了
盛价	盛价
盛冬	盛冬
盛赞	盛讚
目录	目錄
盲干	盲幹
直了	直了
直于	直於
直冲	直衝
直升	直升
直发	直髮
直接参与	直接參与
直摆	直襬
直杆	直杆
直系	直系
直致	直致
直链	直鏈
直须	直須
相于	相於
相克	相剋
相冲	相衝
相别	相別
相台	相臺
相合	相合
相同	相同
相向	相向
相干	相干
相并	相併
相当	相當
相托	相托
相斗	相鬭
相术	相術
相里	相里
相面	相面
盼了	盼了
盾板	盾板
省个	省個
省了	省了
省出	省出
眉里	眉裏
眉面	眉面
看下表	看下錶
看下钟	看下鐘
看了	看了
看准	看準
看出	看出
看台	看臺
看向	看向
看板	看板
看着表	看着錶
看着钟	看着鐘
看着钟表	看着鐘錶
看表	看錶
看钟	看鐘
真个	真個
真凶	真兇
真确	真確
眠云	眠雲
眦	眥
眷注	眷注
眷舍	眷舍
眺台	眺臺
眼同	眼同
眼帘	眼簾
眼干	眼乾
眼眶里	眼眶裏
眼睛里	眼睛裏
眼药	眼藥
眼虫	眼蟲
眼里	眼裏
着儿	着兒
着克制	着剋制
着色软体	着色軟體
着重指出	着重指出
睁	睜
睐	睞
睑	瞼
睡个	睡個
睡了	睡了
睡游病	睡遊病
睡着了	睡着了
睽合	睽合
瞄了	瞄了
瞄准	瞄準
瞄出	瞄出
瞅下表	瞅下錶
瞅下钟	瞅下鐘
瞇了	瞇了
瞎了	瞎了
瞒	瞞
瞒了	瞞了
瞒哄	瞞哄
瞧了	瞧了
瞧出	瞧出
瞧着表	瞧着錶
瞧着钟	瞧着鐘
瞧着钟表	瞧着鐘錶
瞩	矚
瞩托	矚託
瞪了	瞪了
瞳蒙	瞳矇
矜夸	矜誇
矜庄	矜莊
矞云	矞雲
矢志	矢志
知了	知了
矫	矯
矫制	矯制
短了	短了
短于	短於
短价	短價
短几	短几
短发	短髮
短后	短後
短幸	短幸
短折	短折
短针	短針
矮个	矮個
矮了	矮了
矮几	矮几
石几	石几
石台	石臺
石坛	石壇
石松	石松
石板	石板
石柜	石櫃
石梁	石樑
石英表	石英錶
石英钟	石英鐘
石莼	石蓴
石蜡	石蠟
石针	石針
石钟乳	石鐘乳
石雕	石雕
矶	磯
矽岩	矽岩
矽谷	矽谷
矾	礬
矿	礦
砀	碭
码	碼
码表	碼錶 碼表
砂岩	砂岩
砂布	砂布
砌合	砌合
砍了	砍了
砍出	砍出
砍向	砍向
研修	研修
研制	研製
研发	研發
砖	磚
砖厂	磚廠
砖雕	磚雕
砖面	磚面
砗	硨
砚	硯
砚台	硯臺
砥据	砥據
砧板	砧板
砭针	砭鍼
砰当	砰噹
砲台	砲臺
破价	破價
破布	破布
破获	破獲
破表	破錶
破面	破面
砸了	砸了
砺	礪
砻	礱
砻谷机	礱穀機
砾	礫
砾岩	礫岩
础	礎
硅谷	硅谷
硕	碩
硖	硤
硗	磽
硗确	磽确
硝烟	硝煙
硬了	硬了
硬干	硬幹
硬彩	硬彩
硬面	硬麵
确	確
确乎	確乎
确保	確保
确信	確信
确凿	確鑿
确切	確切
确定	確定
确实	確實
确当	確當
确是	確是
确有	確有
确瘠	确瘠
确知	確知
确立	確立
确认	確認
确论	確論
确证	確證
确非	確非
碍	礙
碍于	礙於
碎布	碎布
碑坛	碑壇
碑志	碑誌
碑面	碑面
碗柜	碗櫃
碛	磧
碛卤	磧鹵
碜	磣
碧云	碧雲
碰了	碰了
碰钟	碰鐘
碰面	碰面
碱	鹼
磁制	磁製
磁极	磁極
磁针	磁針
磨了	磨了
磨出	磨出
磨制	磨製
磨合	磨合
磨折	磨折
磨炼	磨鍊
磨链	磨鍊
磬折	磬折
磬钟	磬鐘
礁岩	礁岩
示复	示覆
示范	示範
礼	禮
礼制	禮制
礼台	禮臺
礼斗	禮斗
礼赞	禮讚
社党	社黨
社团	社團
社里	社裏
祈愿	祈願
祝厘	祝釐
祝发	祝髮
祝愿	祝願
祝赞	祝讚
神台	神臺
神坛	神壇
神志	神志
神曲	神曲
神术	神術
神游	神遊
神采	神采
神雕	神鵰
祢	禰
祥云	祥雲
票价	票價
票庄	票莊
票据	票據
票汇	票匯
票面	票面
祭了	祭了
祭出	祭出
祭台	祭臺
祭吊	祭弔
祭坛	祭壇
祭尸	祭尸
祯	禎
祷	禱
祸	禍
祸于	禍於
祸种	禍種
禀	稟
禀复	稟覆
禁制	禁制
禁当	禁當
禁欲	禁慾
禁烟	禁菸
禁药	禁藥
禄	祿
禅	禪
福舍	福舍
禺谷	禺谷
离	離
离了	離了
离于	離於
离别	離別
离合	離合
禽舍	禽舍
禾虫	禾蟲
禾谷	禾穀
秀出	秀出
秀发	秀髮
秀才	秀才
私下里	私下裏
私了	私了
私仇	私仇
私党	私黨
私斗	私鬭
私曲	私曲
私欲	私慾
秃	禿
秃发	禿髮
秃妃之发	禿妃之髮
秆	稈
秉鉴	秉鑒
秋事	秋事
秋令	秋令
秋假里	秋假裏
秋决	秋決
秋凉	秋涼
秋分	秋分
秋千	鞦韆
秋发	秋髮
秋叶	秋葉
秋后	秋後
秋场	秋場
秋士	秋士
秋声	秋聲
秋天	秋天
秋天里	秋天裏
秋娘	秋娘
秋季	秋季
秋官	秋官
秋审	秋審
秋山	秋山
秋思	秋思
秋意	秋意
秋成	秋成
秋扇	秋扇
秋播	秋播
秋收	秋收
秋方	秋方
秋日	秋日
秋日里	秋日裏
秋旱	秋旱
秋景	秋景
秋期	秋期
秋榜	秋榜
秋毫	秋毫
秋气	秋氣
秋水	秋水
秋汛	秋汛
秋河	秋河
秋波	秋波
秋游	秋遊
秋瑾	秋瑾
秋田	秋田
秋眉	秋眉
秋石	秋石
秋社	秋社
秋禊	秋禊
秋耕	秋耕
秋胡	秋胡
秋色	秋色
秋节	秋節
秋茶	秋茶
秋草	秋草
秋荼	秋荼
秋虫	秋蟲
秋蝉	秋蟬
秋裤	秋褲
秋试	秋試
秋闱	秋闈
秋阳	秋陽
秋阴入井干	秋陰入井幹
秋雨	秋雨
秋霖	秋霖
秋霜	秋霜
秋颜	秋顏
秋风	秋風
秋香	秋香
秋麻	秋麻
种	種
种上	種上
种下	種下
种人	種人
种仁	種仁
种切	種切
种别	種別
种到	種到
种名	種名
种因	種因
种地	種地
种姓	種姓
种子	種子
种差	種差
种师中	种師中
种师道	种師道
种得	種得
种德	種德
种性	種性
种户	種戶
种放	种放
种族	種族
种树	種樹
种植	種植
种牛	種牛
种猪	種豬
种玉	種玉
种生	種生
种田	種田
种畜	種畜
种痘	種痘
种的	種的
种皮	種皮
种祸	種禍
种种	種種
种稻	種稻
种类	種類
种籽	種籽
种群	種群
种肥	種肥
种花	種花
种菜	種菜
种蛋	種蛋
种谷	種穀
种豆	種豆
种起	種起
种过	種過
种马	種馬
种麻	種麻
科克	科克
科别	科別
科斗	科斗
科系	科系
科范	科範
秒表	秒錶
秒针	秒針
秒钟	秒鐘
秘录	祕錄
租价	租價
租借	租借
租出	租出
秤杆	秤桿
秧针	秧針
积	積
积云	積雲
积恶	積惡
积极	積極
积极参与	積极參与
积极参加	積极參加
积淀	積澱
积谷	積穀
积谷防饥	積穀防饑
积郁	積鬱
称	稱
称出	稱出
称制	稱制
称愿	稱願
称赞	稱讚
移出	移出
移向	移向
秽	穢
秾纤	穠纖
稀松	稀鬆
稆	穭
程朱	程朱
稍出	稍出
稍后	稍後
税	稅
税制	稅制
税种	稅種
稠云	稠雲
稣	穌
稳	穩
稳占	穩佔
稳当	穩當
稳扎	穩紮
稻种	稻種
稻穗	稻穗
稻谷	稻穀
稽征	稽徵
穆罕默德历	穆罕默德曆
穑	穡
穗儿	穗兒
穗子	穗子
穗帏飘井干	繐幃飄井幹
穗帐	繐帳
穗帷	繐帷
穗状	穗狀
穗肥	穗肥
穗裳	繐裳
穗轴	穗軸
穗选	穗選
穷	窮
穷于	窮於
穷冬	窮冬
穷发	窮髮
穷困	窮困
穷尽	窮盡
穷极	窮極
穷追不舍	窮追不捨
穷里	窮里
穹谷	穹谷
空个	空個
空中布雷	空中佈雷
空了	空了
空余	空餘
空出	空出
空投布雷	空投佈雷
空荡	空蕩
空荡荡	空蕩蕩
空蒙	空濛
空谷	空谷
空钟	空鐘
穿出	穿出
穿针	穿針
突出	突出
突升	突升
突发	突發
窃	竊
窃占	竊占
窃据	竊據
窃钟掩耳	竊鐘掩耳
窅娘	窅娘
窍	竅
窑	窯
窒欲	窒慾
窗台	窗臺
窗帘	窗簾
窗明几亮	窗明几亮
窗明几净	窗明几淨
窘困	窘困
窜	竄
窜出	竄出
窜升	竄升
窜游	竄遊
窝	窩
窝里	窩裏
窥	窺
窦	竇
窭	窶
立了	立了
立于	立於
立冬	立冬
立升	立升
立当	立當
立志	立志
立扎	立扎
立杆	立杆
立柜	立櫃
立秋	立秋
立范	立範
竖	豎
竖着	豎着
站个	站個
站了	站了
站出	站出
站台	站臺
站干岸儿	站乾岸兒
竞	競
竞价	競價
竞向	競向
竞斗	競鬭
竟于	竟於
竟须	竟須
章台	章臺
章回	章回
章表	章表
童仆	童僕
童蒙	童蒙
竭尽	竭盡
端了	端了
端出	端出
端庄	端莊
端面	端面
竹几	竹几
竹叶	竹葉
竹布	竹布
竹帘	竹簾
竹板	竹板
竹林之游	竹林之遊
竹签	竹籤
笃	篤
笃志	篤志
笆斗	笆斗
笋	筍
笋干	筍乾
笏板	笏板
笑个	笑個
笑了	笑了
笑出	笑出
笑里藏刀	笑裏藏刀
笑面	笑面
笔	筆
笔划	筆劃 筆畫
笔卷	筆捲
笔录	筆錄
笔据	筆據
笔杆	筆桿
笔秃墨干	筆禿墨乾
笔致	筆致
笕	筧
符合	符合
符采	符采
第几	第幾
笺	箋
笺注	箋註
笼	籠
笾	籩
等个	等個
等了	等了
等于	等於
等价	等價
等同	等同
筋斗	筋斗
筑	築
筑前	筑前
筑北	筑北
筑后	筑後
筑坛	築壇
筑城	築城
筑堤	築堤
筑墙	築牆
筑室	築室
筑屋	築屋
筑州	筑州
筑巢	築巢
筑後	筑後
筑成	築成
筑有	築有
筑栏	築欄
筑波	筑波
筑磕	築磕
筑紫	筑紫
筑肥	筑肥
筑西	筑西
筑起	築起
筑路	築路
筑邦	筑邦
筑阳	筑陽
筑陽	筑陽
答出	答出
答卷	答卷
答复	答覆
答覆	答覆
策划	策劃
筚	篳
筛	篩
筛板	篩板
筝	箏
筲斗	筲斗
筵几	筵几
筹	籌
筹划	籌劃
签	簽
签上	簽上
签下	簽下
签了	簽了
签些	簽些
签写	簽寫
签出	簽出
签到	簽到
签单	簽單
签印	簽印
签发	簽發
签名	簽名
签呈	簽呈
签在	簽在
签好	簽好
签妥	簽妥
签子	簽子
签字	簽字
签完	簽完
签定	簽定
签帐	簽帳
签幐	籤幐
签得	簽得
签押	籤押
签收	簽收
签有	簽有
签条	籤條
签注	簽注
签爲	簽爲
签着	簽着
签章	簽章
签约	簽約
签结	簽結
签署	簽署
签証	簽証
签订	簽訂
签证	簽證
签诗	籤詩
签赌	簽賭
签过	簽過
签退	簽退
简	簡
简别	簡別
简历	簡歷
简尸	簡屍
简并	簡併
简朴	簡樸
简板	簡板
箕斗	箕斗
算了	算了
算准	算準
算出	算出
算历	算曆
算发	算髮
算术	算術
箝制	箝制
管个	管個
管了	管了
管制	管制
管干	管幹
箦	簀
箧	篋
箨	籜
箩	籮
箪	簞
箫	簫
箭杆	箭桿
箭虫	箭蟲
箱帘	箱簾
篆烟	篆煙
篇卷	篇卷
篑	簣
篓	簍
篡党	篡黨
篮	籃
篮坛	籃壇
篮板	籃板
篱	籬
簇合	簇合
簖	籪
簸荡	簸盪
簿历	簿歷
簿录	簿錄
簿据	簿據
籁	籟
米价	米價
米制	米制
米虫	米蟲
米谷	米穀
籴	糴
类	類
类别	類別
类同	類同
籼	秈
粉彩	粉彩
粉拳绣腿	粉拳繡腿
粉板	粉板
粉签子	粉籤子
粉面	粉面
粗制	粗製
粗卤	粗鹵
粗布	粗布
粗恶	粗惡
粜	糶
粜出	糶出
粝	糲
粤	粵
粤曲	粵曲
粤胡	粵胡
粥厂	粥廠
粪	糞
粪秽蔑面	糞穢衊面
粮	糧
精于	精於
精准	精準
精制	精製
精干	精幹
精当	精當
精彩	精彩
精松	精鬆
精炼	精煉 精鍊
精确	精確
精致	精緻
精舍	精舍
精虫	精蟲
精辟	精闢
精采	精采
精链	精鍊
糁	糝
糅合	糅合
糇	餱
糊涂	糊塗
糊里糊涂	糊裏糊塗
糕干	糕乾
糖厂	糖廠
糟了	糟了
糠穗	糠穗
系上	繫上
系世	繫世
系为	係爲
系争	係爭
系于	繫於
系于一发	繫於一髮
系住	繫住
系刊	系刊
系列	系列
系列里	系列裏
系到	繫到
系务	系務
系命	繫命
系囚	繫囚
系孙	系孫
系心	繫心
系念	繫念
系怀	繫懷
系恋	繫戀
系所	系所
系数	係數
系族	系族
系爪	繫爪
系爲	係爲
系狱	繫獄
系璧	系璧
系着	系着
系系	繫系
系紧	繫緊
系累	繫累
系结	繫結
系统	系統
系绳	繫繩
系缚	繫縛
系腰	繫腰
系臂	係臂
系花	系花
系获	係獲
系裹	繫裹
系词	系詞
系谱	系譜
系趾	繫趾
系踵	係踵
系蹄	係蹄
系辞	繫辭
系里	系裏
系颈	繫頸
系风捕影	繫風捕影
系馆	系館
素借	素藉
素发	素髮
素志	素志
素愿	素願
素朴	素樸
素面	素麵 素面
索价	索價
索合	索合
索面	索麵
紧	緊
紧了	緊了
紧挨	緊挨
紧绷	緊繃
紧绷着	緊繃着
紧绷绷	緊繃繃
紧致	緊緻
紧追不舍	緊追不捨
紫云	紫雲
紫台	紫臺
紫姜	紫薑
紫苏	紫蘇
累了	累了
累囚	累囚
累堆	累堆
累瓦结绳	累瓦結繩
累绁	累紲
累臣	累臣
絷	縶
綑了	綑了
綑吊	綑吊
綑扎	綑紮
經有云	經有云
緝凶	緝兇
縻系	縻繫
繁台	繁臺
繁复	繁複
繁钟	繁鐘
繃价	繃價
繃针	繃針
纂修	纂修
纠	糾
纠合	糾合
纡	紆
纡余	紆餘
纡回	紆迴
纡曲	紆曲
纡郁	紆鬱
红	紅
红了	紅了
红云	紅雲
红发	紅髮
红叶	紅葉
红娘	紅娘
红岩	紅巖
红曲	紅曲
红松	紅松
红绳系足	紅繩繫足
红药	紅藥
红虫	紅蟲
红钟	紅鐘
纣	紂
纤	纖
纤丽	纖麗
纤云	纖雲
纤人	纖人
纤介	纖介
纤夫	縴夫
纤妍	纖妍
纤密	纖密
纤小	纖小
纤屑	纖屑
纤巧	纖巧
纤度	纖度
纤弱	纖弱
纤微	纖微
纤悉	纖悉
纤户	縴戶
纤手	纖手 縴手
纤指	纖指
纤柔	纖柔
纤毛	纖毛
纤毫	纖毫
纤玉	纖玉
纤画	纖畫
纤瘦	纖瘦
纤离	纖離
纤纤	纖纖
纤细	纖細
纤维	纖維
纤腰	纖腰
纤阿	纖阿
纥	紇
约	約
约克	約克
约占	約佔
约同	約同
约据	約據
级	級
级别	級別
纨	紈
纩	纊
纪	紀
纪历	紀曆
纪录	紀錄
纫	紉
纬	緯
纭	紜
纯	純
纯朴	純樸
纯种	純種
纰	紕
纱	紗
纱厂	紗廠
纱布	紗布
纲	綱
纲鉴	綱鑒
纳	納
纳合	納合
纳征	納徵
纳采	納采
纵	縱
纵出	縱出
纵向	縱向
纵欲	縱慾
纵谷	縱谷
纶	綸
纷	紛
纸	紙
纸扎	紙紮
纸板	紙板
纸烟	紙菸
纸雕	紙雕
纸面	紙面
纹	紋
纹板	紋板
纺	紡
纺纤	紡纖
纽	紐
纾	紓
纾困	紓困
线	綫
线虫	綫蟲
绀	紺
绁	紲
绂	紱
练	練
练个	練個
练了	練了
练出	練出
组	組
组党	組黨
组别	組別
组合	組合
组团	組團
组曲	組曲
组里	組裏
绅	紳
细	細
细不容发	細不容髮
细别	細別
细如发	細如髮
细娘	細娘
细布	細布
细曲	細曲
细术	細術
细炼	細鍊
细致	細緻
细表	細表
细链	細鍊
织	織
织出	織出
织布	織布
终	終
终了	終了
终于	終於
终制	終制
终曲	終曲
终极	終極
终须	終須
绉	縐
绉布	縐布
绊	絆
绋	紼
绌	絀
绍	紹
绎	繹
经	經
经制	經制
经卷	經卷
经历	經歷
经坛	經壇
经折	經摺
经曲	經曲
经有云	經有云
经术	經術
绐	紿
绑	綁
绑回	綁回
绑扎	綁紮
绒	絨
绒布	絨布
结	結
结了	結了
结仇	結仇
结伙	結夥
结伴同游	結伴同遊
结余	結餘
结党	結黨
结出	結出
结制	結制
结发	結髮
结合	結合
结彩	結綵
结扎	結紮
结托	結托
结汇	結匯
结采	結采
绕	繞
绕梁	繞樑
绗	絎
绘	繪
绘出	繪出
绘制	繪製
给	給
给于	給於
给价	給價
绚	絢
绛	絳
络	絡
络合	絡合
络腮胡	絡腮鬍
绝	絕
绝于	絕於
绝后	絕後
绝岩	絕巖
绝才	絕才
绝症	絕症
绝种	絕種
绞	絞
绞尽	絞盡
绞干	絞乾
绞面	絞面
统	統
统制	統制
统合	統合
统御	統御
绠	綆
绡	綃
绢	絹
绣	繡
绣像	繡像
绣口	繡口
绣帘	繡簾
绣得	繡得
绣户	繡戶
绣房	繡房
绣毯	繡毯
绣球	繡球
绣的	繡的
绣花	繡花
绣衣	繡衣
绣起	繡起
绣针	繡針
绣阁	繡閣
绣面	繡面
绣鞋	繡鞋
绥	綏
绦	絛
绦虫	絛蟲
继	繼
继志	繼志
绨	綈
绩	績
绪	緒
绪余	緒餘
绫	綾
续	續
续借	續借
续后	續後
绮	綺
绮云	綺雲
绯	緋
绰	綽
绰板	綽板
绲	緄
绳	繩
维	維
维修	維修
维斗	維斗
维系	維繫
绵	綿
绵历	綿歷
绶	綬
绷住	繃住
绷子	繃子
绷带	繃帶
绷开	繃開
绷扒吊拷	繃扒弔拷
绷着	繃着
绷紧	繃緊
绷脸	繃臉
绸	綢
绸布	綢布
绸缎庄	綢緞莊
绺	綹
绻	綣
综	綜
综合	綜合
绽	綻
绾	綰
绾发	綰髮
绿	綠
绿云	綠雲
绿党	綠黨
绿发	綠髮
绿叶	綠葉
绿蜡	綠蠟
缀	綴
缀出	綴出
缀合	綴合
缁	緇
缂	緙
缃	緗
缄	緘
缅	緬
缆	纜
缇	緹
缈	緲
缉	緝
缉凶	緝兇
缉获	緝獲
缋	繢
缌	緦
缍	綞
缎	緞
缏	緶
缑	緱
缒	縋
缓	緩
缓了	緩了
缓冲	緩衝
缓征	緩徵
缔	締
缕	縷
缕当	縷當
编	編
编个	編個
编了	編了
编余	編余
编修	編修
编出	編出
编制	編製
编发	編髮
编录	編錄
编曲	編曲
编采	編採
编钟	編鐘
缗	緡
缘	緣
缙	縉
缚	縛
缛	縟
缜	縝
缜致	縝緻
缝	縫
缝个	縫個
缝了	縫了
缝制	縫製
缝合	縫合
缝里	縫裏
缝针	縫針
缟	縞
缠	纏
缠回	纏回
缠斗	纏鬭
缡	縭
缢	縊
缣	縑
缤	繽
缥	縹
缥致	縹致
缦	縵
缦胡	縵胡
缧	縲
缨	纓
缩	縮
缩合	縮合
缩回	縮回
缩栗	縮慄
缪	繆
缫	繅
缬	纈
缭	繚
缮	繕
缮修	繕修
缯	繒
缰	繮
缱	繾
缲	繰
缳	繯
缴	繳
缴出	繳出
缴卷	繳卷
缴回	繳回
缴获	繳獲
缵	纘
罂	罌
罄尽	罄盡
网	網
网志	網誌
网里	網裏
罔极	罔極
罗	羅
罗布	羅布
罗柜	羅櫃
罗致	羅致
罚	罰
罚个	罰個
罚了	罰了
罚出	罰出
罢	罷
罢了	罷了
罢于	罷於
罪恶	罪惡
置于	置於
置言成范	置言成範
罴	羆
羁	羈
羁系	羈繫
羊卜	羊卜
羊舍	羊舍
羌胡	羌胡
美丑	美醜
美于	美於
美仑	美崙
美制	美製
美占	美佔
美发	美髮
美恶	美惡
美才	美才
美术	美術
美苏	美蘇
羑里	羑里
羞于	羞於
羞恶	羞惡
羟	羥
羡	羨
羡余	羨餘
群丑	群醜
群后	群后
群系	群系
群辟	群辟
群雕	群雕
羽虫	羽蟲
翊赞	翊贊
翕辟	翕闢
翘	翹
翘了	翹了
翘出	翹出
翦彩	翦綵
翱游	翱遊
翻个	翻個
翻了	翻了
翻修	翻修
翻出	翻出
翻台	翻檯
翻复	翻覆
翻录	翻錄
翻松	翻鬆
翻涌	翻涌
翻面	翻面
老个	老個
老了	老了
老于	老於
老仆	老僕
老几	老幾
老千	老千
老台	老臺
老向	老向
老奸	老奸
老姜	老薑
老娘	老孃
老干	老乾
老干部	老幹部
老庄	老莊
老当	老當
老斗	老斗
老板	老闆
老爷钟	老爺鐘
老舍	老舍
老蒙	老懞
老表	老表
考个	考個
考了	考了
考出	考出
考卷	考卷
考后	考後
考征	考徵
考据	考據
考种	考種
者回	者回
而于	而於
而克制	而剋制
而后	而後
而回	而回
耍奸	耍奸
耍斗	耍鬭
耐冬	耐冬
耕佣	耕傭
耕出	耕出
耕种	耕種
耕获	耕穫
耗尽	耗盡
耘荡	耘盪
耦合	耦合
耧	耬
耳余	耳餘
耳卜	耳卜
耳后	耳後
耳沈	耳沈
耳针	耳針
耶娘	耶孃
耸	聳
耸了	聳了
耸出	聳出
耻	恥
耽于	耽於
耿于	耿於
聂	聶
聊个	聊個
聊表	聊表
聋	聾
聋虫	聾蟲
职	職
职别	職別
职志	職志
职系	職系
聍	聹
联	聯
联于	聯於
联合	聯合
联系	聯繫
聘雇	聘雇
聚了	聚了
聚合	聚合
聩	聵
聪	聰
聪了	聰了
肃	肅
肆志	肆志
肉丝面	肉絲麵
肉干	肉乾
肉松	肉鬆
肉欲	肉慾
肉羹面	肉羹麵
肚里	肚裏
肚饥	肚飢
肝脏	肝臟
肝郁	肝鬱
肠	腸
肠脏	腸臟
股价	股價
股栗	股慄
肤	膚
肤发	膚髮
肥了	肥了
肥筑方言	肥筑方言
肮	骯
肮肮脏脏	骯骯髒髒
肮脏	骯髒
肯出	肯出
肯回	肯回
育才	育才
育种	育種
肴	餚
肴馔	肴饌
肺叶	肺葉
肺脏	肺臟
肾	腎
肾脏	腎臟
肿	腫
胀	脹
胁	脅
胁制	脅制
胃脏	胃臟
胃药	胃藥
胃里	胃裏
胆	膽
背出	背出
背后	背後
背向	背向
背地里	背地裏
背面	背面
胎发	胎髮
胚叶	胚葉
胜	勝
胜了	勝了
胜事	勝事
胜于	勝於
胜仗	勝仗
胜任	勝任
胜会	勝會
胜似	勝似
胜利	勝利
胜券	勝券
胜在	勝在
胜地	勝地
胜境	勝境
胜局	勝局
胜常	勝常
胜得	勝得
胜景	勝景
胜朝	勝朝
胜概	勝概
胜流	勝流
胜游	勝遊
胜率	勝率
胜的	勝的
胜算	勝算
胜肽	胜肽
胜衣	勝衣
胜诉	勝訴
胜负	勝負
胜败	勝敗
胜蹟	勝蹟
胜过	勝過
胜部	勝部
胜键	胜鍵
胡三	胡三
胡乐	胡樂
胡乱	胡亂
胡云	胡云
胡亥	胡亥
胡人	胡人
胡伶	胡伶
胡佛	胡佛
胡侃	胡侃
胡儿	胡兒
胡匪	胡匪 鬍匪
胡卢	胡盧
胡同	衚衕
胡吣	胡唚
胡哨	胡哨
胡喷	胡噴
胡嘈	胡嘈
胡噜	胡嚕
胡子	鬍子
胡宁	胡寧
胡床	胡床
胡思	胡思
胡想	胡想
胡扯	胡扯
胡掳	胡擄
胡搅	胡攪
胡搞	胡搞
胡敲	胡敲
胡服	胡服
胡朴安	胡樸安
胡来	胡來
胡杨	胡楊
胡柴	胡柴
胡桃	胡桃
胡桐	胡桐
胡梢	鬍梢
胡梯	胡梯
胡椒	胡椒
胡海	胡海
胡涂	胡塗
胡混	胡混
胡渣	鬍渣
胡渰	胡渰
胡爲	胡爲
胡牌	胡牌
胡猜	胡猜
胡琴	胡琴
胡瑗	胡瑗
胡瓜	胡瓜
胡秦	胡秦
胡突	胡突
胡笙	胡笙
胡笳	胡笳
胡粉	胡粉
胡缠	胡纏
胡羼	胡羼
胡耈	胡耈
胡臭	胡臭
胡荽	胡荽
胡虏	胡虜
胡蜂	胡蜂
胡行	胡行
胡言	胡言
胡讲	胡講
胡诌	胡謅
胡话	胡話
胡语	胡語
胡说	胡說
胡豆	胡豆
胡赖	胡賴
胡越	胡越
胡适	胡適
胡里胡涂	胡裏胡塗
胡铨	胡銓
胡闹	胡鬧
胡须	鬍鬚
胡风	胡風
胡饼	胡餅
胡马	胡馬
胡骑	胡騎
胡髭	鬍髭
胡髯	鬍髯
胡麻	胡麻
胧	朧
胪	臚
胫	脛
胰脏	胰臟
胶	膠
胶卷	膠捲
胶合	膠合
胶布	膠布
胸针	胸針
能借	能借
能克制	能剋制
能干	能幹
脉	脈
脉冲	脈衝
脉岩	脈岩
脊梁	脊樑
脍	膾
脏	臟
脏东西	髒東西
脏乱	髒亂
脏了	髒了
脏兮兮	髒兮兮
脏发	髒髮
脏器	臟器
脏字	髒字
脏得	髒得
脏心	髒心
脏水	髒水
脏的	髒的
脏腑	臟腑
脏词	髒詞
脏话	髒話
脏钱	髒錢
脐	臍
脑	腦
脑后	腦後
脑子里	腦子裏
脑干	腦幹
脓	膿
脓团	膿團
脔	臠
脚	腳
脚价	腳價
脚板	腳板
脚注	腳註
脚炼	腳鍊
脚面	腳面
脱	脫
脱了	脫了
脱党	脫黨
脱出	脫出
脱发	脫髮
脱困	脫困
脱尽	脫盡
脱蜡	脫蠟
脱谷机	脫穀機
脶	腡
脸	臉
脸面	臉面
脺脏	脺臟
脾脏	脾臟
腊	臘
腊之以为饵	腊之以爲餌
腊味	腊味
腊尽	臘盡
腊毒	腊毒
腊笔	腊筆
腌䐶	腌䐶
腌制	醃製
腌成	醃成
腌渍	醃漬
腌肉	醃肉
腌腊	醃臘
腌臜	腌臢
腌菜	醃菜
腌过	醃過
腌鱼	醃魚
腐余	腐餘
腐干	腐乾
腐恶	腐惡
腑脏	腑臟
腕表	腕錶
腭	齶
腮斗	腮斗
腰布	腰布
腰杆	腰桿
腰板	腰板
腰柜	腰櫃
腰里	腰裏
腹板	腹板
腹里	腹裏
腹面	腹面
腻	膩
腻了	膩了
腻云	膩雲
腼	靦
腼面	靦面
腽	膃
腾	騰
腾云	騰雲
腾冲	騰衝
腾出	騰出
腾升	騰昇
膏药	膏藥
膑	臏
膨松	膨鬆
臣仆	臣僕
臥云	臥雲
臥游	臥遊
臧获	臧獲
臧谷亡羊	臧穀亡羊
自个	自個
自了	自了
自于	自於
自修	自修
自制	自製
自发	自發
自后	自後
自夸	自誇
自尽	自盡
自当	自當
自愿	自願
自注	自注
自种	自種
自觉自愿	自覺自愿
自赞	自贊
自适	自適
自须	自須
臭虫	臭蟲
至于	至於
至多	至多
至当	至當
至极	至極
致书	致書
致乱	致亂
致于	致於
致仕	致仕
致使	致使
致冷	致冷
致函	致函
致力	致力
致命	致命
致哀	致哀
致奠	致奠
致密	緻密
致富	致富
致师	致師
致志	致志
致思	致思
致意	致意
致政	致政
致敬	致敬
致歉	致歉
致死	致死
致理	致理
致用	致用
致电	致電
致疑	致疑
致病	致病
致癌	致癌
致知	致知
致祭	致祭
致胜	致勝
致获	致獲
致词	致詞
致详	致詳
致语	致語
致谢	致謝
致贺	致賀
致赠	致贈
致身	致身
致辞	致辭
致远	致遠
致送	致送
臻于	臻於
舂谷	舂穀
舄卤	舄鹵
舆	輿
舆台	輿臺
舆尸	輿尸
舆志	輿志
舌叶	舌葉
舌后	舌後
舌干唇焦	舌乾唇焦
舌面	舌面
舍下	舍下
舍不得	捨不得
舍亲	舍親
舍人	舍人
舍出	捨出
舍利	舍利
舍去	捨去
舍命	捨命
舍堕	捨墮
舍妹	舍妹
舍姪	舍姪
舍安就危	捨安就危
舍实	捨實
舍己为人	捨己爲人
舍己为公	捨己爲公
舍己为国	捨己爲國
舍己从人	捨己從人
舍己救人	捨己救人
舍弃	捨棄
舍弟	舍弟
舍得	捨得
舍我其谁	捨我其誰
舍本逐末	捨本逐末
舍死忘生	捨死忘生
舍生	捨生
舍监	舍監
舍短取长	捨短取長
舍身	捨身
舍车保帅	捨車保帥
舍近求远	捨近求遠
舍间	舍間
舒卷	舒捲
舒适	舒適
舞出	舞出
舞台	舞臺
舞团	舞團
舞娘	舞娘
舞曲	舞曲
舢板	舢板
舣	艤
航向	航向
航海历	航海曆
舰	艦
舰只	艦隻
舱	艙
船厂	船廠
船只	船隻
船台	船臺
船娘	船孃
船板	船板
船钟	船鐘
舻	艫
艎板	艎板
艨冲	艨衝
良价	良价
良游	良遊
良种	良種
良药	良藥
艰	艱
艰困	艱困
色当	色當
色彩	色彩
色欲	色慾
色系	色系
艳	豔
艳后	豔后
艷后	豔后
艸木丰丰	艸木丰丰
艺	藝
艺坛	藝壇
艺术	藝術
节	節
节余	節餘
节制	節制
节录	節錄
节欲	節慾
芈	羋
芍药	芍藥
芒种	芒種
芗	薌
芜	蕪
芟秋	芟秋
芦	蘆
芦帘	蘆簾
芦荡	蘆蕩
芧栗	芧栗
芬郁	芬鬱
花个	花個
花了	花了
花价	花價
花卷	花捲
花厂	花廠
花台	花臺
花叶	花葉
花哄	花鬨
花团	花團
花坛	花壇
花娘	花娘
花布	花布
花庵词选	花菴詞選
花彩	花彩
花托	花托
花拳绣腿	花拳繡腿
花盆里	花盆裏
花种	花種
花胜	花勝
花荡	花蕩
花药	花葯
花虫	花蟲
花采	花采
花钟	花鐘
花雕	花雕
花面	花面
花马吊嘴	花馬弔嘴
苁	蓯
苇	葦
苈	藶
苋	莧
苌	萇
苍	蒼
苍发	蒼髮
苍术	蒼朮
苍松	蒼松
苍郁	蒼鬱
苎	苧
苎麻	苧麻
苏	蘇
苏丹	蘇丹
苏俄	蘇俄
苏北	蘇北
苏区	蘇區
苏堤	蘇堤
苏头	蘇頭
苏峻	蘇峻
苏州	蘇州
苏息	蘇息
苏打	蘇打
苏拉	蘇拉
苏方	蘇方
苏昆	蘇崑
苏木	蘇木
苏杭	蘇杭
苏武	蘇武
苏洵	蘇洵
苏澳	蘇澳
苏瓦	蘇瓦
苏白	蘇白
苏秦	蘇秦
苏绣	蘇繡
苏联	蘇聯
苏苏	蘇蘇
苏蕙	蘇蕙
苏轼	蘇軾
苏辙	蘇轍
苏醒	甦醒
苏铁	蘇鐵
苏隄	蘇隄
苑里	苑裏
苗栗	苗栗
苗种	苗種
苞叶	苞葉
苞虫	苞蟲
苟合	苟合
苟同	苟同
若个	若個
若于	若於
若向	若向
若干	若干
若虫	若蟲
苦了	苦了
苦于	苦於
苦修	苦修
苦卤	苦鹵
苦参	苦蔘
苦干	苦幹
苦斗	苦鬭
苦药	苦藥
苦里	苦裏
苧	薴
苧悴	薴悴
苧烯	薴烯
苫布	苫布
英制	英制
英占	英佔
英发	英發
英布	英布
英才	英才
英杰	英傑
英里	英里
苴布	苴布
苹	蘋
苹叶	蘋葉
苹婆	蘋婆
苹果	蘋果
苹萦	苹縈
苹风	蘋風
茂发	茂發
茂才	茂才
茂松	茂松
茂都淀	茂都澱
范例	範例
范围	範圍
范增	范增
范姜	范姜
范字	範字
范宽	范寬
范式	範式
范性形变	範性形變
范文	範文
范晔	范曄
范本	範本
范畴	範疇
范蠡	范蠡
范进	范進
范金	範金
范阳	范陽
范雎	范雎
茄克	茄克
茄冬	茄冬
茅台	茅臺
茅舍	茅舍
茅针	茅針
茈胡	茈胡
茎	莖
茎干	莖幹
茏	蘢
茑	蔦
茔	塋
茕	煢
茧	繭
茧栗	繭栗
茵借	茵藉
茶余	茶餘
茶几	茶几
茶卤	茶滷
茶叶	茶葉
茶庄	茶莊
茶托	茶托
茶面	茶麵
荅布	荅布
荆	荊
荆尸	荊尸
荆布	荊布
草丛里	草叢裏
草叶	草葉
草广	草广
草庵	草菴
草签	草簽
草舍	草舍
草荐	草荐
草药	草藥
草虫	草蟲
荐	薦
荐居	荐居
荐臻	荐臻
荐饥	荐饑
荒了	荒了
荚	莢
荛	蕘
荜	蓽
荞	蕎
荞麦面	蕎麥麵
荟	薈
荠	薺
荡	盪
荡产	蕩產
荡出	盪出
荡口	盪口
荡复	蕩覆
荡女	蕩女
荡妇	蕩婦
荡子	蕩子
荡寇	蕩寇
荡寒	盪寒
荡尽	蕩盡
荡平	蕩平
荡心	蕩心
荡志	蕩志
荡散	蕩散
荡来荡去	蕩來蕩去
荡析	蕩析
荡气回肠	蕩氣迴腸
荡涤	盪滌
荡漾	盪漾
荡潏	蕩潏
荡然	蕩然
荡田	蕩田
荡舟	盪舟
荡船	盪船
荡荡	蕩蕩
荡酒	盪酒
荡风	盪風
荣	榮
荣升	榮升
荣幸	榮幸
荣获	榮獲
荤	葷
荥	滎
荦	犖
荦确	犖确
荧	熒
荧郁	熒鬱
荨	蕁
荩	藎
荪	蓀
荫	蔭
荭	葒
药	葯
药专	藥專
药丸	藥丸
药典	藥典
药兽	藥獸
药农	藥農
药到命除	藥到命除
药到病除	藥到病除
药剂	藥劑
药力	藥力
药包	藥包
药医学系	藥醫學系
药单	藥單
药厂	藥廠
药叉	藥叉
药名	藥名
药味	藥味
药品	藥品
药商	藥商
药壶	藥壷
药头	藥頭
药婆	藥婆
药学	藥學
药害	藥害
药局	藥局
药师	藥師
药店	藥店
药引	藥引
药性	藥性
药房	藥房
药效	藥效
药方	藥方
药末	藥末
药杀	藥殺
药材	藥材
药械	藥械
药检局	藥檢局
药棉	藥棉
药死	藥死
药水	藥水
药汁	藥汁
药油	藥油
药法	藥法
药浴	藥浴
药液	藥液
药渣	藥渣
药片	藥片
药物	藥物
药王	藥王
药理	藥理
药瓶	藥瓶
药用	藥用
药疹	藥疹
药瘾	藥癮
药皂	藥皂
药盒	藥盒
药石	藥石
药科	藥科
药筒	藥筒
药签	藥籤
药箭	藥箭
药箱	藥箱
药籤	藥籤
药粉	藥粉
药糖	藥糖
药线	藥綫
药罐	藥罐
药膏	藥膏
药膛	藥膛
药膳	藥膳
药舖	藥舖
药茶	藥茶
药草	藥草
药行	藥行
药衡	藥衡
药补	藥補
药袋	藥袋
药言	藥言
药贩	藥販
药贴	藥貼
药费	藥費
药酒	藥酒
药量	藥量
药针	藥針
药铺	藥鋪
药锭	藥錠
药面儿	藥麵兒
药饵	藥餌
药饼	藥餅
药骰	藥骰
荷叶	荷葉
荷花淀	荷花澱
莅	蒞
莫当	莫當
莫须	莫須
莱	萊
莱彩	萊彩
莲	蓮
莲台	蓮臺
莲叶	蓮葉
莲须	蓮鬚
莳	蒔
莴	萵
莶	薟
获	獲
获准	獲准
获利	獲利
获到	獲到
获匪其丑	獲匪其醜
获取	獲取
获咎	獲咎
获奖	獲獎
获得	獲得
获悉	獲悉
获戾	獲戾
获捷	獲捷
获救	獲救
获益	獲益
获知	獲知
获罪	獲罪
获胜	獲勝
获致	獲致
获赠	獲贈
获赦	獲赦
获选	獲選
获邀	獲邀
获释	獲釋
获颁	獲頒
获鹿	獲鹿
莸	蕕
莹	瑩
莺	鶯
莺谷	鶯谷
莽卤	莽鹵
莽荡	莽蕩
菊坛	菊壇
菊秋	菊秋
菌种	菌種
菜干	菜乾
菜种	菜種
菜肴	菜肴
菜虫	菜蟲
菠棱菜	菠棱菜
菠萝干	菠蘿乾
萌发	萌發
萎雕	萎雕
萝	蘿
萝卜	蘿蔔
萝卜干	蘿蔔乾
萤	螢
营	營
营干	營幹
营舍	營舍
萦	縈
萦回	縈迴
萦系	縈繫
萧	蕭
萧参	蕭蔘
萧娘	蕭娘
萨	薩
落了	落了
落于	落於
落价	落價
落卷	落卷
落发	落髮
落台	落臺
落叶	落葉
落后	落後
落托	落托
落腮胡	落腮鬍
著录	著錄
著志	著志
葛布	葛布
葡占	葡佔
葡萄干	葡萄乾
董氏封发	董氏封髮
葱	蔥
葱郁	蔥鬱
蒇	蕆
蒉	蕢
蒋	蔣
蒌	蔞
蒌叶	蔞葉
蒐录	蒐錄
蒙上	蒙上
蒙事	矇事
蒙人	蒙人
蒙住	矇住
蒙养	蒙養
蒙冤	蒙冤
蒙冲	蒙衝
蒙受	蒙受
蒙叟	蒙叟
蒙古	蒙古
蒙吏	蒙吏
蒙哄	蒙哄
蒙哥	蒙哥
蒙在	蒙在
蒙坑	蒙坑
蒙垢	蒙垢
蒙城	蒙城
蒙头	蒙頭
蒙头转	矇頭轉
蒙学	蒙學
蒙尘	蒙塵
蒙山	蒙山
蒙师	蒙師
蒙席	蒙席
蒙庄	蒙莊
蒙恩	蒙恩
蒙恬	蒙恬
蒙懂	懞懂
蒙戎	蒙戎
蒙拾	蒙拾
蒙族	蒙族
蒙昧	矇昧 濛昧
蒙昧无知	矇昧無知
蒙松雨	濛鬆雨
蒙求	蒙求
蒙汗药	蒙汗藥
蒙汜	濛汜
蒙混	矇混
蒙爱	蒙愛
蒙特	蒙特
蒙田	蒙田
蒙皮	蒙皮
蒙盖	蒙蓋
蒙直	懞直
蒙眬	矇矓
蒙着	矇着
蒙瞍	矇瞍
蒙稚	蒙稚
蒙童	蒙童
蒙笼	蒙籠
蒙络	蒙絡
蒙羞	蒙羞
蒙聩	矇聵
蒙胞	蒙胞
蒙胧	朦朧
蒙脸	蒙臉
蒙茏	蒙蘢
蒙药	蒙藥
蒙蒙	濛濛 矇矇
蒙蒙懂懂	懞懞懂懂
蒙蒙细雨	濛濛細雨
蒙蔽	矇蔽
蒙藏	蒙藏
蒙语	蒙語
蒙谷	蒙谷
蒙起	蒙起
蒙难	蒙難
蒙雾	濛霧
蒙面	蒙面
蒙馆	蒙館
蒙骗	矇騙
蒙鸿	濛鴻
蒜发	蒜髮
蒲团	蒲團
蒸了	蒸了
蒸发	蒸發
蒿里	蒿里
蓄发	蓄髮
蓄志	蓄志
蓄胡	蓄鬍
蓄须	蓄鬚
蓊郁	蓊鬱
蓝	藍
蓝布	藍布
蓝板	藍板
蓝淀	藍澱
蓟	薊
蓠	蘺
蓣	蕷
蓥	鎣
蓦	驀
蓬发	蓬髮
蓬松	蓬鬆
蓬蓬松松	蓬蓬鬆鬆
蔂	虆
蔑如	蔑如
蔑弃	蔑棄
蔑蒙	蔑蒙
蔑视	蔑視
蔗板	蔗板
蔷	薔
蔹	蘞
蔺	藺
蔼	藹
蔼彩	藹彩
蔽面	蔽面
蕉叶	蕉葉
蕉布	蕉布
蕲	蘄
蕲向	蘄向
蕴	蘊
蕴借	蘊藉
蕴含着	蘊含着
蕴涵着	蘊涵着
薄云	薄雲
薄干	薄幹
薄幸	薄倖
薄恶	薄惡
薄曲	薄曲
薄板	薄板
薄面	薄面
薙发	薙髮
薝卜	薝蔔
薮	藪
薰修	薰脩
薴烯	薴烯
藏于	藏於
藏历	藏曆
藏奸	藏奸
藏幸	藏幸
藏蒙歌儿	藏矇歌兒
藓	蘚
藕复	藕覆
藤制	藤製
藩台	藩臺
蘖	櫱
虎克	虎克
虎据	虎據
虎斗	虎鬭
虎须	虎鬚
虏	虜
虏获	虜獲
虑	慮
虚	虛
虚冲	虛沖
虚发	虛發
虚夸	虛誇
虚症	虛症
虚荡	虛蕩
虫	蟲
虫书	蟲書
虫体	蟲體
虫儿	蟲兒
虫出	蟲出
虫卵	蟲卵
虫声	蟲聲
虫子	蟲子
虫孔	蟲孔
虫害	蟲害
虫情	蟲情
虫漆	蟲漆
虫灾	蟲災
虫牙	蟲牙
虫瘿	蟲癭
虫眼	蟲眼
虫篆	蟲篆
虫类	蟲類
虫胶	蟲膠
虫虫	蟲蟲
虫蚀	蟲蝕
虫蚁	蟲蟻
虫蛭	蟲蛭
虫豸	蟲豸
虫部	虫部
虫鱼	蟲魚
虫鸣	蟲鳴
虬	虯
虬须	虯鬚
虮	蟣
虮蝨相吊	蟣蝨相弔
虹彩	虹彩
虽	雖
虾	蝦
虾须	蝦鬚
虿	蠆
蚀	蝕
蚁	蟻
蚁合	蟻合
蚁后	蟻后
蚁术	蟻術
蚂	螞
蚊动牛斗	蚊動牛鬭
蚊虫	蚊蟲
蚕	蠶
蚕种	蠶種
蚜虫	蚜蟲
蚬	蜆
蛀虫	蛀蟲
蛆虫	蛆蟲
蛇发女妖	蛇髮女妖
蛊	蠱
蛋卷	蛋卷
蛎	蠣
蛏	蟶
蛏干	蟶乾
蛔虫	蛔蟲
蛔虫药	蛔蟲藥
蛮	蠻
蛮干	蠻幹
蛰	蟄
蛰虫	蟄蟲
蛱	蛺
蛲	蟯
蛲虫	蟯蟲
蛳	螄
蛴	蠐
蜀党	蜀黨
蜂准	蜂準
蜂出	蜂出
蜂后	蜂后
蜂涌	蜂涌
蜂蒙	蜂蒙
蜂蜡	蜂蠟
蜕	蛻
蜗	蝸
蜗杆	蜗桿
蜗舍	蝸舍
蜜蜡	蜜蠟
蜜里调油	蜜裏調油
蜡	蠟
蜡丸	蠟丸
蜡书	蠟書
蜡人	蠟人
蜡像	蠟像
蜡台	蠟臺
蜡嘴	蠟嘴
蜡封	蠟封
蜡屐	蠟屐
蜡布	蠟布
蜡弹	蠟彈
蜡扦	蠟扦
蜡月	蜡月
蜡本	蠟本
蜡板	蠟板
蜡果	蠟果
蜡染	蠟染
蜡査	蠟査
蜡梅	蠟梅
蜡油	蠟油
蜡泪	蠟淚
蜡渣	蠟渣
蜡灯	蠟燈
蜡炬	蠟炬
蜡烛	蠟燭
蜡版	蠟版
蜡珀	蠟珀
蜡画	蠟畫
蜡疗	蠟療
蜡皮	蠟皮
蜡祭	蜡祭
蜡笔	蠟筆
蜡笺	蠟箋
蜡纸	蠟紙
蜡膏	蠟膏
蜡膜	蠟膜
蜡花	蠟花
蜡茶	蠟茶
蜡虫	蠟蟲
蜡蜂	蠟蜂
蜡诏	蠟詔
蜡质	蠟質
蜡铺	蠟鋪
蜡黄	蠟黃
蜰虫	蜰蟲
蜷曲	蜷曲
蝇	蠅
蝈	蟈
蝉	蟬
蝎	蠍
蝎蝎螫螫	蝎蝎螫螫
蝎谮	蝎譖
蝗虫	蝗蟲
蝼	螻
蝾	蠑
融合	融合
融汇	融匯
螟虫	螟蟲
螫针	螫針
螹胡	螹胡
螺杆	螺桿
蟠据	蟠據
蟠曲	蟠曲
蟠采	蟠采
蟻后	蟻后
蟾彩	蟾彩
蠁干	蠁幹
蠓虫	蠓蟲
蠕虫	蠕蟲
蠢虫	蠢蟲
蠹虫	蠹蟲
血仇	血仇
血余	血餘
血参	血參
血拼	血拚
衅	釁
衅恶	釁惡
衅钟	釁鐘
衅面	釁面
行了	行了
行事历	行事曆
行于	行於
行云	行雲
行佣	行佣
行凶	行兇
行卷	行卷
行台	行臺
行同	行同
行复	行復
行幸	行幸
行当	行當
行志	行志
行板	行板
行游	行遊
行药	行藥
行针	行鍼
衍极	衍極
衔	銜
衣柜	衣櫃
衣绣昼行	衣繡晝行
补	補
补于	補於
补修	補修
补发	補發
补注	補註
补种	補種
补药	補藥
补血药	補血藥
补针	補針
表亲	表親
表仪	表儀
表件	表件
表停	錶停
表兄	表兄
表冊	表冊
表冠	錶冠
表决	表決
表出	表出
表列	表列
表功	表功
表厂	錶廠
表叔	表叔
表哥	表哥
表唱	表唱
表土	表土
表壳	錶殼
表头	表頭
表奏	表奏
表妹	表妹
表姊	表姊
表姐	表姐
表姑	表姑
表姨	表姨
表姪	表姪
表婶	表嬸
表嫂	表嫂
表子	表子
表字	表字
表尺	表尺
表层	表層
表带	錶帶
表店	錶店
表弟	表弟
表彰	表彰
表征	表徵
表德	表德
表快	錶快
表态	表態
表情	表情
表意	表意
表慢	錶慢
表扬	表揚
表报	表報
表揭	表揭
表文	表文
表明	表明
表显	表顯
表本	表本
表板	錶板
表格	表格
表海	表海
表演	表演
表照	表照
表率	表率
表王	錶王
表现	表現
表甥	表甥
表白	表白
表的历史	錶的歷史
表的嘀嗒	錶的嘀嗒
表皮	表皮
表盘	錶盤
表相	表相
表示	表示
表礼	表禮
表章	表章
表笔	表筆
表笺	表箋
表背	表背
表舅	表舅
表荐	表薦
表蒙子	錶蒙子
表行	錶行
表表	表表
表襮	表襮
表观	表觀
表记	表記
表证	表證
表识	表識
表词	表詞
表象	表象
表转	錶轉
表达	表達
表述	表述
表速	錶速
表里	表裏
表针	錶針
表链	錶鏈
表错	表錯
表门	表門
表露	表露
表面	表面
表题	表題
表饰	表飾
衬	襯
衬出	襯出
衬布	襯布
衬托	襯托
衬里	襯裏
衮	袞
衷于	衷於
衷曲	衷曲
衿曲	衿曲
袁术	袁術
袄	襖
袅	裊
袅娜	嫋娜
袅窕	裊窕
袅绕	裊繞
袅袅	嫋嫋 裊裊
袋表	袋錶
袋里	袋裏
袖里	袖裏
袜	襪
被发	被髮
被发佯狂	被髮佯狂
被发入山	被髮入山
被发左衽	被髮左衽
被发缨冠	被髮纓冠
被发阳狂	被髮陽狂
被复	被複
被里	被裏
被面	被面
袭	襲
袭卷	襲捲
裁划	裁劃
裁制	裁製
裁并	裁併
裂了	裂了
裂致	裂致
裂谷	裂谷
装	裝
装修	裝修
装出	裝出
装折	裝摺
裆	襠
裒克	裒剋
裢	褳
裣	襝
裤	褲
裴回	裴回
裸叶	裸葉
裹了	裹了
裹尸	裹屍
裹布	裹布
褐布	褐布
褒录	褒錄
褒赞	褒讚
褛	褸
褴	襤
褶曲	褶曲
襄赞	襄贊
襟曲	襟曲
西出	西出
西占	西佔
西厂	西廠
西历	西曆
西台	西臺
西后	西后
西向	西向
西周	西周
西周钟	西周鐘
西岳	西嶽
西征	西征
西晒	西曬
西曲	西曲
西极	西極
西游	西遊
西药	西藥
西蒙	西蒙
西里	西里
西面	西面
要么	要麼
要了	要了
要价	要價
要克制	要剋制
要冲	要衝
要占	要佔
覆亡	覆亡
覆命	覆命
覆没	覆沒
覆盖	覆蓋
覆盖着	覆蓋着
覆着	覆着
覆辙	覆轍
见	見
见个	見個
见了	見了
见于	見於
见几	見幾
见复	見覆
见棱见角	見棱見角
见素抱朴	見素抱樸
见面	見面
观	觀
观台	觀臺
观采	觀採
规	規
规划	規劃
规复	規復
规范	規範
觅	覓
视	視
视于	視於
视同	視同
觇	覘
览	覽
览胜	覽勝
觉	覺
觉出	覺出
觉发	覺發
觊	覬
觊幸	覬倖
觋	覡
觌	覿
觌面	覿面
觎	覦
觏	覯
觐	覲
觑	覷
觑当	覷當
角落里	角落裏
角里	角里
觔斗	觔斗
觚棱	觚棱
觞	觴
解了	解了
解出	解出
解制	解制
解发	解發
解发佯狂	解髮佯狂
解困	解困
解当	解當
解痛药	解痛藥
解药	解藥
解雇	解雇
触	觸
触发	觸發
触板	觸板
触须	觸鬚
觯	觶
觱发	觱發
言云	言云
言大而夸	言大而夸
言辩而确	言辯而确
証据	証據
詩云	詩云
誉	譽
誊	謄
誊出	謄出
誊录	謄錄
誓愿	誓願
語有云	語有云
謷丑	謷醜
謻台	謻臺
警世钟	警世鐘
警报钟	警報鐘
警示钟	警示鐘
警钟	警鐘
计	計
计价	計價
计划	計劃
计时表	計時錶
订	訂
订个	訂個
订了	訂了
订于	訂於
订价	訂價
订出	訂出
订制	訂製
讣	訃
认	認
认个	認個
认了	認了
认准	認準
认出	認出
认同	認同
认尸	認屍
讥	譏
讦	訐
讦发	訐發
讧	訌
讨	討
讨个	討個
讨了	討了
讨价	討價
讨出	討出
讨彩	討彩
让	讓
让价	讓價
让出	讓出
讪	訕
讫	訖
讫了	訖了
讬了	託了
训	訓
训蒙	訓蒙
议	議
议价	議價
议坛	議壇
讯	訊
记	記
记了	記了
记仇	記仇
记录	記錄
记挂	記掛
讲	講
讲个	講個
讲了	講了
讲价	講價
讲出	講出
讲台	講臺
讲坛	講壇
讳	諱
讴	謳
讵	詎
讶	訝
讷	訥
许	許
许愿	許願
许愿起经	許愿起經
讹	訛
论	論
论价	論價
论坛	論壇
论据	論據
论赞	論贊
讼	訟
讽	諷
设	設
设了	設了
设于	設於
设党	設黨
设厂	設廠
设台	設臺
设坛	設壇
访	訪
访台	訪臺
诀	訣
诀别	訣別
证	證
证于	證於
证出	證出
证据	證據
诂	詁
诃	訶
评	評
评个	評個
评了	評了
评价	評價
评出	評出
评卷	評卷
评注	評註
评鉴	評鑒
诅	詛
识	識
识别	識別
识面	識面
诈	詐
诈哄	詐哄
诈尸	詐屍
诈术	詐術
诈胡	詐胡
诉	訴
诉愿	訴願
诊	診
诋	詆
诌	謅
词	詞
词余	詞餘
词干	詞幹
词曲	詞曲
词汇	詞彙
词表	詞表
词采	詞采
诎	詘
诏	詔
诏板	詔板
译	譯
译注	譯註
诒	詒
诓	誆
诓哄	誆哄
诔	誄
诔赞	誄讚
试	試
试出	試出
试制	試製
试卷	試卷
试周	試周
试炼	試煉
试种	試種
试药	試藥
诖	詿
诗	詩
诗云	詩云
诗余	詩餘
诗卷	詩卷
诗坛	詩壇
诗才	詩才
诗赞	詩讚
诗钟	詩鐘
诘	詰
诘曲	詰曲
诙	詼
诚	誠
诚征	誠徵
诚朴	誠樸
诛	誅
诜	詵
话	話
话别	話別
话里有话	話裏有話
诞	誕
诟	詬
诠	詮
诠注	詮註
诡	詭
询	詢
询于	詢於
询价	詢價
诣	詣
诤	諍
该	該
该于	該於
该党	該黨
该厂	該廠
该向	該向
该回	該回
该当	該當
该钟	該鐘
该面	該面
详	詳
详尽	詳盡
详征博引	詳徵博引
详注	詳註
详确	詳確
诧	詫
诨	諢
诩	詡
诫	誡
诬	誣
诬蔑	誣衊
语	語
语云	語云
语录	語錄
语有云	語有云
语汇	語彙
语系	語系
诮	誚
误	誤
诰	誥
诱	誘
诱出	誘出
诱发	誘發
诱奸	誘姦
诲	誨
诳	誑
说	說
说了	說了
说出	說出
说合	說合
说着	說着
诵	誦
诶	誒
请	請
请个	請個
请了	請了
请出	請出
请向	請向
请君入瓮	請君入甕
请回	請回
请愿	請願
请托	請託
诸	諸
诸余	諸餘
诹	諏
诺	諾
读	讀
读了	讀了
读出	讀出
读后	讀後
诼	諑
诽	誹
课	課
课余	課餘
课卷	課卷
课后	課後
课征	課徵
课表	課表
诿	諉
谀	諛
谁	誰
谁个	誰個
谁干的	誰幹的
谂	諗
调	調
调个	調個
调了	調了
调价	調價
调准	調準
调出	調出
调制	調製
调升	調升
调卷	調卷
调发	調發
调合	調合
调哄	調哄
调回	調回
调当	調當
调表	調錶
调适	調適
谄	諂
谅	諒
谆	諄
谇	誶
谈	談
谈了	談了
谈出	談出
谈征	談徵
谊	誼
谋	謀
谋划	謀劃
谋干	謀幹
谋面	謀面
谌	諶
谍	諜
谎	謊
谎价	謊價
谏	諫
谐	諧
谐价	諧價
谐当	諧當
谑	謔
谒	謁
谓	謂
谔	諤
谕	諭
谖	諼
谗	讒
谘	諮
谙	諳
谙历	諳歷
谚	諺
谛	諦
谜	謎
谜团	謎團
谜面	謎面
谝	諞
谟	謨
谠	讜
谡	謖
谢	謝
谢了	謝了
谢别	謝別
谢表	謝表
谣	謠
谤	謗
谥	謚
谦	謙
谦克	謙克
谦冲	謙沖
谧	謐
谨	謹
谨致	謹致
谩	謾
谪	謫
谫	譾
谬	謬
谬种	謬種
谬赞	謬讚
谬采虚声	謬採虛聲
谭	譚
谮	譖
谯	譙
谯周	譙周
谰	讕
谱	譜
谱出	譜出
谱录	譜錄
谱曲	譜曲
谱系	譜系
谱表	譜表
谲	譎
谳	讞
谴	譴
谵	譫
谶	讖
谷人	穀人
谷仓	穀倉
谷保家商	穀保家商
谷关	谷關
谷口	谷口
谷圭	穀圭
谷地	谷地
谷场	穀場
谷城	谷城
谷壁	谷壁
谷壳	穀殼
谷子	穀子
谷川	谷川
谷底	谷底
谷日	穀日
谷旦	穀旦
谷梁	穀梁
谷永	谷永
谷湾	谷灣
谷物	穀物
谷皮	穀皮
谷神	穀神
谷米	穀米
谷类	穀類
谷粒	穀粒
谷舱	穀艙
谷苗	穀苗
谷草	穀草
谷蠡	谷蠡
谷谷	穀穀 谷谷
谷象	谷象
谷贱伤农	穀賤傷農
谷贵饿农	穀貴餓農
谷道	穀道
谷都	谷都
谷雨	穀雨
谷风	谷風 穀風
谷食	穀食
谷饮	谷飲
谿谷	谿谷
豁出	豁出
豁荡	豁蕩
豆娘	豆娘
豆干	豆乾
豆签	豆簽
豉虫	豉蟲
象征	象徵
象征着	象徵着
象板	象板
豪杰	豪傑
豫游	豫遊
買凶	買兇
賈后	賈后
賢后	賢后
賨布	賨布
賸余	賸餘
贝	貝
贝克	貝克
贝叶	貝葉
贝当	貝當
贞	貞
负	負
负债累累	負債累累
负向	負向
负才	負才
负极	負極
负面	負面
贡	貢
贡烟	貢菸
财	財
财团	財團
责	責
贤	賢
贤后	賢后
贤才	賢才
败	敗
败于	敗於
败叶	敗葉
账	賬
货	貨
货价	貨價
货卜	貨卜
货布	貨布
货柜	貨櫃
质	質
质当	質當
质朴	質樸
贩	販
贪	貪
贪欲	貪慾
贫	貧
贫困	貧困
贬	貶
贬价	貶價
购	購
购买欲	購買慾
购并	購併
贮	貯
贯	貫
贯注	貫注
贰	貳
贱	賤
贱价	賤價
贱才	賤才
贲	賁
贳	貰
贴	貼
贴个	貼個
贴出	貼出
贴后	貼後
贴布	貼布
贵	貴
贵了	貴了
贵价	貴价
贵干	貴幹
贵幸	貴幸
贵征	貴徵
贵戚	貴戚
贶	貺
贷	貸
贷个	貸個
贷了	貸了
贷借	貸借
贷出	貸出
贸	貿
费	費
费了	費了
费占	費佔
费尽	費盡
贺	賀
贺表	賀表
贻	貽
贻范	貽範
贼	賊
贼党	賊黨
贽	贄
贾	賈
贾后	賈后
贾胡	賈胡
贿	賄
赀	貲
赁	賃
赂	賂
赃	贓
资	資
资历	資歷
赅	賅
赆	贐
赇	賕
赈	賑
赈饥	賑饑
赉	賚
赉发	賚發
赊	賒
赊借	賒借
赋	賦
赋别	賦別
赌	賭
赌了	賭了
赌台	賭檯
赌当	賭當
赌斗	賭鬭
赌注	賭注
赌胜	賭勝
赍	齎
赍发	齎發
赎	贖
赎回	贖回
赎当	贖當
赎药	贖藥
赏	賞
赏了	賞了
赏赞	賞讚
赏鉴	賞鑒
赐	賜
赐了	賜了
赐复	賜復
赓	賡
赔	賠
赔了	賠了
赔出	賠出
赔尽	賠盡
赕	賧
赖	賴
赖于	賴於
赘	贅
赙	賻
赚	賺
赚个	賺個
赚了	賺了
赚哄	賺哄
赛	賽
赛愿	賽願
赜	賾
赝	贗
赞	贊
赞不绝口	讚不絕口
赞乐	讚樂
赞佩	讚佩
赞助	贊助
赞叹	讚歎
赞叹不已	讚歎不已
赞同	贊同
赞呗	讚唄
赞善	贊善
赞成	贊成
赞扬	讚揚
赞拜	贊拜
赞普	贊普
赞歌	讚歌
赞歎	讚歎
赞理	贊理
赞礼	贊禮
赞美	讚美
赞羡	讚羨
赞翼	贊翼
赞誉	讚譽
赞许	讚許
赞词	讚詞
赞赏	讚賞
赞辞	讚辭
赞颂	讚頌
赠	贈
赠别	贈別
赡	贍
赢	贏
赢了	贏了
赢余	贏餘
赢出	贏出
赢回	贏回
赣	贛
赤术	赤朮
赤松	赤松
赤绳系足	赤繩繫足
赭面	赭面
走了	走了
走出	走出
走后	走後
走向	走向
走回	走回
走板	走板
赴曲	赴曲
赵	趙
赵云	趙雲
赵庄	趙莊
赵治勋	趙治勳
赶	趕
赶了	趕了
赶修	趕修
赶出	趕出
赶制	趕製
赶向	趕向
赶回	趕回
赶录	趕錄
赶面棍	趕麵棍
起了	起了
起价	起價
起吊	起吊
起哄	起鬨
起复	起復
起获	起獲
趁哄	趁哄
趁愿	趁願
超出	超出
超升	超升
超级杯	超級杯
越冬	越冬
越出	越出
越发	越發
趋	趨
趋于	趨於
趋向	趨向
趋舍	趨舍
趫才	趫才
趱	趲
趱干	趲幹
足于	足於
足坛	足壇
趸	躉
趸当	躉當
跃	躍
跃升	躍升
跄	蹌
跌了	跌了
跌价	跌價
跌扑	跌扑
跌荡	跌蕩
跎纤	跎縴
跑出	跑出
跑合	跑合
跑表	跑表
跗注	跗注
跗面	跗面
跞	躒
跟了	跟了
跟出	跟出
跟斗	跟斗
跨了	跨了
跨党	跨黨
跨出	跨出
跨向	跨向
跪了	跪了
路志	路誌
路签	路籤
路面	路面
跳了	跳了
跳价	跳價
跳出	跳出
跳台	跳臺
跳回	跳回
跳板	跳板
跳梁	跳梁
跳梁小丑	跳樑小丑
跳荡	跳蕩
跳表	跳錶
跳针	跳針
践	踐
践极	踐極
跷	蹺
跷了	蹺了
跷出	蹺出
跸	蹕
跹	躚
跻	躋
跻升	躋升
踅回	踅回
踊	踊
踌	躊
踏了	踏了
踏出	踏出
踏板	踏板
踢了	踢了
踢出	踢出
踢向	踢向
踢回	踢回
踪	蹤
踬	躓
踬仆	躓仆
踯	躑
蹇修	蹇修
蹑	躡
蹒	蹣
蹪于	蹪於
蹰	躕
蹲了	蹲了
蹲板	蹲板
蹿	躥
躁郁	躁鬱
躄出	躄出
躏	躪
躏借	躪藉
躐胡	躐胡
躜	躦
身于	身於
身价	身價
身后	身後
躯	軀
躯干	軀幹
躺个	躺個
躺出	躺出
车	車
车厂	車廠
车库里	車庫裏
车斗	車斗
车种	車種
车站里	車站裏
车里	車裏
轧	軋
轧制	軋製
轨	軌
轨制	軌制
轨范	軌範
轩	軒
轩辟	軒闢
轫	軔
转	轉
转个	轉個
转了	轉了
转借	轉借
转出	轉出
转发	轉發
转台	轉檯
转向	轉向
转回	轉回
转录	轉錄
转托	轉託
转折	轉折
转斗千里	轉鬭千里
转注	轉註
转系	轉系
轭	軛
轮	輪
轮发	輪發
轮台	輪臺
轮回	輪迴
轮奸	輪姦
轮种	輪種
轮系	輪系
轮虫	輪蟲
软	軟
软困	軟困
轰	轟
轰了	轟了
轰出	轟出
轲	軻
轳	轤
轴	軸
轴系	軸系
轴面	軸面
轵	軹
轶	軼
轶荡	軼蕩
轸	軫
轹	轢
轺	軺
轻	輕
轻于	輕於
轻松	輕鬆
轻烟	輕煙
轻蔑	輕蔑
轻轻松松	輕輕鬆鬆
轼	軾
载	載
载于	載於
载出	載出
轾	輊
轿	轎
辁	輇
辁才	輇才
辂	輅
较	較
较于	較於
辄	輒
辅	輔
辅系	輔系
辅赞	輔贊
辆	輛
辇	輦
辈	輩
辈出	輩出
辉	輝
辊	輥
辋	輞
辍	輟
辎	輜
辏	輳
辐	輻
辑	輯
辑录	輯錄
输	輸
输了	輸了
输出	輸出
输征	輸征
辔	轡
辕	轅
辖	轄
辗	輾
辘	轆
辙	轍
辚	轔
辛丑	辛丑
辞	辭
辞修	辭修
辞别	辭別
辞汇	辭彙
辞致	辭致
辞采	辭采
辟世	辟世
辟为	闢爲
辟举	辟舉
辟书	辟書
辟佛	闢佛
辟作	闢作
辟划	闢劃
辟匿	辟匿
辟召	辟召
辟命	辟命
辟咡	辟咡
辟土	闢土
辟地	闢地
辟室	闢室
辟廱	辟廱
辟建	闢建
辟引	辟引
辟恶	辟惡
辟易	辟易
辟淫	辟淫
辟然	辟然
辟爲	闢爲
辟田	闢田
辟筑	闢築
辟纑	辟纑
辟色	辟色
辟芷	辟芷
辟言	辟言
辟谣	闢謠
辟谷	辟穀
辟辟	闢辟
辟违	辟違
辟逻	辟邏
辟邪	辟邪
辟邪以律	闢邪以律
辟雍	辟雍
辨出	辨出
辨别	辨別
辨向	辨向
辨复	辨復
辨志	辨志
辨折	辨折
辩	辯
辩才	辯才
辩斗	辯鬭
辫	辮
辫发	辮髮
辱游	辱游
边	邊
边修	邊修
辽	遼
辽沈	遼瀋
达	達
达致	達致
迁	遷
迁了	遷了
迁于	遷於
迁出	遷出
迁升	遷升
迁厂	遷廠
迁台	遷臺
迁回	遷回
迂回	迂迴
迂曲	迂曲
过	過
过了	過了
过于	過於
过冬	過冬
过冲	過沖
过出	過出
过历	過歷
过后	過後
过当	過當
过录	過錄
过杆	過杆
过梁	過樑
过水面	過水麵
过蒙	過蒙
迈	邁
迈了	邁了
迈克	邁克
迈出	邁出
迈向	邁向
迎出	迎出
迎合	迎合
迎向	迎向
迎面	迎面
运	運
运出	運出
运回	運回
近了	近了
近于	近於
近日無仇	近日無讎
近日里	近日裏
返台	返臺
返回	返回
返复	返復
返朴	返樸
返里	返里
还	還
还了	還了
还于	還於
还价	還價
还修	還修
还冲	還衝
还出	還出
还占	還佔
还发	還發
还向	還向
还回	還回
还愿	還願
还辟	還辟
还采	還採
这	這
这个	這個
这么	這麼
这么着	這麼着
这伙人	這夥人
这只	這隻
这只采	這只採
这回	這回
这注	這注
这种	這種
这里	這裏
这钟	這鐘
进	進
进了	進了
进价	進價
进修	進修
进出	進出
进占	進佔
进厂	進廠
进发	進發
进幸	進幸
远	遠
远于	遠於
远别	遠別
远县才至	遠縣纔至
远征	遠征
远志	遠志
远恶	遠惡
远游	遠遊
远胜	遠勝
违	違
连	連
连三并四	連三併四
连个	連個
连了	連了
连于	連於
连云	連雲
连出	連出
连升	連升
连占	連佔
连卷	連卷
连发	連發
连台	連臺
连合	連合
连同	連同
连回	連回
连庄	連莊
连杆	連桿
连种	連種
连系	連繫
连胜	連勝
连采	連採
迟	遲
迟了	遲了
迟回	遲迴
迥别	迥別
迥然回异	迥然迴異
迦叶	迦葉
迩	邇
迫于	迫於
迳	逕
迷了	迷了
迷于	迷於
迷幻药	迷幻藥
迷彩	迷彩
迷暗	迷暗
迷胡	迷胡
迷药	迷藥
迷蒙	迷濛
迷魂药	迷魂藥
迸出	迸出
迸发	迸發
迹	蹟
追凶	追兇
追向	追向
追回	追回
退伙	退夥
退党	退黨
退出	退出
退后	退後
退向	退向
退回	退回
退烧药	退燒藥
退针	退針
送个	送個
送了	送了
送修	送修
送出	送出
送别	送別
送回	送回
适	適
适中	適中
适之	適之
适于	適於
适人	適人
适从	適從
适任	適任
适值	適值
适切	適切
适口	適口
适合	適合
适婚	適婚
适孙	適孫
适宜	適宜
适应	適應
适度	適度
适当	適當
适性	適性
适意	適意
适才	適才
适时	適時
适来	適來
适然	適然
适用	適用
适者	適者
适逢	適逢
适量	適量
适销	適銷
适间	適間
适闷	適悶
适龄	適齡
逃了	逃了
逃出	逃出
逃回	逃回
逆党	逆黨
逆向	逆向
逆折	逆折
逆钟	逆鐘
选	選
选个	選個
选修	選修
选出	選出
选录	選錄
选曲	選曲
选种	選種
选系	選系
逊	遜
逊于	遜於
逋发	逋髮
逋荡	逋蕩
逍遥游	逍遙遊
透了	透了
透出	透出
透辟	透闢
逐个	逐個
逐出	逐出
递	遞
递了	遞了
递出	遞出
递升	遞升
递向	遞向
递回	遞迴
通了	通了
通于	通於
通历	通曆
通同	通同
通向	通向
通奸	通姦
通庄	通莊
通心面	通心麵
通志	通志
通才	通才
通鉴	通鑑
逛了	逛了
逛出	逛出
逛回	逛回
逛荡	逛蕩
逞凶	逞兇
逞凶斗狠	逞兇鬭狠
逞凶鬥狠	逞兇鬭狠
逞志	逞志
逞恶	逞惡
逞欲	逞欲
速回	速回
造价	造價
造出	造出
造曲	造麯
造钟	造鐘
造钟表	造鐘錶
逢蒙	逢蒙
逦	邐
逮系	逮繫
逮获	逮獲
逸才	逸才
逸欲	逸欲
逻	邏
逼了	逼了
逼出	逼出
逼向	逼向
逼回	逼回
逼并	逼併
逾出	逾出
遂愿	遂願
遄征	遄征
遇合	遇合
遍于	遍於
遍历	遍歷
遍布	遍布
遏云	遏雲
遏制	遏制
遐布	遐布
遐志	遐志
道出	道出
道别	道別
道曲	道曲
道术	道術
道范	道範
道里	道里
遗	遺
遗传钟	遺傳鐘
遗志	遺志
遗愿	遺願
遗才	遺才
遗范	遺範
遗表	遺表
遗迹	遺蹟
遣发	遣發
遣回	遣回
遥	遙
遨游	遨遊
遭致	遭致
遮丑	遮醜
遮复	遮覆
遮挽	遮挽
遮面	遮面
避了	避了
避向	避向
避孕药	避孕藥
避恶	避惡
邀天之幸	邀天之倖
邅回	邅回
邋里邋遢	邋裏邋遢
邑里	邑里
邓	鄧
邝	鄺
邢台	邢臺
那个	那個
那么	那麼
那么着	那麼着
那借	那借
那几	那幾
那卷	那捲
那只	那隻
那台	那臺
那回	那回
那种	那種
那里	那裏
邪恶	邪惡
邪曲	邪曲
邪术	邪術
邪辟	邪辟
邬	鄔
邮	郵
邮汇	郵匯
邸舍	邸舍
邹	鄒
邺	鄴
邻	鄰
邻曲	鄰曲
邻舍	鄰舍
邻里	鄰里
郁伊	鬱伊
郁勃	鬱勃
郁卒	鬱卒
郁南	鬱南
郁哉	郁哉
郁垒	鬱壘
郁堙不偶	鬱堙不偶
郁塞	鬱塞
郁律	鬱律
郁悒	鬱悒
郁愤	鬱憤
郁抑	鬱抑
郁挹	鬱挹
郁朴	郁樸
郁李	郁李
郁林	鬱林
郁气	鬱氣
郁江	鬱江
郁沉沉	鬱沉沉
郁泱	鬱泱
郁火	鬱火
郁烈	郁烈
郁热	鬱熱
郁燠	鬱燠
郁症	鬱症
郁积	鬱積
郁穆	郁穆
郁纡	鬱紆
郁结	鬱結
郁蒸	鬱蒸
郁蓊	鬱蓊
郁血	鬱血
郁邑	鬱邑
郁郁	鬱郁
郁郁不乐	鬱鬱不樂
郁郁不平	鬱鬱不平
郁郁寡欢	鬱鬱寡歡
郁郁而终	鬱鬱而終
郁郁葱葱	鬱鬱蔥蔥
郁金	鬱金
郁闭	鬱閉
郁闷	鬱悶
郁陶	鬱陶
郁馥	郁馥
郁黑	鬱黑
郊坛	郊壇
郊游	郊遊
郎个	郎個
郎当	郎當
郏	郟
郐	鄶
郑	鄭
郑凯云	鄭凱云
郑庄公	鄭莊公
郓	鄆
郘钟	郘鐘
郦	酈
郧	鄖
部党	部黨
部发	部發
部曲	部曲
郸	鄲
都于	都於
都出	都出
都发	都發
都向	都向
都回	都回
鄭凱云	鄭凱云
配了	配了
配出	配出
配制	配製
配发	配發
配合	配合
配水干管	配水幹管
配种	配種
配药	配藥
酒厂	酒廠
酒后	酒後
酒困	酒困
酒坛	酒罈
酒帘	酒帘
酒恶	酒惡
酒曲	酒麯
酒柜	酒櫃
酒肴	酒肴
酒胡	酒胡
酒药	酒藥
酒面	酒面
酝	醞
酝借	醞藉
酝酿着	醞釀着
酥松	酥鬆
酥签	酥簽
酱	醬
酽	釅
酾	釃
酿	釀
酿制	釀製
醇朴	醇樸
醇郁	醇郁
醉于	醉於
醋坛	醋罈
醋栗	醋栗
醣厂	醣廠
醮坛	醮壇
醲郁	醲郁
采下	採下
采为	採爲
采买	採買
采伐	採伐
采住	採住
采信	採信
采光	採光
采到	採到
采制	採制
采办	採辦
采区	採區
采去	採去
采取	採取
采回	採回
采在	採在
采地	采地
采声	采聲
采头	采頭
采女	采女
采好	採好
采录	採錄
采得	採得
采择	採擇
采拾	採拾
采挖	採挖
采掘	採掘
采摘	採摘
采摭	採摭
采撷	採擷
采收	採收
采料	採料
采暖	採暖
采树种	採樹種
采样	採樣
采桑	採桑
采樵人	採樵人
采气	採氣
采油	採油
采煤	採煤
采爲	採爲
采猎	採獵
采珠	採珠
采生折割	採生折割
采用	採用
采的	採的
采盐	採鹽
采石	採石
采矿	採礦
采砂场	採砂場
采种	採種
采空区	採空區
采空采穗	採空採穗
采納	採納
采纳	採納
采给	採給
采绿	采綠
采缉	采緝
采色	采色
采芑	采芑
采花	採花
采芹	采芹
采芹人	採芹人
采苓	采苓
采苹	采蘋
采茶	採茶
采药	採藥
采莲	採蓮
采获	採獲
采菊	採菊
采菽	采菽
采葛	采葛
采薇	采薇
采薪	採薪
采蘩	采蘩
采行	採行
采衣	采衣
采补	採補
采访	採訪
采证	採證
采诗	采詩
采购	採購
采过	採過
采运	採運
采选	採選
采邑	采邑
采采	采采
采金	採金
采铁	採鐵
采集	採集
采风	採風
采食	採食
釉彩	釉彩
釉药	釉藥
释	釋
释出	釋出
释卷	釋卷
里人	里人
里党	里黨
里加	里加
里勾外连	裏勾外連
里名	里名
里君	里君
里外	裏外
里头	裏頭
里子	裏子
里实	裏實
里宰	里宰
里尔	里爾
里层	裏層
里居	里居
里屋	裏屋
里巷	里巷
里布	裏布
里带	裏帶
里应外合	裏應外合
里廉	裏廉
里弦	裏弦
里急	裏急
里手	裏手
里拉	里拉
里搜	裏搜
里斯	里斯
里昂	里昂
里正	里正
里民	里民
里海	裏海
里港	里港
里白	裏白
里社	里社
里程	里程
里程表	里程錶
里约	里約
里老	里老
里耳	里耳
里肌	里肌
里胥	里胥
里脊	裏脊
里舍	里舍
里虚	裏虛
里衣	裏衣
里言	裏言
里语	里語
里谚	里諺
里豪	里豪
里踢	裏踢
里边	裏邊
里通外国	裏通外國
里通外敌	裏通外敵
里里	裏裏
里长	里長
里门	里門
里闬	里閈
里间	裏間
里闾	里閭
里面	裏面
重于	重於
重价	重價
重修	重修
重出	重出
重划	重劃
重制	重製
重发	重發
重台	重臺
重合	重合
重回	重回
重复	重複
重当	重當
重托	重託
重折	重摺
重涂	重塗
重游	重遊
重罗面	重羅麵
重锤	重錘
野台	野臺
野合	野合
野姜	野薑
野游	野遊
野种	野種
量了	量了
量出	量出
量回	量回
量表	量表
金仑溪	金崙溪
金价	金價
金发	金髮
金台	金臺
金叶	金葉
金斗	金斗
金柜	金櫃
金范	金範
金虫	金蟲
金表	金錶
金装玉里	金裝玉裏
金谷	金谷
金针	金針
金钟	金鐘
金面	金面
金马仑道	金馬崙道
釦了	釦了
鉴	鑒
鉴于	鑒於
鉴别	鑒別
鉴堂	鑒堂
鉴定	鑒定
鉴宝	鑒寶
鉴察	鑒察
鉴戒	鑒戒
鉴明	鑒明
鉴此	鑒此
鉴泉	鑒泉
鉴湖	鑑湖
鉴照	鑒照
鉴相	鑒相
鉴真	鑒真
鉴证	鑒證
鉴识	鑒識
鉴诫	鑒誡
鉴谅	鑒諒
鉴赏	鑒賞
鉴频	鑒頻
銮	鑾
錞于	錞于
錾	鏨
鍉针	鍉針
鎗托	鎗托
鎗杆	鎗桿
鎭	鎮
钆	釓
钇	釔
针	針
针关	鍼關
针刺	針刺
针剂	針劑
针口	鍼口
针叶	針葉
针头	針頭
针孔	針孔
针对	針對
针尖	針尖
针工	針工
针布	針布
针指	針指
针毡	針氈
针法	針法
针灸	鍼灸
针状	針狀
针盘	針盤
针眼	針眼
针砭	鍼砭
针神	針神
针笔	針筆
针筒	針筒
针箍	針箍
针线	針綫
针织	針織
针脚	針腳
针芒	鍼芒
针铓	針鋩
针锋	針鋒
针骨	針骨
针黹	針黹
针鼹	針鼹
针鼻	針鼻
钉	釘
钉个	釘個
钉了	釘了
钉合	釘合
钉锤	釘錘
钊	釗
钋	釙
钌	釕
钍	釷
钏	釧
钐	釤
钒	釩
钓	釣
钓个	釣個
钓了	釣了
钔	鍆
钕	釹
钗	釵
钗云	釵雲
钙	鈣
钛	鈦
钜	鉅
钜万	鉅萬
钝	鈍
钞	鈔
钞录	鈔錄
钟	鍾
钟上	鐘上
钟下	鐘下
钟不	鐘不
钟乳洞	鐘乳洞
钟乳石	鐘乳石
钟体	鐘體
钟停	鐘停
钟关	鐘關
钟匠	鐘匠
钟发音	鐘發音
钟口	鐘口
钟响	鐘響
钟在寺里	鐘在寺裏
钟塔	鐘塔
钟壁	鐘壁
钟声	鐘聲
钟太	鐘太
钟头	鐘頭
钟好	鐘好
钟山	鐘山
钟左右	鐘左右
钟差	鐘差
钟座	鐘座
钟形	鐘形
钟律	鐘律
钟快	鐘快
钟意	鐘意
钟慢	鐘慢
钟摆	鐘擺
钟敲	鐘敲
钟有	鐘有
钟楼	鐘樓
钟模	鐘模
钟没	鐘沒
钟漏	鐘漏
钟点	鐘點
钟王	鐘王
钟琴	鐘琴
钟的	鐘的
钟盘	鐘盤
钟相	鐘相
钟磬	鐘磬
钟纽	鐘紐
钟罩	鐘罩
钟腰	鐘腰
钟螺	鐘螺
钟行	鐘行
钟表	鐘錶
钟表面	鐘表面
钟被	鐘被
钟调	鐘調
钟身	鐘身
钟速	鐘速
钟陈列	鐘陳列
钟面	鐘面
钟顶	鐘頂
钟鸣	鐘鳴
钟鼎	鐘鼎
钟鼓	鐘鼓
钠	鈉
钡	鋇
钢	鋼
钢制	鋼製
钢千	鋼千
钢板	鋼板
钢梁	鋼樑
钢种	鋼種
钢针	鋼針
钣	鈑
钤	鈐
钥	鑰
钦	欽
钧	鈞
钧复	鈞覆
钧鉴	鈞鑒
钨	鎢
钩	鉤
钩了	鉤了
钩党	鉤黨
钩出	鉤出
钩心斗角	鉤心鬭角
钩虫	鉤蟲
钩针	鉤針
钪	鈧
钫	鈁
钬	鈥
钭	鈄
钮	鈕
钯	鈀
钰	鈺
钱	錢
钱复	錢復
钱布	錢布
钱庄	錢莊
钱柜	錢櫃
钱范	錢範
钱谷	錢穀
钲	鉦
钳	鉗
钳制	鉗制
钴	鈷
钵	鉢
钶	鈳
钸	鈽
钹	鈸
钺	鉞
钻	鑽
钻个	鑽個
钻出	鑽出
钻台	鑽臺
钻杆	鑽桿
钼	鉬
钽	鉭
钾	鉀
钿	鈿
钿合	鈿合
铀	鈾
铁	鐵
铁价	鐵價
铁厂	鐵廠
铁叶	鐵葉
铁杆	鐵桿
铁板	鐵板
铁柜	鐵櫃
铁针	鐵針
铁钟	鐵鐘
铁链	鐵鏈
铁锈	鐵鏽
铁锤	鐵錘
铁面	鐵面
铂	鉑
铃	鈴
铃虫	鈴蟲
铄	鑠
铅	鉛
铅板	鉛板
铆	鉚
铈	鈰
铉	鉉
铉台	鉉臺
铊	鉈
铋	鉍
铌	鈮
铍	鈹
铎	鐸
铐	銬
铑	銠
铒	鉺
铕	銪
铖	鋮
铗	鋏
铙	鐃
铛	鐺
铜	銅
铜制	銅製
铜厂	銅廠
铜叶	銅葉
铜板	銅板
铜范	銅範
铜钟	銅鐘
铝	鋁
铝制	鋁製
铝板	鋁板
铟	銦
铠	鎧
铡	鍘
铢	銖
铣	銑
铤	鋌
铥	銩
铧	鏵
铨	銓
铩	鎩
铪	鉿
铫	銚
铬	鉻
铭	銘
铮	錚
铯	銫
铯钟	銫鐘
铰	鉸
铰链	鉸鏈
铱	銥
铲	鏟
铲出	剷出
铲刈	剷刈
铲头	剷頭
铲子	鏟子
铲平	剷平
铲除	剷除
铳	銃
铴	鐋
铵	銨
银	銀
银价	銀價
银发	銀髮
银台	銀臺
银团	銀團
银朱	銀硃
银板	銀板
银柜	銀櫃
银针	銀針
铷	銣
铸	鑄
铸钟	鑄鐘
铹	鐒
铺	鋪
铺了	鋪了
铺伙	鋪夥
铺出	鋪出
铺向	鋪向
铺板	鋪板
铺锦列绣	鋪錦列繡
铺面	鋪面
铼	錸
铽	鋱
链	鏈
链冶	鍊冶
链句	鍊句
链套	鏈套
链子	鏈子
链字	鍊字
链师	鍊師
链度	鍊度
链式	鏈式
链形	鍊形
链条	鏈條
链椎	鏈椎
链气	鍊氣
链球	鏈球
链罩	鏈罩
链贫	鍊貧
链轨	鏈軌
链轮	鏈輪
链锁	鏈鎖
铿	鏗
销	銷
销了	銷了
销出	銷出
销回	銷回
销志	銷志
锁	鎖
锁柜	鎖櫃
锁链	鎖鏈
锂	鋰
锄	鋤
锄奸	鋤奸
锅	鍋
锅伙	鍋伙
锅台	鍋臺
锅庄	鍋莊
锅烟	鍋煙
锆	鋯
锇	鋨
锈	鏽
锈病	鏽病
锈菌	鏽菌
锈蚀	鏽蝕
锉	銼
锊	鋝
锋	鋒
锋出	鋒出
锋面	鋒面
锌	鋅
锌板	鋅板
锐	銳
锐志	銳志
锑	銻
锒	鋃
锓	鋟
锔	鋦
锕	錒
锖	錆
锗	鍺
错	錯
错了	錯了
锚	錨
锚杆	錨杆
锚虫	錨蟲
锛	錛
锞	錁
锟	錕
锡	錫
锢	錮
锣	鑼
锤	錘
锤儿	錘兒
锤头	錘頭
锤子	錘子
锤炼	錘鍊
锤链	錘鍊
锥	錐
锥面	錐面
锦	錦
锦绣	錦繡
锨	杴
锩	錈
锬	錟
锭	錠
键	鍵
锯	鋸
锯了	鋸了
锯出	鋸出
锰	錳
锱	錙
锲	鍥
锲而不舍	鍥而不捨
锴	鍇
锵	鏘
锶	鍶
锷	鍔
锸	鍤
锹	鍬
锺	鍾
锺表	鍾錶
锻	鍛
锻炼	鍛煉
锻炼出	鍛鍊出
锻链	鍛鍊
锼	鎪
锾	鍰
镀	鍍
镁	鎂
镂	鏤
镄	鐨
镆	鏌
镇	鎮
镇台	鎮臺
镉	鎘
镊	鑷
镌	鐫
镍	鎳
镏	鎦
镐	鎬
镑	鎊
镒	鎰
镓	鎵
镔	鑌
镕岩	鎔岩
镖	鏢
镗	鏜
镘	鏝
镙	鏍
镛	鏞
镜	鏡
镜台	鏡臺
镜鉴	鏡鑑
镜面	鏡面
镝	鏑
镞	鏃
镟	鏇
镡	鐔
镢	钁
镣	鐐
镤	鏷
镦	鐓
镧	鑭
镨	鐠
镪	鏹
镫	鐙
镬	鑊
镭	鐳
镯	鐲
镰	鐮
镰仓	鎌倉
镱	鐿
镳	鑣
镶	鑲
镶了	鑲了
镶板	鑲板
长	長
长了	長了
长于	長於
长几	長几
长出	長出
长历	長曆
长发	長發
长吁	長吁
长征	長征
长才	長才
长板	長板
长生药	長生藥
长胡	長鬍
长虫	長蟲
长谷	長谷
长针	長針
门	門
门吊儿	門弔兒
门帘	門簾
门斗	門斗
门板	門板
门里	門裏
门面	門面
闩	閂
闪	閃
闪了	閃了
闪出	閃出
闫	閆
闭	閉
闭合	閉合
闭面	閉面
问	問
问个	問個
问了	問了
问出	問出
问卜	問卜
问卷	問卷
问当	問當
闯	闖
闯出	闖出
闯炼	闖鍊
闯荡	闖蕩
闯链	闖鍊
闰	閏
闱	闈
闲	閒
闲情逸致	閒情逸緻
闲游	閒遊
闲荡	閒蕩
闲适	閒適
闳	閎
间	間
间不容发	間不容髮
间出	間出
间别	間別
闵	閔
闵凶	閔凶
闵采尔	閔採爾
闶	閌
闷	悶
闷板	悶板
闷着头儿干	悶着頭兒幹
闷表	悶錶
闸	閘
闸板	閘板
闹	鬧
闹个	鬧個
闹出	鬧出
闹台	鬧臺
闹哄	鬧鬨
闹着玩儿	鬧着玩兒
闹表	鬧錶
闹钟	鬧鐘
闺	閨
闺范	閨範
闻	聞
闻了	聞了
闻出	聞出
闼	闥
闽	閩
闽台	閩臺
闾	閭
闾里	閭里
阀	閥
阀杆	閥杆
阁	閣
阂	閡
阃	閫
阃范	閫範
阄	鬮
阅	閱
阅卷	閱卷
阅历	閱歷
阆	閬
阈	閾
阉	閹
阉党	閹黨
阊	閶
阋	鬩
阌	閿
阍	閽
阎	閻
阏	閼
阐	闡
阐发	闡發
阑	闌
阑干	闌干
阒	闃
阔	闊
阔别	闊別
阕	闋
阖	闔
阗	闐
阙	闕
阙里	闕里
阚	闞
队	隊
队别	隊別
阡表	阡表
阨困	阨困
阮咸	阮咸
防个	防個
防了	防了
防修	防修
防制	防制
防台	防颱
防御	防禦
防晒	防曬
防水表	防水錶
防秋	防秋
防范	防範
防锈	防鏽
阳	陽
阳历	陽曆
阳台	陽臺
阳春面	陽春麵
阳极	陽極
阳秋	陽秋
阳谷	陽谷
阳面	陽面
阴	陰
阴云	陰雲
阴占	陰占
阴历	陰曆
阴干	陰乾
阴恶	陰惡
阴暗	陰暗
阴极	陰極
阴沈	陰沈
阴沟里翻船	陰溝裏翻船
阴郁	陰鬱
阴雕	陰雕
阵	陣
阵云	陣雲
阶	階
阻于	阻於
阻修	阻修
阿党	阿黨
阿呆	阿呆
阿咸	阿咸
阿娘	阿孃
阿斗	阿斗
阿蒙	阿蒙
阿里	阿里
附了	附了
附于	附於
附合	附合
附录	附錄
附注	附註
附表	附表
际	際
陆	陸
陆丰	陸豐
陆云	陸雲
陆梁	陸梁
陆游	陸游
陇	隴
陇种	隴種
陈	陳
陈尸	陳屍
陈炼	陳鍊
陈胜	陳勝
陈链	陳鍊
陉	陘
降了	降了
降于	降於
降价	降價
降压药	降壓藥
降回	降回
降表	降表
限于	限於
限价	限價
限制	限制
限尽	限盡
陕	陝
院系	院系
除了	除了
除奸	除奸
除恶	除惡
除臭药	除臭藥
陧	隉
陨	隕
陨获	隕穫
险	險
险恶	險惡
险症	險症
险胜	險勝
陪了	陪了
陪出	陪出
陪吊	陪弔
陪同	陪同
陵云	陵雲
陵折	陵折
陵谷	陵谷
陷于	陷於
隆冬	隆冬
隆准	隆準
隆极	隆極
随	隨
随于	隨於
随同	隨同
随后	隨後
隐	隱
隐于	隱於
隐几	隱几
隐占	隱佔
隐暗	隱暗
隔了	隔了
隔出	隔出
隔别	隔別
隔向	隔向
隔周	隔週
隔板	隔板
隶	隸
隶仆	隸僕
隽	雋
难	難
难了	難了
难于	難於
难出	難出
难当	難當
难舍	難捨
雄才	雄才
雄胜	雄勝
雅游	雅游
雅致	雅緻
雅范	雅範
集了	集了
集于	集於
集合	集合
集团	集團
集录	集錄
集注	集註
集游法	集遊法
雇个	雇個
雇主	雇主
雇于	雇於
雇人	雇人
雇佣	雇傭
雇农	雇農
雇到	雇到
雇员	雇員
雇工	雇工
雇用	雇用
雏	雛
雕丧	雕喪
雕丽	雕麗
雕云	雕雲
雕像	雕像
雕刻	雕刻
雕励	雕勵
雕啄	雕啄
雕塑	雕塑
雕墙	雕牆
雕弓	雕弓
雕心雁爪	鵰心雁爪
雕悍	鵰悍
雕戈	雕戈
雕成	雕成
雕敝	雕敝
雕板	雕板
雕栏	雕欄
雕梁画栋	雕樑畫棟
雕残	雕殘
雕漆	雕漆
雕版	雕版
雕琢	雕琢
雕瑑	雕瑑
雕砌	雕砌
雕空	雕空
雕簇	雕簇
雕绘	雕繪
雕翎	鵰翎
雕色	雕色
雕花	雕花
雕虫	雕蟲
雕谢	雕謝
雕镂	雕鏤
雕镌	雕鐫
雕零	雕零
雕青	雕青
雕题	雕題
雕飕	雕颼
雕饰	雕飾
雕骚	雕騷
雕鹗	鵰鶚
雕龙	雕龍
雠	讎
雨云	雨雲
雨后	雨後
雨布	雨布
雩坛	雩壇
雪柜	雪櫃
雪窗萤几	雪窗螢几
雪里	雪裏
雳	靂
零个	零個
零余	零餘
零只	零隻
零布	零布
雷云	雷雲
雷同	雷同
雾	霧
雾台	霧臺
雾里	霧裏
霁	霽
霁范	霽範
震于	震於
震栗	震慄
震荡	震盪
霉毒	黴毒
霉素	黴素
霉菌	黴菌
霉黑	黴黑
霉黧	黴黧
霍里	霍里
霜叶	霜葉
霞云	霞雲
霞彩	霞彩
霞表	霞表
霭	靄
露丑	露醜
露了	露了
露出	露出
露台	露臺
露复	露覆
露尸	露屍
露布	露布
露才	露才
露板	露板
露面	露面
霸占	霸佔
霸才	霸才
霸据	霸據
霸术	霸術
青云	青雲
青发	青發
青叶	青葉
青山一发	青山一髮
青帘	青帘
青松	青松
青烟	青煙
青苹	青苹
青虫	青蟲
青霉	青黴
靓	靚
静	靜
静修	靜修
静舍	靜舍
非于	非於
非出	非出
非占不可	非佔不可
非同	非同
非当	非當
非才	非才
非据	非據
靠了	靠了
靠后	靠後
面上	面上
面世	面世
面临	面臨
面临着	面臨着
面交	面交
面人儿	麵人兒
面从	面從
面价	麵價
面会	面會
面值	面值
面允	面允
面光	面光
面具	面具
面分	面分
面刺	面刺
面前	面前
面包	麵包
面包扎	面包紮
面包着	面包着
面北	面北
面厂	麵廠
面向	面向
面君	面君
面听	面聽
面呈	面呈
面告	面告
面商	面商
面善	面善
面嘱	面囑
面嘴	面嘴
面团	麵糰
面圣	面聖
面坊	麵坊
面坯儿	麵坯兒
面垢	面垢
面塑	麵塑
面墙	面牆
面壁	面壁
面奏	面奏
面如	面如
面嫩	面嫩
面子	面子
面孔	面孔
面容	面容
面宽	面寬
面对	面對
面尘	面塵
面山	面山
面巾	面巾
面市	面市
面带	面帶
面店	麵店
面庞	面龐
面弱	面弱
面恶	面惡
面情	面情
面折	面折
面授	面授
面摊	麵攤
面数	面數
面斥	面斥
面旋	面旋
面无	面無
面晤	面晤
面有	面有
面朋	面朋
面朝	面朝
面朝着	面朝着
面杖	麵杖
面条	麵條
面板	面板
面染	面染
面桌	面桌
面水	面水
面汤	麵湯
面泛	面泛
面洽	面洽
面浆	麵漿
面海	面海
面灰	麵灰
面熟	面熟
面甜	面甜
面生	面生
面疔	面疔
面疙瘩	麵疙瘩
面疱	面皰
面皂	面皂
面皮	麵皮
面盆	面盆
面目	面目
面相	面相
面码儿	麵碼兒
面禀	面稟
面积	面積
面筋	麵筋
面粉	麵粉
面糊	麵糊
面红	面紅
面纱	面紗
面纸	面紙
面线	麵綫
面缚	面縛
面缸	麵缸
面罄	面罄
面罩	面罩
面肥	麵肥
面膜	面膜
面致	面致
面般	面般
面色	面色
面茶	麵茶
面薄	面薄
面衣	面衣
面西	面西
面见	面見
面誉	面譽
面议	面議
面试	面試
面请	面請
面谀	面諛
面谈	面談
面谒	面謁
面谕	面諭
面谢	面謝
面貌	面貌
面质	面質
面辞	面辭
面邀	面邀
面部	面部
面重	面重
面门	面門
面陈	面陳
面霜	面霜
面面	面面
面靥	面靨
面颊	面頰
面额	面額
面食	麵食
面食面	面食麵
面饰	面飾
面饺	麵餃
面饼	麵餅
面馆	麵館
面首	面首
面驾	面駕
面黄	面黃
靥	靨
革面	革面
靶台	靶臺
鞋厂	鞋廠
鞋柜	鞋櫃
鞋里	鞋裏
鞋面	鞋面
鞑	韃
鞣制	鞣製
鞭尸	鞭屍
鞭虫	鞭蟲
鞭辟入里	鞭辟入裏
鞯	韉
鞲	韝
韦	韋
韦后	韋后
韦娘	韋娘
韦布	韋布
韦庄	韋莊
韧	韌
韩	韓
韩制	韓製
韩国制	韓國製
韩干	韓幹
韪	韙
韫	韞
韬	韜
音准	音準
音同	音同
音声如钟	音聲如鐘
音系	音系
韵	韻
韵致	韻致
頁面	頁面
頂多	頂多
页	頁
页岩	頁岩
页面	頁面
顶	頂
顶个	頂個
顶了	頂了
顶凶	頂兇
顶叶	頂葉
顶回	頂回
顶多	頂多
顶板	頂板
顶针	頂針
顷	頃
顸	頇
项	項
项庄	項莊
项梁	項梁
项链	項鍊
顺	順
顺于	順於
顺当	順當
顺适	順適
顺钟向	順鐘向
须	須
须发	鬚髮
须子	鬚子
须待	須待
须得	須得
须捷	須捷
须是	須是
须根	鬚根
须毛	鬚毛
须然	須然
须生	鬚生
须用	須用
须留	須留
须眉	鬚眉
须知	須知
须索	須索
须胡	鬚鬍
须至	須至
须臾	須臾
须虑	須慮
须要	須要
须须	鬚鬚
须鲨	鬚鯊
须鲸	鬚鯨
顼	頊
顽	頑
顽卤	頑鹵
顽症	頑症
顽蒙	頑蒙
顾	顧
顾借	顧藉
顾曲	顧曲
顿	頓
顿了	頓了
颀	頎
颁	頒
颁发	頒發
颁布	頒佈
颂	頌
颂系	頌繫
颂赞	頌讚
颃	頏
预	預
预借	預借
预制	預製
预卜	預卜
预后	預後
颅	顱
领	領
领出	領出
领台	領檯
领回	領回
领域里	領域裏
领表	領表
领袖欲	領袖慾
颇	頗
颇复	頗覆
颇欲	頗欲
颈	頸
颉	頡
颊	頰
颊面	頰面
颊须	頰鬚
颌	頜
颍	潁
颏	頦
颐	頤
频	頻
颓	頹
颔	頷
颖	穎
颗	顆
题	題
题个	題個
题了	題了
题签	題籤
颚	顎
颛	顓
颛制	顓制
颛蒙	顓蒙
颜	顏
颜回	顏回
颜范	顏範
颜面	顏面
额	額
额征	額徵
额我略历	額我略曆
额面	額面
颞	顳
颟	顢
颠	顛
颠仆	顛仆
颠复	顛覆
颠干倒坤	顛乾倒坤
颠覆	顛覆
颡	顙
颢	顥
颤	顫
颤栗	顫慄
颦	顰
颧	顴
風采	風采
风	風
风云	風雲
风卷残云	風捲殘雲
风发	風發
风后	風后
风向	風向
风团	風團
风土志	風土誌
风干	風乾
风斗	風斗
风烟	風煙
风物志	風物誌
风致	風致
风范	風範
风药	風藥
风起云涌	風起雲涌
风采	風采
风里	風裏
飑	颮
飒	颯
飓	颶
飕	颼
飘	飄
飘向	飄向
飘摆	飄擺
飘游	飄遊
飘荡	飄蕩
飘飘荡荡	飄飄蕩蕩
飙	飆
飞	飛
飞个	飛個
飞了	飛了
飞云	飛雲
飞出	飛出
飞刍挽粟	飛芻輓粟
飞升	飛昇
飞向	飛向
飞回	飛回
飞征	飛征
飞扎	飛紮
飞梁	飛樑
飞虫	飛蟲
飞行钟	飛行鐘
飞谷	飛谷
食欲	食慾
食野之苹	食野之苹
食面	食麵
飨	饗
餍	饜
饥	飢
饥困	飢困
饥寒	飢寒
饥年	饑年
饥民	饑民
饥渴	飢渴
饥溺	飢溺
饥火	飢火
饥肠	飢腸
饥色	飢色
饥荒	饑荒
饥饱	飢飽
饥饿	飢餓
饥馁	飢餒
饥馑	饑饉
饧	餳
饨	飩
饩	餼
饪	飪
饫	飫
饬	飭
饬回	飭回
饭	飯
饭后	飯後
饭后钟	飯後鐘
饭团	飯糰
饭庄	飯莊
饮	飲
饯	餞
饯别	餞別
饰	飾
饱	飽
饱参	飽參
饱合	飽合
饱尝	飽嚐
饲	飼
饲喂	飼餵
饴	飴
饵	餌
饶	饒
饷	餉
饺	餃
饼	餅
饼干	餅乾
饽	餑
饿	餓
馀	餘
馀党	餘黨
馁	餒
馂余	餕餘
馄	餛
馄饨面	餛飩麵
馅	餡
馆	館
馆舍	館舍
馆谷	館穀
馆里	館裏
馈	饋
馊	餿
馋	饞
馍	饃
馏	餾
馐	饈
馑	饉
馒	饅
馔	饌
首发	首發
首只	首隻
首台	首臺
首当	首當
首当其冲	首當其衝
首恶	首惡
首面	首面
首须	首須
香干	香乾
香愿	香願
香斗	香斗
香烟	香菸
香蜡	香蠟
香郁	香郁
馥郁	馥郁
马	馬
马克	馬克
马厂	馬廠
马台	馬臺
马吊	馬吊
马后	馬後
马干	馬乾
马术	馬術
马杆	馬杆
马表	馬錶
马里	馬里
马面	馬面
驭	馭
驮	馱
驯	馴
驰	馳
驱	驅
驱出	驅出
驱虫	驅蟲
驳	駁
驳回	駁回
驴	驢
驵	駔
驶	駛
驶出	駛出
驶向	駛向
驶回	駛回
驷	駟
驸	駙
驹	駒
驺	騶
驻	駐
驻扎	駐紮
驼	駝
驽	駑
驾	駕
驾了	駕了
驾回	駕回
驾娘	駕娘
驾御	駕御
驿	驛
骀	駘
骀借	駘藉
骀荡	駘蕩
骁	驍
骂	罵
骂个	罵個
骂了	罵了
骂着	罵着
骄	驕
骅	驊
骆	駱
骇	駭
骈	駢
骊	驪
骋	騁
骋志	騁志
验	驗
验尸	驗屍
骏	駿
骏发	駿發
骐	騏
骑	騎
骑了	騎了
骑出	騎出
骑回	騎回
骑术	騎術
骒	騍
骓	騅
骖	驂
骗	騙
骗了	騙了
骗出	騙出
骗回	騙回
骗术	騙術
骘	騭
骚	騷
骛	騖
骜	驁
骝	騮
骞	騫
骟	騸
骠	驃
骡	騾
骢	驄
骣	驏
骤	驟
骥	驥
骧	驤
骨坛	骨罈
骨子里	骨子裏
骨干	骨幹
骨折	骨折
骨灰坛	骨灰罈
骾朴	骾朴
髅	髏
髋	髖
髌	髕
高个	高個
高了	高了
高于	高於
高价	高價
高几	高几
高出	高出
高升	高升
高台	高臺
高坛	高壇
高干	高幹
高才	高才
高挂	高掛
高杆	高杆
高梁	高梁
高清愿	高清愿
高纤	高纖
髡发	髡髮
髭胡	髭鬍
髭须	髭鬚
髯胡	髯鬍
髼松	髼鬆
鬅松	鬅鬆
鬈发	鬈髮
鬈曲	鬈曲
鬒发	鬒髮
鬓	鬢
鬓云	鬢雲
鬓发	鬢髮
鬼录	鬼錄
鬼才	鬼才
魂牵梦系	魂牽夢繫
魇	魘
魉	魎
魏征	魏徵
魔仆	魔僕
魔术	魔術
魔板	魔板
魔表	魔錶
鱼	魚
鱼干	魚乾
鱼松	魚鬆
鱼板	魚板
鱼梁	魚梁
鱼种	魚種
鱼虫	魚蟲
鱿	魷
鲁	魯
鲂	魴
鲆	鮃
鲇	鯰
鲇鱼	鯰魚
鲈	鱸
鲋	鮒
鲍	鮑
鲎	鱟
鲐	鮐
鲑	鮭
鲒	鮚
鲔	鮪
鲕	鮞
鲚	鱭
鲛	鮫
鲜	鮮
鲜彩	鮮彩
鲞	鯗
鲟	鱘
鲠	鯁
鲡	鱺
鲢	鰱
鲣	鰹
鲤	鯉
鲥	鰣
鲦	鰷
鲧	鯀
鲨	鯊
鲩	鯇
鲫	鯽
鲭	鯖
鲮	鯪
鲰	鯫
鲱	鯡
鲲	鯤
鲳	鯧
鲵	鯢
鲶	鯰
鲷	鯛
鲸	鯨
鲸蜡	鯨蠟
鲸须	鯨鬚
鲻	鯔
鲽	鰈
鳃	鰓
鳃叶	鰓葉
鳄	鱷
鳅	鰍
鳆	鰒
鳇	鰉
鳌	鰲
鳍	鰭
鳎	鰨
鳏	鰥
鳐	鰩
鳓	鰳
鳔	鰾
鳕	鱈
鳖	鱉
鳗	鰻
鳜	鱖
鳝	鱔
鳞	鱗
鳞叶	鱗葉
鳞游	鱗游
鳞虫	鱗蟲
鳟	鱒
鳢	鱧
鳣舍	鱣舍
鸟	鳥
鸟卜	鳥卜
鸟松	鳥松
鸠	鳩
鸠占鹊巢	鳩佔鵲巢
鸠合	鳩合
鸡	雞
鸡丝	雞絲
鸡丝面	雞絲麵
鸡争鹅斗	雞爭鵝鬭
鸡只	雞隻
鸡吵鹅斗	雞吵鵝鬭
鸡奸	雞姦
鸡腿面	雞腿麵
鸡舍	雞舍
鸡蛋里挑骨头	雞蛋裏挑骨頭
鸢	鳶
鸣	鳴
鸣钟	鳴鐘
鸥	鷗
鸦	鴉
鸨	鴇
鸩	鴆
鸪	鴣
鸫	鶇
鸬	鸕
鸭	鴨
鸯	鴦
鸱	鴟
鸲	鴝
鸳	鴛
鸵	鴕
鸶	鷥
鸷	鷙
鸷虫	鷙蟲
鸸	鴯
鸹	鴰
鸺	鵂
鸽	鴿
鸾	鸞
鸿	鴻
鸿志	鴻志
鸿案相庄	鴻案相莊
鸿篇巨制	鴻篇巨製
鸿范	鴻範
鸿蒙	鴻蒙
鹁	鵓
鹂	鸝
鹃	鵑
鹄	鵠
鹄发	鵠髮
鹄志	鵠志
鹄面	鵠面
鹅	鵝
鹅准	鵝準
鹆	鵒
鹇	鷳
鹈	鵜
鹉	鵡
鹊	鵲
鹌	鵪
鹎	鵯
鹏	鵬
鹑	鶉
鹕	鶘
鹗	鶚
鹘	鶻
鹚	鶿
鹜	鶩
鹞	鷂
鹣	鶼
鹤	鶴
鹤发	鶴髮
鹤吊	鶴弔
鹤板	鶴板
鹦	鸚
鹧	鷓
鹨	鷚
鹩	鷯
鹪	鷦
鹫	鷲
鹬	鷸
鹭	鷺
鹰	鷹
鹰雕	鹰鵰
鹳	鸛
鹾	鹺
鹿台	鹿臺
鹿谷	鹿谷
麟台	麟臺
麟种	麟種
麦	麥
麦克	麥克
麦冬	麥冬
麦秋	麥秋
麦穗	麥穗
麸	麩
麸曲	麩曲
麻团	麻團
麻布	麻布
麻杆	麻桿
麻胡	麻胡
麻药	麻藥
麻酱面	麻醬麵
麻醉药	麻醉藥
黃鈺筑	黃鈺筑
黄	黃
黄了	黃了
黄卷	黃卷
黄历	黃曆
黄发	黃髮
黄干黑瘦	黃乾黑瘦
黄曲毒素	黃麯毒素
黄梁	黃梁
黄种	黃種
黄蜡	黃蠟
黄钟	黃鐘
黄钰筑	黃鈺筑
黄须	黃鬚
黉	黌
黉舍	黌舍
黏了	黏了
黏合	黏合
黑了	黑了
黑云	黑雲
黑发	黑髮
黑布	黑布
黑暗	黑暗
黑松	黑松
黑板	黑板
黑烟	黑煙
黑种	黑種
黑里	黑裏
黑面	黑麵
黝暗	黝暗
黥布	黥布
黥面	黥面
黩	黷
黪	黲
黮暗	黮闇
黾	黽
鼋	黿
鼍	鼉
鼓出	鼓出
鼓台	鼓臺
鼓板	鼓板
鼓荡	鼓盪
鼓里	鼓裏
鼓面	鼓面
鼗	鞀
鼠曲草	鼠麯草
鼠药	鼠藥
鼹	鼴
鼻准	鼻準
鼻梁	鼻樑
鼻烟	鼻菸
齄	齇
齐	齊
齐出	齊出
齐发	齊發
齐姜	齊姜
齐庄	齊莊
齐王舍牛	齊王捨牛
齑	齏
齧合	齧合
齿	齒
齿危发秀	齒危髮秀
齿发	齒髮
齿录	齒錄
龀	齔
龃	齟
龄	齡
龄虫	齡蟲
龅	齙
龆	齠
龇	齜
龈	齦
龉	齬
龊	齪
龋	齲
龌	齷
龙	龍
龙卷	龍捲
龙团	龍團
龙岩	龍巖
龙斗虎伤	龍鬭虎傷
龙种	龍種
龙须	龍鬚
龚	龔
龚胜	龔勝
龛	龕
龟	龜
龟卜	龜卜
龟鉴	龜鑒
